transcript_id	chromosome	strand	txStart	txEnd	gene_name	length	start	end
NM_130786	chr19	-	58858171	58864865	A1BG	6694	58862365	58867365
NR_015380	chr19	+	58863335	58866549	A1BG-AS1	3214	58860835	58865835
NM_001198818	chr10	-	52559168	52645435	A1CF	86267	52642935	52647935
NM_001347423	chr12	-	9220303	9268825	A2M	48522	9266325	9271325
NR_026971	chr12	+	9217772	9220651	A2M-AS1	2879	9215272	9220272
NM_144670	chr12	+	8975067	9029377	A2ML1	54310	8972567	8977567
NR_040112	chr12	-	9381128	9386803	A2MP1	5675	9384303	9389303
NM_001080438	chr1	-	33772366	33786699	A3GALT2	14333	33784199	33789199
NM_001318038	chr22	-	43088117	43117307	A4GALT	29190	43114807	43119807
NM_016161	chr3	-	137842559	137851229	A4GNT	8670	137848729	137853729
NR_037584	chr17	-	31856805	31860779	AA06	3974	31858279	31863279
NM_015665	chr12	-	53701239	53715412	AAAS	14173	53712912	53717912
NM_001319840	chr12	+	125549912	125627879	AACS	77967	125547412	125552412
NR_024035	chr5	-	178191861	178245436	AACSP1	53575	178242936	178247936
NM_001086	chr3	+	151531860	151546276	AADAC	14416	151529360	151534360
NM_207365	chr3	+	151451703	151475556	AADACL2	23853	151449203	151454203
NR_110203	chr3	-	151468966	151645963	AADACL2-AS1	176997	151643463	151648463
NR_111984	chr1	+	12776117	12788726	AADACL3	12609	12773617	12778617
NM_001013630	chr1	+	12704565	12727097	AADACL4	22532	12702065	12707065
NR_026915	chr3	+	151488243	151502682	AADACP1	14439	151485743	151490743
NM_001286683	chr4	-	170981372	171011538	AADAT	30166	171009038	171014038
NM_153698	chr9	-	99403532	99417599	AAED1	14067	99415099	99420099
NM_001271885	chr15	-	67493012	67547536	AAGAB	54524	67545036	67550036
NM_014911	chr2	-	69685126	69870977	AAK1	185851	69868477	69873477
NM_001316957	chr11	+	77532159	77611831	AAMDC	79672	77529659	77534659
NM_001087	chr2	-	219128851	219134932	AAMP	6081	219132432	219137432
NM_001166579	chr17	+	74449432	74466199	AANAT	16767	74446932	74451932
NM_015511	chr20	+	34824338	34844863	AAR2	20525	34821838	34826838
NM_001025357	chr8	+	117950463	117956239	AARD	5776	117947963	117952963
NM_001605	chr16	-	70286296	70323412	AARS	37116	70320912	70325912
NM_020745	chr6	-	44266462	44281063	AARS2	14601	44278563	44283563
NM_001261434	chr17	-	41102542	41116515	AARSD1	13973	41114015	41119015
NM_001323890	chr4	-	57204450	57253674	AASDH	49224	57251174	57256174
NM_015423	chr11	+	105948291	105969419	AASDHPPT	21128	105945791	105950791
NM_005763	chr7	-	121713597	121784344	AASS	70747	121781844	121786844
NR_026961	chr21	-	45225638	45232448	AATBC	6810	45229948	45234948
NM_012138	chr17	+	35306174	35414171	AATF	107997	35303674	35308674
NM_001080395	chr17	-	79091095	79139872	AATK	48777	79137372	79142372
NM_020686	chr16	+	8768443	8878432	ABAT	109989	8765943	8770943
NM_005502	chr9	-	107543283	107690527	ABCA1	147244	107688027	107693027
NM_080282	chr17	-	67144147	67240956	ABCA10	96809	67238456	67243456
NR_002451	chr4	-	419223	467998	ABCA11P	48775	465498	470498
NR_103740	chr2	-	215796265	216003151	ABCA12	206886	216000651	216005651
NM_152701	chr7	+	48211056	48687091	ABCA13	476035	48208556	48213556
NR_003574	chr16	+	2390922	2476700	ABCA17P	85778	2388422	2393422
NM_212533	chr9	-	139901685	139923374	ABCA2	21689	139920874	139925874
NM_001089	chr16	-	2325878	2390747	ABCA3	64869	2388247	2393247
NM_000350	chr1	-	94458393	94586705	ABCA4	128312	94584205	94589205
NM_172232	chr17	-	67240575	67323323	ABCA5	82748	67320823	67325823
NM_080284	chr17	-	67074846	67138015	ABCA6	63169	67135515	67140515
NM_019112	chr19	+	1040101	1065570	ABCA7	25469	1037601	1042601
NM_001288986	chr17	-	66863427	66951533	ABCA8	88106	66949033	66954033
NM_080283	chr17	-	66970772	67057136	ABCA9	86364	67054636	67059636
NR_126414	chr17	+	67000854	67014464	ABCA9-AS1	13610	66998354	67003354
NM_001348944	chr7	-	87133178	87342639	ABCB1	209461	87340139	87345139
NM_012089	chr1	-	229652328	229694442	ABCB10	42114	229691942	229696942
NM_003742	chr2	-	169779448	169887833	ABCB11	108385	169885333	169890333
NM_000443	chr7	-	87031360	87105019	ABCB4	73659	87102519	87107519
NM_001163941	chr7	+	20655244	20796637	ABCB5	141393	20652744	20657744
NM_001349828	chr2	-	220074487	220083739	ABCB6	9252	220081239	220086239
NM_001271696	chrX	-	74273114	74376175	ABCB7	103061	74373675	74378675
NM_007188	chr7	+	150725508	150744869	ABCB8	19361	150723008	150728008
NM_001243014	chr12	-	123405497	123451056	ABCB9	45559	123448556	123453556
NM_004996	chr16	+	16043433	16236930	ABCC1	193497	16040933	16045933
NM_001198934	chr6	+	43395291	43418163	ABCC10	22872	43392791	43397791
NM_032583	chr16	-	48200821	48269088	ABCC11	68267	48266588	48271588
NM_033226	chr16	-	48116883	48180681	ABCC12	63798	48178181	48183181
NR_003087	chr21	+	15646119	15673692	ABCC13	27573	15643619	15648619
NM_000392	chr10	+	101542354	101611949	ABCC2	69595	101539854	101544854
NM_003786	chr17	+	48712217	48769063	ABCC3	56846	48709717	48714717
NM_005845	chr13	-	95672082	95953700	ABCC4	281618	95951200	95956200
NM_001320032	chr3	-	183637723	183735748	ABCC5	98025	183733248	183738248
NR_046570	chr3	+	183724125	183729207	ABCC5-AS1	5082	183721625	183726625
NM_001171	chr16	-	16243421	16317328	ABCC6	73907	16314828	16319828
NR_003569	chr16	+	18582569	18609607	ABCC6P1	27038	18580069	18585069
NM_000352	chr11	-	17414431	17498392	ABCC8	83961	17495892	17500892
NM_020297	chr12	-	21950323	22089628	ABCC9	139305	22087128	22092128
NM_000033	chrX	+	152990322	153010216	ABCD1	19894	152987822	152992822
NM_005164	chr12	-	39945021	40013843	ABCD2	68822	40011343	40016343
NM_002858	chr1	+	94883932	94984219	ABCD3	100287	94881432	94886432
NR_003256	chr14	-	74751979	74769767	ABCD4	17788	74767267	74772267
NM_002940	chr4	+	146019155	146050676	ABCE1	31521	146016655	146021655
NM_001090	chr6	+	30539169	30559309	ABCF1	20140	30536669	30541669
NM_005692	chr7	-	150904922	150924460	ABCF2	19538	150921960	150926960
NM_018358	chr3	+	183903862	183911795	ABCF3	7933	183901362	183906362
NM_207627	chr21	+	43619798	43717354	ABCG1	97556	43617298	43622298
NM_001257386	chr4	-	89011415	89152778	ABCG2	141363	89150278	89155278
NM_022169	chr11	+	119019749	119033374	ABCG4	13625	119017249	119022249
NM_022436	chr2	-	44039610	44065958	ABCG5	26348	44063458	44068458
NM_022437	chr2	+	44066102	44105605	ABCG8	39503	44063602	44068602
NM_032604	chr2	+	27346656	27353680	ABHD1	7024	27344156	27349156
NR_073571	chr3	+	111697722	111712215	ABHD10	14493	111695222	111700222
NR_026912	chr7	-	73150424	73153197	ABHD11	2773	73150697	73155697
NM_015600	chr20	-	25275378	25371618	ABHD12	96240	25369118	25374118
NM_181533	chr14	+	51338877	51371688	ABHD12B	32811	51336377	51341377
NM_032859	chr13	+	108870762	108886603	ABHD13	15841	108868262	108873262
NM_015407	chr3	+	52009041	52015216	ABHD14A	6175	52006541	52011541
NM_001316331	chr3	+	52009041	52023218	ABHD14A-ACY1	14177	52006541	52011541
NM_032750	chr3	-	52002525	52008646	ABHD14B	6121	52006146	52011146
NM_198147	chr17	-	27887688	27894042	ABHD15	6354	27891542	27896542
NM_021160	chr6_ssto_hap7	-	2985531	3001955	ABHD16A	16424	2999455	3004455
NM_001130111	chr19	-	1876974	1885518	ABHD17A	8544	1883018	1888018
NM_016014	chr9	-	74477367	74526161	ABHD17B	48794	74523661	74528661
NM_021214	chr15	+	80987651	81047962	ABHD17C	60311	80985151	80990151
NM_001319306	chr4	+	128886410	128960866	ABHD18	74456	128883910	128888910
NM_007011	chr15	+	89631380	89745591	ABHD2	114211	89628880	89633880
NM_138340	chr18	-	19230857	19284766	ABHD3	53909	19282266	19287266
NM_022060	chr14	+	23067146	23081265	ABHD4	14119	23064646	23069646
NM_016006	chr3	+	43732361	43764217	ABHD5	31856	43729861	43734861
NM_001320126	chr3	+	58223228	58280463	ABHD6	57235	58220728	58225728
NM_024527	chr19	-	17402939	17414282	ABHD8	11343	17411782	17416782
NM_001178125	chr10	-	27035524	27150016	ABI1	114492	27147516	27152516
NM_001282925	chr2	+	204192961	204296896	ABI2	103935	204190461	204195461
NM_016428	chr17	+	47287588	47300587	ABI3	12999	47285088	47290088
NM_015429	chr3	-	100468178	100712334	ABI3BP	244156	100709834	100714834
NM_007313	chr9	+	133589267	133763062	ABL1	173795	133586767	133591767
NM_001168236	chr1	-	179068461	179198819	ABL2	130358	179196319	179201319
NM_001322884	chr10	-	116190868	116528028	ABLIM1	337160	116525528	116530528
NM_001130085	chr4	-	7967036	8160559	ABLIM2	193523	8158059	8163059
NM_001301028	chr5	+	148521009	148640001	ABLIM3	118992	148518509	148523509
NM_020469	chr9	-	136130562	136150630	ABO	20068	136148130	136153130
NM_001322841	chr17	-	906757	1132974	ABR	226217	1130474	1135474
NM_139166	chr8	-	107771710	107782472	ABRA	10762	107779972	107784972
NM_021243	chr6	+	139349818	139364439	ABRACL	14621	139347318	139352318
NM_001345962	chr4	-	84382092	84406331	ABRAXAS1	24239	84403831	84408831
NM_032182	chr10	+	126490353	126525239	ABRAXAS2	34886	126487853	126492853
NM_013375	chr6	+	26597170	26600277	ABT1	3107	26594670	26599670
NM_172027	chr3	+	127391780	127399769	ABTB1	7989	127389280	127394280
NM_145804	chr11	-	34172533	34379555	ABTB2	207022	34377055	34382055
NM_001130410	chr3	-	38164200	38178733	ACAA1	14533	38176233	38181233
NM_006111	chr18	-	47309873	47340251	ACAA2	30378	47337751	47342751
NM_198839	chr17	-	35441926	35766902	ACACA	324976	35764402	35769402
NM_001093	chr12	+	109577201	109706030	ACACB	128829	109574701	109579701
NM_025247	chr12	+	112123856	112194911	ACAD10	71055	112121356	112126356
NR_132426	chr3	-	132276981	132378975	ACAD11	101994	132376475	132381475
NM_014384	chr11	+	134123433	134135746	ACAD8	12313	134120933	134125933
NR_033426	chr3	+	128598332	128631957	ACAD9	33625	128595832	128600832
NM_001608	chr2	-	211052715	211090215	ACADL	37500	211087715	211092715
NM_000016	chr1	+	76190031	76229363	ACADM	39332	76187531	76192531
NM_000017	chr12	+	121163540	121177811	ACADS	14271	121161040	121166040
NM_001609	chr10	+	124768428	124817806	ACADSB	49378	124765928	124770928
NM_001270447	chr17	+	7120443	7128586	ACADVL	8143	7117943	7122943
NM_013227	chr15	+	89346673	89418585	ACAN	71912	89344173	89349173
NM_014716	chr17	+	7239847	7254793	ACAP1	14946	7237347	7242347
NM_012287	chr3	-	194995464	195163817	ACAP2	168353	195161317	195166317
NM_030649	chr1	-	1227763	1243269	ACAP3	15506	1240769	1245769
NM_000019	chr11	+	107992257	108018891	ACAT1	26634	107989757	107994757
NM_005891	chr6	+	160182988	160200087	ACAT2	17099	160180488	160185488
NM_022735	chr1	-	226332379	226374423	ACBD3	42044	226371923	226376923
NR_146443	chr1	+	226335703	226342678	ACBD3-AS1	6975	226333203	226338203
NM_001321352	chr17	+	43209966	43221548	ACBD4	11582	43207466	43212466
NM_001352570	chr10	-	27471766	27529808	ACBD5	58042	27527308	27532308
NM_032360	chr1	-	180257351	180472022	ACBD6	214671	180469522	180474522
NM_001039844	chr10	-	15117473	15130775	ACBD7	13302	15128275	15133275
NR_144471	chr10	-	15057070	15130775	ACBD7-DCLRE1CP1	73705	15128275	15133275
NM_001127219	chr11	+	44087728	44105569	ACCS	17841	44085228	44090228
NM_001031854	chr11	+	44069530	44081527	ACCSL	11997	44067030	44072030
NM_022914	chr16	-	67691414	67694718	ACD	3304	67692218	67697218
NM_000789	chr17	+	61554421	61575741	ACE	21320	61551921	61556921
NM_021804	chrX	-	15579155	15620192	ACE2	41037	15617692	15622692
NM_133492	chr19	-	6306509	6333640	ACER1	27131	6331140	6336140
NM_001010887	chr9	+	19408924	19452500	ACER2	43576	19406424	19411424
NM_001300955	chr11	+	76571916	76737841	ACER3	165925	76569416	76574416
NM_001302622	chr7	-	100487614	100493754	ACHE	6140	100491254	100496254
NM_001164815	chr14	-	23527773	23564823	ACIN1	37050	23562323	23567323
NM_001296	chr3	+	42850963	42908775	ACKR2	57812	42848463	42853463
NM_020311	chr2	+	237478379	237490994	ACKR3	12615	237475879	237480879
NM_016557	chr3	+	132316080	132321485	ACKR4	5405	132313580	132318580
NM_001303275	chr17	-	40023169	40075275	ACLY	52106	40072775	40077775
NM_138326	chr2	+	135596185	135659602	ACMSD	63417	135593685	135598685
NM_002197	chr9	+	32384600	32450832	ACO1	66232	32382100	32387100
NM_001098	chr22	+	41865128	41924993	ACO2	59865	41862628	41867628
NM_001258406	chr13	+	77526623	77532776	ACOD1	6153	77524123	77529123
NM_001037161	chr14	+	74003927	74010498	ACOT1	6571	74001427	74006427
NM_015547	chr1	+	55013806	55100417	ACOT11	86611	55011306	55016306
NM_130767	chr5	-	80625946	80689988	ACOT12	64042	80687488	80692488
NM_018473	chr6	+	24667262	24705295	ACOT13	38033	24664762	24669762
NR_046028	chr14	+	74034323	74042362	ACOT2	8039	74031823	74036823
NM_152331	chr14	+	74058409	74062470	ACOT4	4061	74055909	74060909
NM_001037162	chr14	+	74083547	74086592	ACOT6	3045	74081047	74086047
NM_007274	chr1	-	6324331	6453826	ACOT7	129495	6451326	6456326
NM_005469	chr20	-	44470359	44486048	ACOT8	15689	44483548	44488548
NM_001330259	chrX	-	23719173	23761404	ACOT9	42231	23758904	23763904
NM_007292	chr17	-	73937588	73975515	ACOX1	37927	73973015	73978015
NM_003500	chr3	-	58490862	58522929	ACOX2	32067	58520429	58525429
NM_003501	chr4	-	8368008	8442452	ACOX3	74444	8439952	8444952
NM_001142807	chr2	+	111490149	111875799	ACOXL	385650	111487649	111492649
NR_122074	chr2	-	111855917	111873165	ACOXL-AS1	17248	111870665	111875665
NR_024080	chr2	+	264868	278282	ACP1	13414	262368	267368
NM_001302491	chr11	-	47260852	47270398	ACP2	9546	47267898	47272898
NM_001111036	chr19	-	11685474	11689823	ACP5	4349	11687323	11692323
NR_136633	chr1	-	147119167	147142665	ACP6	23498	147140165	147145165
NM_001004318	chr19	+	39574944	39602128	ACP7	27184	39572444	39577444
NM_001134194	chr3	+	132036210	132087146	ACPP	50936	132033710	132038710
NM_033068	chr19	+	51293671	51298481	ACPT	4810	51291171	51296171
NM_001097	chr22	+	51176651	51183727	ACR	7076	51174151	51179151
NM_032489	chr12	-	6747241	6756580	ACRBP	9339	6754080	6759080
NM_001612	chr11	-	125542228	125550793	ACRV1	8565	125548293	125553293
NM_015162	chr15	-	78463186	78527049	ACSBG1	63863	78524549	78529549
NM_030924	chr19	+	6135643	6193114	ACSBG2	57471	6133143	6138143
NM_001288972	chr17	+	48503518	48552206	ACSF2	48688	48501018	48506018
NM_001243279	chr16	+	89160216	89222254	ACSF3	62038	89157716	89162716
NM_001995	chr4	-	185676748	185747268	ACSL1	70520	185744768	185749768
NM_004457	chr2	+	223725731	223808119	ACSL3	82388	223723231	223728231
NM_001318509	chrX	-	108884558	108976632	ACSL4	92074	108974132	108979132
NM_203379	chr10	+	114133915	114188138	ACSL5	54223	114131415	114136415
NM_001205250	chr5	-	131285666	131347761	ACSL6	62095	131345261	131350261
NM_001318890	chr16	-	20634558	20709110	ACSM1	74552	20706610	20711610
NM_001308954	chr16	+	20462782	20498991	ACSM2A	36209	20460282	20465282
NM_001105069	chr16	-	20548082	20587695	ACSM2B	39613	20585195	20590195
NM_005622	chr16	+	20775311	20808479	ACSM3	33168	20772811	20777811
NM_001080454	chr12	+	7456927	7480969	ACSM4	24042	7454427	7459427
NM_001324372	chr16	+	20420855	20452654	ACSM5	31799	20418355	20423355
NM_207321	chr10	+	96953956	96988686	ACSM6	34730	96951456	96956456
NM_001252677	chr20	-	24986865	25038818	ACSS1	51953	25036318	25041318
NM_001242393	chr20	+	33462765	33515769	ACSS2	53004	33460265	33465265
NM_024560	chr12	+	81471796	81650537	ACSS3	178741	81469296	81474296
NM_001100	chr1	-	229566992	229569843	ACTA1	2851	229567343	229572343
NM_001320855	chr10	-	90694830	90751154	ACTA2	56324	90748654	90753654
NR_125373	chr10	+	90692440	90699731	ACTA2-AS1	7291	90689940	90694940
NM_001101	chr7	-	5566778	5570232	ACTB	3454	5567732	5572732
NM_001017992	chr5	-	56775842	56778636	ACTBL2	2794	56776136	56781136
NM_005159	chr15	-	35080296	35087927	ACTC1	7631	35085427	35090427
NR_037688	chr17	-	79476996	79479892	ACTG1	2896	79477392	79482392
NR_036446	chr15	-	83394649	83408532	ACTG1P17	13883	83406032	83411032
NR_033926	chr1	+	27650364	27653016	ACTG1P20	2652	27647864	27652864
NM_001615	chr2	+	74120092	74146780	ACTG2	26688	74117592	74122592
NM_177989	chr3	+	179280667	179306193	ACTL6A	25526	179278167	179283167
NM_016188	chr7	-	100240725	100254084	ACTL6B	13359	100251584	100256584
NM_030812	chr1	+	18081807	18153558	ACTL8	71751	18079307	18084307
NM_001102	chr14	-	69340839	69446083	ACTN1	105244	69443583	69448583
NR_073422	chr14	+	69446398	69454180	ACTN1-AS1	7782	69443898	69448898
NM_001278343	chr1	+	236849753	236927927	ACTN2	78174	236847253	236852253
NM_001258371	chr11	+	66313865	66330800	ACTN3	16935	66311365	66316365
NM_001322033	chr19	+	39138255	39221172	ACTN4	82917	39135755	39140755
NM_018477	chr14	+	58666832	58702353	ACTR10	35521	58664332	58669332
NM_005736	chr10	-	104238985	104262512	ACTR1A	23527	104260012	104265012
NM_005735	chr2	-	98272401	98280561	ACTR1B	8160	98278061	98283061
NM_005722	chr2	+	65454828	65498390	ACTR2	43562	65452328	65457328
NM_005721	chr2	+	114647510	114719129	ACTR3	71619	114645010	114650010
NM_020445	chr7	+	152456833	152552464	ACTR3B	95631	152454333	152459333
NM_001351028	chr7	-	149578447	150020758	ACTR3C	442311	150018258	150023258
NM_024855	chr20	+	37377096	37401089	ACTR5	23993	37374596	37379596
NM_022496	chr12	+	100593864	100618202	ACTR6	24338	100591364	100596364
NM_022899	chr3	-	53901093	53916229	ACTR8	15136	53913729	53918729
NM_032487	chr3	-	169484710	169487683	ACTRT3	2973	169485183	169490183
NM_001111067	chr2	-	158592957	158732374	ACVR1	139417	158729874	158734874
NM_020328	chr12	+	52345450	52390863	ACVR1B	45413	52342950	52347950
NM_001111032	chr2	-	158383278	158485399	ACVR1C	102121	158482899	158487899
NM_001278580	chr2	+	148602085	148688396	ACVR2A	86311	148599585	148604585
NM_001106	chr3	+	38495789	38534633	ACVR2B	38844	38493289	38498289
NR_028389	chr3	-	38492517	38496311	ACVR2B-AS1	3794	38493811	38498811
NM_000020	chr12	+	52301201	52317145	ACVRL1	15944	52298701	52303701
NM_001198895	chr3	+	52017299	52023218	ACY1	5919	52014799	52019799
NM_080658	chr11	-	67410025	67418130	ACY3	8105	67415630	67420630
NR_126394	chr14	-	75519927	75536186	ACYP1	16259	75533686	75538686
NM_001320587	chr2	+	54198239	54532435	ACYP2	334196	54195739	54200739
NM_000022	chr20	-	43248159	43280399	ADA	32240	43277899	43282899
NM_001282227	chr22	-	17659679	17702744	ADA2	43065	17700244	17705244
NM_139243	chr4	+	123300120	123350947	ADAD1	50827	123297620	123302620
NM_001145400	chr16	+	84224722	84230772	ADAD2	6050	84222222	84227222
NM_001159280	chr15	+	43622553	43646753	ADAL	24200	43620053	43625053
NM_001320570	chr15	-	58887402	59042177	ADAM10	154775	59039677	59044677
NM_001318933	chr17	+	42836546	42859214	ADAM11	22668	42834046	42839046
NM_001288973	chr10	-	127700953	128077127	ADAM12	376174	128074627	128079627
NM_001261464	chr1	+	155023747	155035252	ADAM15	11505	155021247	155026247
NM_003183	chr2	-	9628614	9695949	ADAM17	67335	9693449	9698449
NM_001320313	chr8	+	39442086	39587583	ADAM18	145497	39439586	39444586
NM_033274	chr5	-	156904311	157002831	ADAM19	98520	157000331	157005331
NR_036636	chr12	+	112336866	112339706	ADAM1A	2840	112334366	112339366
NM_001464	chr8	-	39601254	39695808	ADAM2	94554	39693308	39698308
NM_003814	chr14	-	70989077	71001732	ADAM20	12655	70999232	71004232
NR_037933	chr14	-	70935595	70950473	ADAM20P1	14878	70947973	70952973
NM_003813	chr14	+	70918873	70926622	ADAM21	7749	70916373	70921373
NM_001324417	chr7	+	87563457	87832204	ADAM22	268747	87560957	87565957
NM_003812	chr2	+	207308367	207485854	ADAM23	177487	207305867	207310867
NM_001304351	chr8	+	24151552	24216531	ADAM28	64979	24149052	24154052
NM_001278126	chr4	+	175839508	175899331	ADAM29	59823	175837008	175842008
NM_021794	chr1	-	120436155	120439147	ADAM30	2992	120436647	120441647
NM_145004	chr8	+	38965047	39142436	ADAM32	177389	38962547	38967547
NM_001282447	chr20	-	3648611	3663337	ADAM33	14726	3660837	3665837
NR_024107	chr8	-	39308563	39380508	ADAM3A	71945	39378008	39383008
NR_001448	chr8	+	39172181	39260375	ADAM5	88194	39169681	39174681
NR_002224	chr14	-	106435817	106438358	ADAM6	2541	106435858	106440858
NM_003817	chr8	+	24298508	24367077	ADAM7	68569	24296008	24301008
NM_001109	chr10	-	135075919	135090407	ADAM8	14488	135087907	135092907
NR_027638	chr8	+	38854504	38962779	ADAM9	108275	38852004	38857004
NM_001145272	chr8	+	24241797	24263526	ADAMDEC1	21729	24239297	24244297
NM_006988	chr21	-	28208605	28217728	ADAMTS1	9123	28215228	28220228
NM_030957	chr19	-	8645123	8675620	ADAMTS10	30497	8673120	8678120
NM_001324512	chr5	-	33523639	33892297	ADAMTS12	368658	33889797	33894797
NR_024514	chr9	+	136279458	136324525	ADAMTS13	45067	136276958	136281958
NM_139155	chr10	+	72432261	72522195	ADAMTS14	89934	72429761	72434761
NM_139055	chr11	+	130318868	130346540	ADAMTS15	27672	130316368	130321368
NM_139056	chr5	+	5140442	5320415	ADAMTS16	179973	5137942	5142942
NM_139057	chr15	-	100511642	100882210	ADAMTS17	370568	100879710	100884710
NM_001326358	chr16	-	77316024	77469011	ADAMTS18	152987	77466511	77471511
NM_133638	chr5	+	128795957	129074376	ADAMTS19	278419	128793457	128798457
NM_014244	chr5	-	178537851	178772431	ADAMTS2	234580	178769931	178774931
NM_025003	chr12	-	43747668	43945774	ADAMTS20	198106	43943274	43948274
NM_014243	chr4	-	73146685	73434516	ADAMTS3	287831	73432016	73437016
NM_001320336	chr1	-	161159518	161168843	ADAMTS4	9325	161166343	161171343
NM_007038	chr21	-	28290230	28339439	ADAMTS5	49209	28336939	28341939
NR_135689	chr5	-	64444562	64777747	ADAMTS6	333185	64775247	64780247
NM_014272	chr15	-	79051544	79103805	ADAMTS7	52261	79101305	79106305
NR_045529	chr15	+	82882945	82924242	ADAMTS7P1	41297	82880445	82885445
NM_007037	chr11	-	130274817	130298888	ADAMTS8	24071	130296388	130301388
NM_001318781	chr3	-	64501330	64673365	ADAMTS9	172035	64670865	64675865
NR_110150	chr3	+	64547021	64575760	ADAMTS9-AS1	28739	64544521	64549521
NR_038264	chr3	+	64670545	64997143	ADAMTS9-AS2	326598	64668045	64673045
NM_001040272	chr9	+	18474078	18910947	ADAMTSL1	436869	18471578	18476578
NM_001145320	chr9	+	136397285	136440641	ADAMTSL2	43356	136394785	136399785
NM_001301110	chr15	+	84322837	84708593	ADAMTSL3	385756	84320337	84325337
NM_001288608	chr1	+	150521844	150533412	ADAMTSL4	11568	150519344	150524344
NR_104133	chr1	-	150533370	150547028	ADAMTSL4-AS1	13658	150544528	150549528
NM_213604	chr19	-	1505016	1513188	ADAMTSL5	8172	1510688	1515688
NM_001284308	chr7	-	937536	995043	ADAP1	57507	992543	997543
NM_018404	chr17	+	29248753	29286211	ADAP2	37458	29246253	29251253
NM_001025107	chr1	-	154554533	154600456	ADAR	45923	154597956	154602956
NR_027674	chr21	+	46494492	46646478	ADARB1	151986	46491992	46496992
NM_018702	chr10	-	1223252	1779670	ADARB2	556418	1777170	1782170
NR_033387	chr10	+	1568824	1599179	ADARB2-AS1	30355	1566324	1571324
NM_001324444	chr16	-	75630776	75657221	ADAT1	26445	75654721	75659721
NM_182503	chr6	-	143743968	143771841	ADAT2	27873	143769341	143774341
NM_138422	chr19	+	1905212	1913446	ADAT3	8234	1902712	1907712
NM_020421	chr14	+	78266425	78400297	ADCK1	133872	78263925	78268925
NM_052853	chr7	+	140372952	140394908	ADCK2	21956	140370452	140375452
NM_174922	chr8	+	145597703	145618453	ADCK5	20750	145595203	145600203
NM_021116	chr7	+	45614120	45762714	ADCY1	148594	45611620	45616620
NM_001297772	chr1	-	167778624	167883464	ADCY10	104840	167880964	167885964
NR_026938	chr6	+	41068772	41108573	ADCY10P1	39801	41066272	41071272
NM_020546	chr5	+	7396342	7830194	ADCY2	433852	7393842	7398842
NM_004036	chr2	-	25042038	25142886	ADCY3	100848	25140386	25145386
NM_139247	chr14	-	24787554	24804277	ADCY4	16723	24801777	24806777
NM_183357	chr3	-	123001142	123167392	ADCY5	166250	123164892	123169892
NM_015270	chr12	-	49159973	49182879	ADCY6	22906	49180379	49185379
NM_001286057	chr16	+	50300450	50344440	ADCY7	43990	50297950	50302950
NM_001115	chr8	-	131792546	132052835	ADCY8	260289	132050335	132055335
NM_001116	chr16	-	4012649	4166186	ADCY9	153537	4163686	4168686
NM_001099733	chr18	+	904943	912173	ADCYAP1	7230	902443	907443
NM_001118	chr7	+	31092075	31151093	ADCYAP1R1	59018	31089575	31094575
NM_001119	chr4	+	2845583	2931802	ADD1	86219	2843083	2848083
NM_017488	chr2	-	70889215	70995375	ADD2	106160	70992875	70997875
NM_001320591	chr10	+	111756107	111895323	ADD3	139216	111753607	111758607
NR_038943	chr10	-	111705316	111768139	ADD3-AS1	62823	111765639	111770639
NM_024694	chr6	+	146920135	147136597	ADGB	216462	146917635	146922635
NM_001083909	chr10	+	134901507	134945179	ADGRA1	43672	134899007	134904007
NM_032777	chr8	+	37654400	37701504	ADGRA2	47104	37651900	37656900
NM_145290	chr4	-	22388996	22517677	ADGRA3	128681	22515177	22520177
NM_001702	chr8	+	143545376	143626368	ADGRB1	80992	143542876	143547876
NM_001294335	chr1	-	32192705	32229664	ADGRB2	36959	32227164	32232164
NM_001704	chr6	+	69345631	70099403	ADGRB3	753772	69343131	69348131
NM_198827	chr12	+	131438451	131626013	ADGRD1	187562	131435951	131440951
NR_131950	chr12	-	131475170	131478521	ADGRD1-AS1	3351	131476021	131481021
NM_001256255	chr19	+	6887559	6940464	ADGRE1	52905	6885059	6890059
NM_013447	chr19	-	14843508	14889353	ADGRE2	45845	14886853	14891853
NM_001289159	chr19	-	14729928	14785730	ADGRE3	55802	14783230	14788230
NR_024075	chr19	-	6952510	6990857	ADGRE4P	38347	6988357	6993357
NM_001784	chr19	+	14491955	14519537	ADGRE5	27582	14489455	14494455
NM_153840	chr6	-	46965439	47010099	ADGRF1	44660	47007599	47012599
NM_153839	chr6	+	47624325	47665533	ADGRF2	41208	47621825	47626825
NR_135916	chr2	-	26531040	26569685	ADGRF3	38645	26567185	26572185
NM_153838	chr6	+	47666280	47689757	ADGRF4	23477	47663780	47668780
NM_015234	chr6	-	46820241	46922675	ADGRF5	102434	46920175	46925175
NM_001290142	chr16	+	57653604	57698951	ADGRG1	45347	57651104	57656104
NM_001184835	chrX	-	19007424	19140755	ADGRG2	133331	19138255	19143255
NM_001308360	chr16	+	57702156	57723290	ADGRG3	21134	57699656	57704656
NM_153834	chrX	+	135383121	135499047	ADGRG4	115926	135380621	135385621
NM_153837	chr16	+	57576548	57611100	ADGRG5	34552	57574048	57579048
NM_198569	chr6	+	142623055	142767403	ADGRG6	144348	142620555	142625555
NM_032787	chr3	+	100328432	100414323	ADGRG7	85891	100325932	100330932
NM_014921	chr19	-	14258548	14316997	ADGRL1	58449	14314497	14319497
NM_001297704	chr1	+	82165454	82459616	ADGRL2	294162	82162954	82167954
NM_001322246	chr4	+	62066973	62944053	ADGRL3	877080	62064473	62069473
NR_110595	chr4	-	62937472	63027483	ADGRL3-AS1	90011	63024983	63029983
NM_022159	chr1	-	79355448	79472495	ADGRL4	117047	79469995	79474995
NM_032119	chr5	+	89854616	90460033	ADGRV1	605417	89852116	89857116
NM_000667	chr4	-	100197522	100212185	ADH1A	14663	100209685	100214685
NM_000668	chr4	-	100227543	100242599	ADH1B	15056	100240099	100245099
NR_133005	chr4	-	100257648	100274202	ADH1C	16554	100271702	100276702
NM_000670	chr4	-	100044807	100065449	ADH4	20642	100062949	100067949
NM_000671	chr4	-	99992129	100009939	ADH5	17810	100007439	100012439
NM_001102470	chr4	-	100123794	100140403	ADH6	16609	100137903	100142903
NM_000673	chr4	-	100333417	100356667	ADH7	23250	100354167	100359167
NM_144650	chr8	+	67344717	67381044	ADHFE1	36327	67342217	67347217
NM_018269	chr2	-	3501689	3523350	ADI1	21661	3520850	3525850
NR_130907	chr20	+	37209837	37217106	ADIG	7269	37207337	37212337
NM_001177800	chr3	+	186560462	186576252	ADIPOQ	15790	186557962	186562962
NR_046662	chr3	-	186569675	186579157	ADIPOQ-AS1	9482	186576657	186581657
NM_001290629	chr1	-	202909952	202927700	ADIPOR1	17748	202925200	202930200
NM_024551	chr12	+	1800246	1897845	ADIPOR2	97599	1797746	1802746
NM_006721	chr10	+	75910942	76469061	ADK	558119	75908442	75913442
NM_001253845	chr22	+	50920152	50924866	ADM2	4714	50917652	50922652
NM_001282531	chr20	-	49505454	49547750	ADNP	42296	49545250	49550250
NR_110009	chr20	+	49547520	49561671	ADNP-AS1	14151	49545020	49550020
NM_014913	chr18	+	77866914	77898228	ADNP2	31314	77864414	77869414
NM_032804	chr10	+	64564515	64568239	ADO	3724	64562015	64567015
NM_000674	chr1	+	203096835	203136533	ADORA1	39698	203094335	203099335
NM_001278500	chr22	+	24819564	24838328	ADORA2A	18764	24817064	24822064
NR_028484	chr22	-	24825175	24891042	ADORA2A-AS1	65867	24888542	24893542
NM_000676	chr17	+	15848230	15879210	ADORA2B	30980	15845730	15850730
NM_000677	chr1	-	112042050	112046743	ADORA3	4693	112044243	112049243
NM_031284	chr15	-	73043707	73076126	ADPGK	32419	73073626	73078626
NR_040107	chr15	+	73075175	73090540	ADPGK-AS1	15365	73072675	73077675
NM_001125	chr3	+	119298279	119308792	ADPRH	10513	119295779	119300779
NM_138430	chr13	-	114076254	114107839	ADPRHL1	31585	114105339	114110339
NM_017825	chr1	+	36554452	36559533	ADPRHL2	5081	36551952	36556952
NM_020233	chr17	+	10600926	10614875	ADPRM	13949	10598426	10603426
NM_033303	chr8	-	26605666	26723172	ADRA1A	117506	26720672	26725672
NM_000679	chr5	+	159343739	159400017	ADRA1B	56278	159341239	159346239
NM_000678	chr20	-	4201277	4229659	ADRA1D	28382	4227159	4232159
NM_000681	chr10	+	112836789	112840662	ADRA2A	3873	112834289	112839289
NM_000682	chr2	-	96778622	96781984	ADRA2B	3362	96779484	96784484
NM_000684	chr10	+	115803805	115806667	ADRB1	2862	115801305	115806305
NM_000025	chr8	-	37820513	37824184	ADRB3	3671	37821684	37826684
NM_001281438	chr20	+	60877951	60883918	ADRM1	5967	60875451	60880451
NR_134256	chr22	+	40742503	40762752	ADSL	20249	40740003	40745003
NM_001126	chr1	-	244571793	244615436	ADSS	43643	244612936	244617936
NM_152328	chr14	+	105190533	105213662	ADSSL1	23129	105188033	105193033
NM_001143948	chr6	-	11713887	11779280	ADTRP	65393	11776780	11781780
NM_001129	chr7	+	44143959	44154164	AEBP1	10205	44141459	44146459
NM_153207	chr12	+	19592607	19675173	AEBP2	82566	19590107	19595107
NM_022767	chr15	+	89164526	89175512	AEN	10986	89162026	89167026
NM_198969	chr19	-	3052907	3062964	AES	10057	3060464	3065464
NM_198595	chr4	-	7760439	7941653	AFAP1	181214	7939153	7944153
NR_026892	chr4	+	7755816	7780654	AFAP1-AS1	24838	7753316	7758316
NM_152406	chr5	+	148651400	148723198	AFAP1L1	71798	148648900	148653900
NM_032550	chr10	-	116054582	116164537	AFAP1L2	109955	116162037	116167037
NM_001207008	chr6	+	168227670	168372700	AFDN	145030	168225170	168230170
NR_027906	chr6	-	168224569	168227476	AFDN-AS1	2907	168224976	168229976
NM_001166693	chr4	+	87856153	88062206	AFF1	206053	87853653	87858653
NR_038841	chr4	-	87846045	87856002	AFF1-AS1	9957	87853502	87858502
NM_002025	chrX	+	147582138	148082193	AFF2	500055	147579638	147584638
NM_002285	chr2	-	100163715	100759037	AFF3	595322	100756537	100761537
NM_014423	chr5	-	132211070	132299354	AFF4	88284	132296854	132301854
NM_145315	chr6	+	108616077	108846987	AFG1L	230910	108613577	108618577
NR_003228	chr16	+	90038987	90067195	AFG3L1P	28208	90036487	90041487
NM_006796	chr18	-	12328942	12377275	AFG3L2	48333	12374775	12379775
NM_001133	chr4	+	74347461	74369718	AFM	22257	74344961	74349961
NM_001145526	chr17	+	76183397	76203782	AFMID	20385	76180897	76185897
NM_001134	chr4	+	74301935	74321502	AFP	19567	74299435	74304435
NM_017657	chr2	+	64751438	64820138	AFTPH	68700	64748938	64753938
NR_033655	chr4	-	178351928	178363657	AGA	11729	178361157	178366157
NM_014914	chr2	+	236402732	237040444	AGAP1	637712	236400232	236405232
NM_133447	chr10	+	88730497	88769960	AGAP11	39463	88727997	88732997
NR_029396	chr10	-	49218158	49239658	AGAP12P	21500	49237158	49242158
NM_014770	chr12	-	58118075	58135944	AGAP2	17869	58133444	58138444
NM_001281300	chr7	+	150782917	150841523	AGAP3	58606	150780417	150785417
NM_001291379	chr10	-	46321039	46349325	AGAP4	28286	46346825	46351825
NM_001144000	chr10	-	75434032	75457554	AGAP5	23522	75455054	75460054
NM_001077665	chr10	+	51748077	51770259	AGAP6	22182	51745577	51750577
NR_126580	chr10	-	51464143	51486327	AGAP7P	22184	51483827	51488827
NM_001190810	chr10	+	48215723	48237508	AGAP9	21785	48213223	48218223
NM_152336	chr15	+	86623038	87572283	AGBL1	949245	86620538	86625538
NR_046012	chr15	-	86840064	86860199	AGBL1-AS1	20135	86857699	86862699
NM_024783	chr11	-	47681142	47736928	AGBL2	55786	47734428	47739428
NM_178563	chr7	+	134671258	134820530	AGBL3	149272	134668758	134673758
NM_001323575	chr1	-	48998526	50489626	AGBL4	1491100	50487126	50492126
NR_046839	chr1	-	49839872	49937757	AGBL4-IT1	97885	49935257	49940257
NR_138023	chr2	+	27274290	27293490	AGBL5	19200	27271790	27276790
NM_001136	chr6	-	32148744	32152099	AGER	3355	32149599	32154599
NM_001135187	chr2	+	228336887	228425938	AGFG1	89051	228334387	228339387
NM_006076	chr7	+	100136833	100165843	AGFG2	29010	100134333	100139333
NM_018046	chr5	+	76326209	76361058	AGGF1	34849	76323709	76328709
NM_018238	chr7	+	141251077	141354209	AGK	103132	141248577	141253577
NM_000642	chr1	+	100315639	100389579	AGL	73940	100313139	100318139
NM_024758	chr1	-	15898193	15911605	AGMAT	13412	15909105	15914105
NM_001004320	chr7	-	15239942	15601640	AGMO	361698	15599140	15604140
NM_001317123	chr1	+	36335408	36389899	AGO1	54491	36332908	36337908
NM_012154	chr8	-	141530249	141645645	AGO2	115396	141643145	141648145
NM_177422	chr1	+	36396682	36522063	AGO3	125381	36394182	36399182
NR_146062	chr1	+	36273224	36323490	AGO4	50266	36270724	36275724
NM_032741	chr6	-	32135982	32145888	AGPAT1	9906	32143388	32148388
NM_006412	chr9	-	139567594	139581911	AGPAT2	14317	139579411	139584411
NM_020132	chr21	+	45285115	45407475	AGPAT3	122360	45282615	45287615
NM_020133	chr6	-	161551056	161695107	AGPAT4	144051	161692607	161697607
NM_018361	chr8	+	6565877	6619021	AGPAT5	53144	6563377	6568377
NM_003659	chr2	+	178257470	178408564	AGPS	151094	178254970	178259970
NM_006408	chr7	-	16832263	16844738	AGR2	12475	16842238	16847238
NM_176813	chr7	-	16899029	16921613	AGR3	22584	16919113	16924113
NM_001305275	chr1	+	955502	991499	AGRN	35997	953002	958002
NM_000029	chr1	-	230838271	230850336	AGT	12065	230847836	230852836
NM_015239	chr9	-	88161453	88356944	AGTPBP1	195491	88354444	88359444
NM_000685	chr3	+	148415657	148460790	AGTR1	45133	148413157	148418157
NM_000686	chrX	+	115301957	115306225	AGTR2	4268	115299457	115304457
NM_020350	chr1	+	11796141	11810828	AGTRAP	14687	11793641	11798641
NM_000030	chr2	+	241808161	241818536	AGXT	10375	241805661	241810661
NM_001306173	chr5	-	34998205	35048240	AGXT2	50035	35045740	35050740
NM_001323342	chr1	-	247002399	247095280	AHCTF1	92881	247092780	247097780
NR_077058	chr2	-	162355577	162364413	AHCTF1P1	8836	162361913	162366913
NM_001161766	chr20	-	32868070	32899608	AHCY	31538	32897108	32902108
NM_001242673	chr1	+	110527386	110566364	AHCYL1	38978	110524886	110529886
NM_001130720	chr7	+	128864854	129070052	AHCYL2	205198	128862354	128867354
NM_001029882	chr1	-	27860755	27930005	AHDC1	69250	27927505	27932505
NM_017651	chr6	-	135605109	135818903	AHI1	213794	135816403	135821403
NM_024060	chr11	-	62201013	62314332	AHNAK	113319	62311832	62316832
NM_138420	chr14	-	105403587	105444694	AHNAK2	41107	105442194	105447194
NM_001621	chr7	+	17338275	17385775	AHR	47500	17335775	17340775
NM_020731	chr5	+	304290	438405	AHRR	134115	301790	306790
NM_001321441	chr14	+	77924219	77935815	AHSA1	11596	77921719	77926719
NM_001321305	chr2	+	61404552	61416060	AHSA2	11508	61402052	61407052
NM_001622	chr3	+	186330849	186339107	AHSG	8258	186328349	186333349
NM_020661	chr12	-	8754761	8765463	AICDA	10702	8762963	8767963
NM_022831	chr1	-	222841354	222885864	AIDA	44510	222883364	222888364
NM_001185095	chr9	+	133971862	133998539	AIF1L	26677	133969362	133974362
NM_004208	chrX	-	129263337	129299861	AIFM1	36524	129297361	129302361
NM_032797	chr10	-	71872022	71892690	AIFM2	20668	71890190	71895190
NM_144704	chr22	+	21319417	21335649	AIFM3	16232	21316917	21321917
NM_001286587	chr6	+	143380499	143661480	AIG1	280981	143377999	143382999
NM_004833	chr1	-	159032273	159046691	AIM2	14418	159044191	159049191
NM_001142415	chr4	+	107236766	107270381	AIMP1	33615	107234266	107239266
NM_006303	chr7	+	6048881	6063465	AIMP2	14584	6046381	6051381
NM_003977	chr11	+	67250499	67258579	AIP	8080	67247999	67252999
NM_001033055	chr17	-	6327056	6338519	AIPL1	11463	6336019	6341019
NM_000383	chr21	+	45705720	45718102	AIRE	12382	45703220	45708220
NR_047514	chr6	-	160424322	160428696	AIRN	4374	160426196	160431196
NM_018836	chr1	+	4715104	4843851	AJAP1	128747	4712604	4717604
NM_032876	chr14	-	23440382	23451851	AJUBA	11469	23449351	23454351
NM_001318121	chr9	-	130628758	130641900	AK1	13142	130639400	130644400
NM_001319142	chr1	-	33473540	33502512	AK2	28972	33500012	33505012
NM_001199853	chr9	-	4709556	4742043	AK3	32487	4739543	4744543
NM_203464	chr1	+	65613231	65697828	AK4	84597	65610731	65615731
NM_174858	chr1	+	77747661	78025654	AK5	277993	77745161	77750161
NM_001015891	chr5	-	68647552	68665840	AK6	18288	68663340	68668340
NM_001350888	chr14	+	96858424	96955764	AK7	97340	96855924	96860924
NM_152572	chr9	-	135600964	135754198	AK8	153234	135751698	135756698
NM_001145128	chr6	-	109814058	110012415	AK9	198357	110009915	110014915
NM_001330553	chr18	-	5142909	5197751	AKAIN1	54842	5195251	5200251
NM_003488	chr17	+	55162552	55198710	AKAP1	36158	55160052	55165052
NM_001330152	chr17	-	19807615	19881169	AKAP10	73554	19878669	19883669
NM_016248	chr13	+	42846288	42897403	AKAP11	51115	42843788	42848788
NM_005100	chr6	+	151561133	151679694	AKAP12	118561	151558633	151563633
NM_006738	chr15	+	85923846	86292589	AKAP13	368743	85921346	85926346
NM_178813	chrX	+	119029935	119054679	AKAP14	24744	119027435	119032435
NM_005088	chrX	+	1710485	1721411	AKAP17A	10926	1707985	1712985
NM_001198656	chr9	+	112810877	112934791	AKAP2	123914	112808377	112813377
NM_001278309	chr12	-	4724673	4758213	AKAP3	33540	4755713	4760713
NM_003886	chrX	-	49955410	49965664	AKAP4	10254	49963164	49968164
NM_004857	chr14	+	64932216	64941221	AKAP5	9005	64929716	64934716
NM_004274	chr14	+	32798478	33302268	AKAP6	503790	32795978	32800978
NM_016377	chr6	+	131456825	131604675	AKAP7	147850	131454325	131459325
NM_005858	chr19	-	15464331	15490612	AKAP8	26281	15488112	15493112
NM_014371	chr19	-	15490858	15529932	AKAP8L	39074	15527432	15532432
NM_147185	chr7	+	91570188	91739987	AKAP9	169799	91567688	91572688
NM_020642	chr11	+	8932700	8941626	AKIP1	8926	8930200	8935200
NM_024595	chr1	+	39456915	39471737	AKIRIN1	14822	39454415	39459415
NM_018064	chr6	-	88384577	88411985	AKIRIN2	27408	88409485	88414485
NM_001317952	chr9	-	117098406	117156685	AKNA	58279	117154185	117159185
NR_049760	chr1	-	109358519	109400864	AKNAD1	42345	109398364	109403364
NM_006066	chr1	+	46016454	46035723	AKR1A1	19269	46013954	46018954
NM_001346142	chr7	-	134127101	134143991	AKR1B1	16890	134141491	134146491
NM_020299	chr7	+	134212343	134226166	AKR1B10	13823	134209843	134214843
NM_001080538	chr7	+	134233848	134264592	AKR1B15	30744	134231348	134236348
NM_001353	chr10	+	5005453	5020158	AKR1C1	14705	5002953	5007953
NM_001354	chr10	-	5029967	5060225	AKR1C2	30258	5057725	5062725
NM_001253908	chr10	+	5090957	5149878	AKR1C3	58921	5088457	5093457
NM_001818	chr10	+	5238797	5260910	AKR1C4	22113	5236297	5241297
NR_026743	chr10	-	4913858	4958465	AKR1C6P	44607	4955965	4960965
NR_027916	chr10	-	5196654	5227150	AKR1C8P	30496	5224650	5229650
NM_001190906	chr7	+	137761177	137803050	AKR1D1	41873	137758677	137763677
NM_001271025	chr10	+	4868368	4890251	AKR1E2	21883	4865868	4870868
NM_003689	chr1	-	19629201	19638640	AKR7A2	9439	19636140	19641140
NM_012067	chr1	-	19609056	19615280	AKR7A3	6224	19612780	19617780
NM_001348421	chr1	-	19592475	19600616	AKR7L	8141	19598116	19603116
NM_001014432	chr14	-	105235686	105262080	AKT1	26394	105259580	105264580
NM_001278160	chr19	-	50372289	50381613	AKT1S1	9324	50379113	50384113
NM_001243028	chr19	-	40736223	40791302	AKT2	55079	40788802	40793802
NM_181690	chr1	-	243651534	244006584	AKT3	355050	244004084	244009084
NM_022476	chr16	-	53524951	53537216	AKTIP	12265	53534716	53539716
NM_000031	chr9	-	116148591	116163618	ALAD	15027	116161118	116166118
NM_001304444	chr3	+	52232098	52248343	ALAS1	16245	52229598	52234598
NM_000032	chrX	-	55035487	55057497	ALAS2	22010	55054997	55059997
NM_000477	chr4	+	74269955	74287201	ALB	17246	74267455	74272455
NM_001627	chr3	+	105085556	105295757	ALCAM	210201	105083056	105088056
NM_001145396	chr19	+	49956472	49974305	ALDH16A1	17833	49953972	49958972
NM_001323412	chr10	-	97365685	97416567	ALDH18A1	50882	97414067	97419067
NM_000689	chr9	-	75515577	75568233	ALDH1A1	52656	75565733	75570733
NM_001206897	chr15	-	58245621	58358121	ALDH1A2	112500	58355621	58360621
NM_001293815	chr15	+	101419896	101456830	ALDH1A3	36934	101417396	101422396
NM_000692	chr9	+	38392660	38398662	ALDH1B1	6002	38390160	38395160
NM_001270364	chr3	-	125822403	125900029	ALDH1L1	77626	125897529	125902529
NR_046602	chr3	+	125822482	125826912	ALDH1L1-AS1	4430	125819982	125824982
NR_046383	chr3	+	125898907	125929011	ALDH1L1-AS2	30104	125896407	125901407
NM_001034173	chr12	-	105413561	105478341	ALDH1L2	64780	105475841	105480841
NM_000690	chr12	+	112204690	112247789	ALDH2	43099	112202190	112207190
NM_000691	chr17	-	19641297	19651746	ALDH3A1	10449	19649246	19654246
NM_000382	chr17	+	19552063	19580908	ALDH3A2	28845	19549563	19554563
NM_001161473	chr11	+	67776016	67796749	ALDH3B1	20733	67773516	67778516
NM_001031615	chr11	-	67429632	67448685	ALDH3B2	19053	67446185	67451185
NM_001319218	chr1	-	19197923	19229293	ALDH4A1	31370	19226793	19231793
NM_001080	chr6	+	24495196	24537435	ALDH5A1	42239	24492696	24497696
NM_005589	chr14	-	74524367	74551196	ALDH6A1	26829	74548696	74553696
NM_001201377	chr5	-	125877532	125931082	ALDH7A1	53550	125928582	125933582
NM_170771	chr6	-	135238527	135271260	ALDH8A1	32733	135268760	135273760
NM_000696	chr1	-	165631448	165667900	ALDH9A1	36452	165665400	165670400
NM_000034	chr16	+	30064410	30081741	ALDOA	17331	30061910	30066910
NM_000035	chr9	-	104182841	104198062	ALDOB	15221	104195562	104200562
NM_005165	chr17	-	26900132	26903951	ALDOC	3819	26901451	26906451
NM_019109	chr16	+	5121809	5137380	ALG1	15571	5119309	5124309
NM_032834	chr12	+	34175215	34181236	ALG10	6021	34172715	34177715
NM_001013620	chr12	+	38710556	38723528	ALG10B	12972	38708056	38713056
NR_036571	chr13	+	52586522	52603780	ALG11	17258	52584022	52589022
NM_024105	chr22	-	50296853	50312106	ALG12	15253	50309606	50314606
NM_001099922	chrX	+	110924345	111003875	ALG13	79530	110921845	110926845
NR_131032	chr1	-	95448278	95538507	ALG14	90229	95536007	95541007
NM_001195223	chr3	-	125648117	125655887	ALG1L	7770	125653387	125658387
NM_001136152	chr3	+	129800673	129817233	ALG1L2	16560	129798173	129803173
NR_073386	chr11	-	71505408	71524905	ALG1L9P	19497	71522405	71527405
NR_024532	chr9	-	101978706	101984246	ALG2	5540	101981746	101986746
NM_001006941	chr3	-	183960116	183967313	ALG3	7197	183964813	183969813
NM_001142364	chr13	-	37523907	37573504	ALG5	49597	37571004	37576004
NM_013339	chr1	+	63833260	63904233	ALG6	70973	63830760	63835760
NM_024079	chr11	-	77811987	77850699	ALG8	38712	77848199	77853199
NM_024740	chr11	-	111652918	111742305	ALG9	89387	111739805	111744805
NM_004304	chr2	-	29415639	30144477	ALK	728838	30141977	30146977
NM_207413	chr8	-	53446596	53478021	ALKAL1	31425	53475521	53480521
NM_001002919	chr2	-	279560	288308	ALKAL2	8748	285808	290808
NM_006020	chr14	-	78138748	78174356	ALKBH1	35608	78171856	78176856
NM_001145374	chr12	-	109525992	109531293	ALKBH2	5301	109528793	109533793
NM_139178	chr11	+	43902356	43941825	ALKBH3	39469	43899856	43904856
NR_038907	chr11	-	43930838	43942494	ALKBH3-AS1	11656	43939994	43944994
NM_017621	chr7	-	102096666	102105321	ALKBH4	8655	102102821	102107821
NM_017758	chr17	+	18086866	18113267	ALKBH5	26401	18084366	18089366
NM_001297701	chr19	-	36500017	36505145	ALKBH6	5128	36502645	36507645
NM_032306	chr19	+	6372443	6375261	ALKBH7	2818	6369943	6374943
NM_138775	chr11	-	107373452	107436461	ALKBH8	63009	107433961	107438961
NM_018436	chr2	+	3705785	3750260	ALLC	44475	3703285	3708285
NM_015120	chr2	+	73612885	73837046	ALMS1	224161	73610385	73615385
NR_003683	chr2	+	73872045	73912694	ALMS1P1	40649	73869545	73874545
NM_000697	chr17	+	6899383	6914055	ALOX12	14672	6896883	6901883
NR_040089	chr17	-	6888441	6915653	ALOX12-AS1	27212	6913153	6918153
NM_001139	chr17	-	7975953	7991021	ALOX12B	15068	7988521	7993521
NR_002710	chr17	+	6756894	6803668	ALOX12P2	46774	6754394	6759394
NM_001140	chr17	-	4534213	4544960	ALOX15	10747	4542460	4547460
NM_001039130	chr17	+	7942357	7952451	ALOX15B	10094	7939857	7944857
NR_045985	chr17	+	6561037	6564701	ALOX15P1	3664	6558537	6563537
NM_001320861	chr10	+	45869613	45941567	ALOX5	71954	45867113	45872113
NM_001204406	chr13	+	31287614	31338565	ALOX5AP	50951	31285114	31290114
NM_001165960	chr17	-	7999217	8022234	ALOXE3	23017	8019734	8024734
NM_001631	chr2	+	233320821	233325455	ALPI	4634	233318321	233323321
NM_025144	chr4	+	113218498	113363764	ALPK1	145266	113215998	113220998
NM_052947	chr18	-	56148481	56296189	ALPK2	147708	56293689	56298689
NM_020778	chr15	+	85359910	85416713	ALPK3	56803	85357410	85362410
NM_000478	chr1	+	21835850	21904905	ALPL	69055	21833350	21838350
NM_001632	chr2	+	233243243	233247599	ALPP	4356	233240743	233245743
NM_031313	chr2	+	233271551	233275424	ALPPL2	3873	233269051	233274051
NM_020919	chr2	-	202564985	202645895	ALS2	80910	202643395	202648395
NR_033815	chr3	-	46710484	46735203	ALS2CL	24719	46732703	46737703
NR_110620	chr2	-	202152993	202222121	ALS2CR12	69128	202219621	202224621
NM_006982	chr12	+	85674035	85695561	ALX1	21526	85671535	85676535
NM_006492	chr1	-	110602996	110613322	ALX3	10326	110610822	110615822
NM_021926	chr11	-	44282277	44331716	ALX4	49439	44329216	44334216
NM_005782	chr17	-	79845710	79849462	ALYREF	3752	79846962	79851962
NM_203382	chr5	-	33987090	34008220	AMACR	21130	34005720	34010720
NM_016519	chr4	+	71457974	71473004	AMBN	15030	71455474	71460474
NM_001633	chr9	-	116822407	116840752	AMBP	18345	116838252	116843252
NM_001300731	chr11	-	46417961	46615619	AMBRA1	197658	46613119	46618119
NM_001287215	chr6	+	111135823	111216915	AMD1	81092	111133323	111138323
NM_152435	chr12	+	96337070	96362370	AMDHD1	25300	96334570	96339570
NM_001145815	chr16	+	2570362	2580955	AMDHD2	10593	2567862	2572862
NM_001142	chrX	+	11311532	11318881	AMELX	7349	11309032	11314032
NM_001143	chrY	-	6733958	6742068	AMELY	8110	6739568	6744568
NM_152424	chrX	-	63404996	63425624	AMER1	20628	63423124	63428124
NM_152704	chr13	-	25735816	25746421	AMER2	10605	25743921	25748921
NM_152698	chr2	+	131513076	131525707	AMER3	12631	131510576	131515576
NM_001144	chr16	-	56395363	56459450	AMFR	64087	56456950	56461950
NM_000479	chr19	+	2249277	2252072	AMH	2795	2246777	2251777
NM_001164690	chr12	+	53817638	53825456	AMHR2	7818	53815138	53820138
NM_020703	chr1	-	110049445	110052336	AMIGO1	2891	110049836	110054836
NM_181847	chr12	-	47469489	47473734	AMIGO2	4245	47471234	47476234
NM_198722	chr3	-	49754266	49757238	AMIGO3	2972	49754738	49759738
NM_001171689	chrX	-	109437413	109683461	AMMECR1	246048	109680961	109685961
NM_001199140	chr2	-	128619206	128643514	AMMECR1L	24308	128641014	128646014
NM_030943	chr14	+	103388992	103397179	AMN	8187	103386492	103391492
NR_103523	chr12	-	31824070	31882108	AMN1	58038	31879608	31884608
NM_133265	chrX	-	112018104	112084043	AMOT	65939	112081543	112086543
NM_130847	chr11	+	94501507	94609918	AMOTL1	108411	94499007	94504007
NM_001278683	chr3	-	134074186	134094259	AMOTL2	20073	134091759	134096759
NM_000036	chr1	-	115215719	115238239	AMPD1	22520	115235739	115240739
NM_001257360	chr1	+	110162434	110174677	AMPD2	12243	110159934	110164934
NM_001172431	chr11	+	10471867	10529126	AMPD3	57259	10469367	10474367
NM_139316	chr7	-	38423296	38671167	AMPH	247871	38668667	38673667
NM_001164711	chr3	-	49454210	49460111	AMT	5901	49457611	49462611
NM_001286731	chr4	+	71384288	71398460	AMTN	14172	71381788	71386788
NM_001008221	chr1	-	104230039	104239073	AMY1A	9034	104236573	104241573
NM_001008218	chr1	-	104230040	104238889	AMY1B	8849	104236389	104241389
NM_001346780	chr1	-	104230036	104239076	AMY1C	9040	104236576	104241576
NM_000699	chr1	+	104159953	104168402	AMY2A	8449	104157453	104162453
NM_020978	chr1	+	104097265	104122156	AMY2B	24891	104094765	104099765
NM_001321766	chr7	+	2727835	2804759	AMZ1	76924	2725335	2730335
NM_001346471	chr17	+	66202269	66253305	AMZ2	51036	66199769	66204769
NR_026903	chr17	-	62962667	62971703	AMZ2P1	9036	62969203	62974203
NM_022662	chr2	-	112525213	112641741	ANAPC1	116528	112639241	112644241
NM_001256708	chr4	-	145915726	146019693	ANAPC10	103967	146017193	146022193
NM_001289414	chr17	+	79848665	79858409	ANAPC11	9744	79846165	79851165
NM_001242374	chr3	-	134196545	134204865	ANAPC13	8320	134202365	134207365
NM_001330321	chr11	-	71817421	71823826	ANAPC15	6405	71821326	71826326
NM_001242547	chr10	+	73975757	73995618	ANAPC16	19861	73973257	73978257
NR_037931	chr2	+	87088947	87122165	ANAPC1P1	33218	87086447	87091447
NM_013366	chr9	-	140069235	140083057	ANAPC2	13822	140080557	140085557
NM_013367	chr4	+	25378847	25420120	ANAPC4	41273	25376347	25381347
NM_001137559	chr12	-	121746047	121792012	ANAPC5	45965	121789512	121794512
NM_016238	chr12	-	110810704	110841535	ANAPC7	30831	110839035	110844035
NM_001145	chr14	+	21152335	21162345	ANG	10010	21149835	21154835
NM_015305	chr14	-	77253585	77279283	ANGEL1	25698	77276783	77281783
NR_125333	chr1	-	213165523	213189217	ANGEL2	23694	213186717	213191717
NM_001146	chr8	-	108261709	108510283	ANGPT1	248574	108507783	108512783
NM_001118887	chr8	-	6357174	6420784	ANGPT2	63610	6418284	6423284
NM_015985	chr20	-	850541	896977	ANGPT4	46436	894477	899477
NM_004673	chr1	-	178818669	178840215	ANGPTL1	21546	178837715	178842715
NM_012098	chr9	-	129849627	129885044	ANGPTL2	35417	129882544	129887544
NM_014495	chr1	+	63063157	63071976	ANGPTL3	8819	63060657	63065657
NM_139314	chr19	+	8429010	8439259	ANGPTL4	10249	8426510	8431510
NM_178127	chr11	-	101761404	101787253	ANGPTL5	25849	101784753	101789753
NM_031917	chr19	-	10203012	10213425	ANGPTL6	10413	10210925	10215925
NM_021146	chr1	+	11249345	11256038	ANGPTL7	6693	11246845	11251845
NM_001191054	chr12	-	133794897	133812422	ANHX	17525	133809922	133814922
NM_001142446	chr8	-	41510743	41754280	ANK1	243537	41751780	41756780
NM_001127493	chr4	+	113739238	114304896	ANK2	565658	113736738	113741738
NM_001204403	chr10	-	61786055	62493284	ANK3	707229	62490784	62495784
NM_144708	chr2	+	190540710	190611376	ANKAR	70666	190538210	190543210
NM_182703	chr15	+	65204100	65251041	ANKDD1A	46941	65201600	65206600
NM_001276713	chr5	+	74907300	74967671	ANKDD1B	60371	74904800	74909800
NM_022096	chr20	+	10015646	10037410	ANKEF1	21764	10013146	10018146
NM_153228	chr17	+	54230835	54560007	ANKFN1	329172	54228335	54233335
NM_016376	chr17	-	4067111	4167290	ANKFY1	100179	4164790	4169790
NM_054027	chr5	-	14704908	14871887	ANKH	166979	14869387	14874387
NM_017747	chr5	+	139781398	139919441	ANKHD1	138043	139778898	139783898
NM_020690	chr5	+	139781398	139929163	ANKHD1-EIF4EBP3	147765	139778898	139783898
NM_019004	chr7	+	91875547	92030698	ANKIB1	155151	91873047	91878047
NM_178510	chr11	+	113258512	113271140	ANKK1	12628	113256012	113261012
NR_103530	chr19	+	17392453	17398455	ANKLE1	6002	17389953	17394953
NM_015114	chr12	-	133302252	133338474	ANKLE2	36222	133335974	133340974
NM_001308375	chr2	-	241418838	241500527	ANKMY1	81689	241498027	241503027
NM_020319	chr7	-	16639400	16685442	ANKMY2	46042	16682942	16687942
NM_023039	chr5	-	72848024	72861511	ANKRA2	13487	72859011	72864011
NM_014391	chr10	-	92671856	92681032	ANKRD1	9176	92678532	92683532
NM_017664	chr13	-	111530886	111567454	ANKRD10	36568	111564954	111569954
NM_013275	chr16	-	89334028	89556969	ANKRD11	222941	89554469	89559469
NM_015208	chr18	+	9136750	9285983	ANKRD12	149233	9134250	9139250
NM_033121	chr12	+	110437234	110477235	ANKRD13A	40001	110434734	110439734
NM_152345	chr17	+	27920526	27941779	ANKRD13B	21253	27918026	27923026
NM_030816	chr1	-	70724684	70820417	ANKRD13C	95733	70817917	70822917
NM_207354	chr11	+	67056761	67069955	ANKRD13D	13194	67054261	67059261
NM_019046	chr10	-	5903688	5931860	ANKRD16	28172	5929360	5934360
NM_032217	chr4	-	73939682	74124515	ANKRD17	184833	74122015	74127015
NM_001331100	chr9	-	38571360	38620657	ANKRD18A	49297	38618157	38623157
NM_001244752	chr9	+	33524410	33573001	ANKRD18B	48591	33521910	33526910
NR_136286	chr9	-	99918174	100001024	ANKRD18CP	82850	99998524	100003524
NR_003291	chr3	-	197784403	197807542	ANKRD18DP	23139	197805042	197810042
NR_026868	chr9	+	95571892	95600739	ANKRD19P	28847	95569392	95574392
NM_001346797	chr10	+	99332197	99343653	ANKRD2	11456	99329697	99334697
NM_032250	chr9	+	67926760	67969840	ANKRD20A1	43080	67924260	67929260
NR_027270	chr21	-	15316095	15352765	ANKRD20A11P	36670	15350265	15355265
NR_046228	chr1	-	142697420	142713605	ANKRD20A12P	16185	142711105	142716105
NR_073430	chr13	-	24481422	24523454	ANKRD20A19P	42032	24520954	24525954
NM_001012421	chr9	-	43090424	43133544	ANKRD20A2	43120	43131044	43136044
NM_001012419	chr9	-	43089971	43133510	ANKRD20A3	43539	43131010	43136010
NM_001098805	chr9	+	69381980	69425109	ANKRD20A4	43129	69379480	69384480
NR_146419	chr9	+	69381811	69481660	ANKRD20A4-ANKRD20A20P	99849	69379311	69384311
NR_040113	chr18	+	14179095	14227049	ANKRD20A5P	47954	14176595	14181595
NR_003366	chr2	-	95426672	95522820	ANKRD20A8P	96148	95520320	95525320
NR_138091	chr13	-	19385282	19446107	ANKRD20A9P	60825	19443607	19448607
NM_144590	chr10	-	90579658	90611732	ANKRD22	32074	90609232	90614232
NM_144994	chr2	-	97503650	97509758	ANKRD23	6108	97507258	97512258
NM_133475	chr19	+	4183350	4224811	ANKRD24	41461	4180850	4185850
NM_001256053	chr10	-	27293044	27389427	ANKRD26	96383	27386927	27391927
NR_026556	chr16	-	46503248	46603009	ANKRD26P1	99761	46600509	46605509
NR_027248	chr13	-	19836939	19919113	ANKRD26P3	82174	19916613	19921613
NM_032139	chr19	-	33087906	33166102	ANKRD27	78196	33163602	33168602
NM_015199	chr3	-	15708743	15901053	ANKRD28	192310	15898553	15903553
NM_173505	chr18	-	21178889	21242849	ANKRD29	63960	21240349	21245349
NM_052997	chr10	+	37414784	37521495	ANKRD30A	106711	37412284	37417284
NM_001145029	chr18	+	14748238	14852737	ANKRD30B	104499	14745738	14750738
NR_027020	chr2	-	132905163	133015542	ANKRD30BL	110379	133013042	133018042
NR_026916	chr21	+	14410486	14490571	ANKRD30BP2	80085	14407986	14412986
NR_033891	chr10	+	45650109	45681489	ANKRD30BP3	31380	45647609	45652609
NM_001164443	chr5	-	74364121	74532703	ANKRD31	168582	74530203	74535203
NM_001130015	chr12	+	52281792	52285505	ANKRD33	3713	52279292	52284292
NM_001164440	chr5	+	10564434	10657928	ANKRD33B	93494	10561934	10566934
NM_001039888	chr1	+	145470507	145475647	ANKRD34A	5140	145468007	145473007
NM_001004441	chr5	-	79852573	79866304	ANKRD34B	13731	79863804	79868804
NM_001146341	chr15	+	79575145	79590581	ANKRD34C	15436	79572645	79577645
NR_038997	chr15	-	79484048	79576287	ANKRD34C-AS1	92239	79573787	79578787
NM_001280799	chr1	+	145549208	145568526	ANKRD35	19318	145546708	145551708
NM_001164315	chr2	+	97779232	97930257	ANKRD36	151025	97776732	97781732
NM_025190	chr2	-	98121260	98206428	ANKRD36B	85168	98203928	98208928
NR_015424	chr2	+	89065418	89106109	ANKRD36BP2	40691	89062918	89067918
NM_001310154	chr2	-	96515295	96658068	ANKRD36C	142773	96655568	96660568
NM_181726	chr4	+	186317839	186321399	ANKRD37	3560	186315339	186320339
NM_016466	chr2	-	97513723	97523756	ANKRD39	10033	97521256	97526256
NM_052855	chr17	-	48770550	48785270	ANKRD40	14720	48782770	48787770
NM_001300972	chr11	+	82904780	82967141	ANKRD42	62361	82902280	82907280
NM_001195144	chr2	-	197851385	198175521	ANKRD44	324136	198173021	198178021
NR_046837	chr2	-	198115581	198167243	ANKRD44-IT1	51662	198164743	198169743
NM_198493	chr1	-	173577474	173639001	ANKRD45	61527	173636501	173641501
NM_001270379	chr8	-	101521979	101572014	ANKRD46	50035	101569514	101574514
NM_017704	chr11	+	94227152	94232744	ANKRD49	5592	94224652	94229652
NM_020337	chr4	-	125585203	125633887	ANKRD50	48684	125631387	125636387
NM_173595	chr12	-	56631590	56652143	ANKRD52	20553	56649643	56654643
NM_024933	chr2	+	71205574	71212629	ANKRD53	7055	71203074	71208074
NM_001349853	chr22	-	38226861	38245325	ANKRD54	18464	38242825	38247825
NM_024669	chr5	-	55395506	55529186	ANKRD55	133680	55526686	55531686
NM_001242809	chr6	+	90142896	90343553	ANKRD6	200657	90140396	90145396
NM_001304369	chr20	-	56791181	56803709	ANKRD60	12528	56801209	56806209
NM_001271700	chr7	+	6071006	6076183	ANKRD61	5177	6068506	6073506
NM_001277333	chr18	+	12093847	12129748	ANKRD62	35901	12091347	12096347
NR_040115	chr22	-	17134598	17156430	ANKRD62P1-PARP4P3	21832	17153930	17158930
NM_001190479	chr15	-	40570572	40574787	ANKRD63	4215	40572287	40577287
NM_001145210	chr1	-	1353799	1356824	ANKRD65	3025	1354324	1359324
NM_001162435	chr6	+	46714653	46726954	ANKRD66	12301	46712153	46717153
NM_019644	chr7	+	117864711	117882784	ANKRD7	18073	117862211	117867211
NM_001348652	chr14	-	102969985	102976143	ANKRD9	6158	102973643	102978643
NM_015245	chr6	+	34857037	35059190	ANKS1A	202153	34854537	34859537
NM_152788	chr12	-	99128568	100378432	ANKS1B	1249864	100375932	100380932
NM_001242929	chr16	-	4746510	4784378	ANKS3	37868	4781878	4786878
NM_145865	chr16	+	21245015	21263750	ANKS4B	18735	21242515	21247515
NM_173551	chr9	-	101494290	101558824	ANKS6	64534	101556324	101561324
NM_001315505	chr3	-	149479225	149510610	ANKUB1	31385	149508110	149513110
NM_001282792	chr2	+	220094478	220101391	ANKZF1	6913	220091978	220096978
NM_001284302	chr7	+	36429411	36493401	ANLN	63990	36426911	36431911
NM_018043	chr11	+	69924407	70035652	ANO1	111245	69921907	69926907
NR_103835	chr11	-	69918539	69921454	ANO1-AS2	2915	69918954	69923954
NM_001346468	chr3	-	43407817	43733086	ANO10	325269	43730586	43735586
NM_001278597	chr12	-	5671816	6055398	ANO2	383582	6052898	6057898
NM_001313726	chr11	+	26210669	26684836	ANO3	474167	26208169	26213169
NM_178826	chr12	+	101188373	101522419	ANO4	334046	101185873	101190873
NM_001142649	chr11	+	22214721	22304913	ANO5	90192	22212221	22217221
NM_001142679	chr12	+	45609769	45834187	ANO6	224418	45607269	45612269
NM_001001891	chr2	+	242127923	242164791	ANO7	36868	242125423	242130423
NM_020959	chr19	-	17434031	17445638	ANO8	11607	17443138	17448138
NM_001012302	chr11	-	417929	442011	ANO9	24082	439511	444511
NM_000216	chrX	-	8496914	8700228	ANOS1	203314	8697728	8702728
NM_006305	chr15	-	69070874	69113261	ANP32A	42387	69110761	69115761
NR_026808	chr15	-	69096159	69099440	ANP32A-IT1	3281	69096940	69101940
NM_006401	chr9	+	100745488	100778224	ANP32B	32736	100742988	100747988
NM_001280560	chr1	-	150190716	150208504	ANP32E	17788	150206004	150211004
NM_001150	chr15	-	90328125	90358072	ANPEP	29947	90355572	90360572
NM_032208	chr2	+	69240275	69476459	ANTXR1	236184	69237775	69242775
NM_001286780	chr4	-	80822770	80994626	ANTXR2	171856	80992126	80997126
NM_001278688	chr10	+	47658232	47701443	ANTXRL	43211	47655732	47660732
NR_103827	chr10	-	47590260	47640844	ANTXRLP1	50584	47638344	47643344
NM_000700	chr9	+	75766646	75785310	ANXA1	18664	75764146	75769146
NM_007193	chr4	+	169013687	169108893	ANXA10	95206	169011187	169016187
NM_001278407	chr10	-	81914879	81965433	ANXA11	50554	81962933	81967933
NM_001003954	chr8	-	124693033	124749666	ANXA13	56633	124747166	124752166
NM_004039	chr15	-	60639349	60690185	ANXA2	50836	60687685	60692685
NM_005139	chr4	+	79472741	79531605	ANXA3	58864	79470241	79475241
NM_001320698	chr2	+	69870936	70053609	ANXA4	182673	69868436	69873436
NM_001154	chr4	-	122589151	122618147	ANXA5	28996	122615647	122620647
NM_001155	chr5	-	150480266	150537443	ANXA6	57177	150534943	150539943
NM_001320879	chr10	-	75134858	75173843	ANXA7	38985	75171343	75176343
NM_001271703	chr10	+	48255203	48271368	ANXA8	16165	48252703	48257703
NM_001098845	chr10	+	47746849	47763040	ANXA8L1	16191	47744349	47749349
NM_003568	chr1	+	150954498	150968114	ANXA9	13616	150951998	150956998
NM_001177507	chr7	-	36552548	36764154	AOAH	211606	36761654	36766654
NM_001272072	chr7	+	150549564	150558379	AOC1	8815	150547064	150552064
NM_001158	chr17	+	40996599	41002729	AOC2	6130	40994099	40999099
NM_003734	chr17	+	41003200	41010147	AOC3	6947	41000700	41005700
NM_001159	chr2	+	201450730	201536217	AOX1	85487	201448230	201453230
NR_135012	chr2	+	201560445	201659638	AOX3P-AOX2P	99193	201557945	201562945
NR_136622	chr4	+	113152894	113194266	AP1AR	41372	113150394	113155394
NM_145730	chr22	-	29723668	29784572	AP1B1	60904	29782072	29787072
NR_040114	chr22	+	32517963	32529456	AP1B1P1	11493	32515463	32520463
NM_001128	chr16	-	71762904	71842976	AP1G1	80072	71840476	71845476
NM_001282474	chr14	-	24028771	24037045	AP1G2	8274	24034545	24039545
NM_032493	chr19	+	16308664	16346156	AP1M1	37492	16306164	16311164
NM_001300887	chr19	-	10683346	10697991	AP1M2	14645	10695491	10700491
NM_001283	chr7	+	100797685	100804557	AP1S1	6872	100795185	100800185
NM_003916	chrX	-	15843928	15873137	AP1S2	29209	15870637	15875637
NR_110905	chr2	-	224620046	224702319	AP1S3	82273	224699819	224704819
NM_130787	chr19	+	50270179	50310369	AP2A1	40190	50267679	50272679
NR_144509	chr11	+	925808	1012245	AP2A2	86437	923308	928308
NM_001282	chr17	+	33914281	34053436	AP2B1	139155	33911781	33916781
NM_004068	chr3	+	183892633	183901879	AP2M1	9246	183890133	183895133
NM_001301078	chr19	-	47341414	47354252	AP2S1	12838	47351752	47356752
NM_003664	chr5	-	77298149	77590579	AP3B1	292430	77588079	77593079
NM_001278511	chr15	-	83328032	83378660	AP3B2	50628	83376160	83381160
NM_003938	chr19	-	2100986	2151556	AP3D1	50570	2149056	2154056
NM_207012	chr10	-	75880014	75910843	AP3M1	30829	75908343	75913343
NM_001134296	chr8	+	42010463	42028701	AP3M2	18238	42007963	42012963
NM_001318093	chr5	+	115177302	115249778	AP3S1	72476	115174802	115179802
NM_005829	chr15	-	90373830	90437617	AP3S2	63787	90435117	90440117
NM_001253853	chr1	-	114436816	114447746	AP4B1	10930	114445246	114450246
NR_125965	chr1	+	114355233	114443859	AP4B1-AS1	88626	114352733	114357733
NM_001252127	chr15	+	51200868	51298097	AP4E1	97229	51198368	51203368
NM_004722	chr7	+	99699129	99704803	AP4M1	5674	99696629	99701629
NM_001254729	chr14	+	31494311	31565656	AP4S1	71345	31491811	31496811
NM_138368	chr11	-	65541368	65548062	AP5B1	6694	65545562	65550562
NR_026895	chr14	+	57735605	57756797	AP5M1	21192	57733105	57738105
NM_018347	chr20	+	3801170	3805954	AP5S1	4784	3798670	3803670
NM_014855	chr7	+	4815261	4834026	AP5Z1	18765	4812761	4817761
NM_013229	chr12	+	99039077	99129211	APAF1	90134	99036577	99041577
NM_001163	chr9	-	72042448	72287275	APBA1	244827	72284775	72289775
NM_001130414	chr15	+	29213839	29410516	APBA2	196677	29211339	29216339
NM_004886	chr19	-	3750770	3761673	APBA3	10903	3759173	3764173
NM_145689	chr11	-	6416353	6440702	APBB1	24349	6438202	6443202
NM_019043	chr10	+	26727265	26856732	APBB1IP	129467	26724765	26729765
NM_173075	chr4	-	40812043	41216635	APBB2	404592	41214135	41219135
NM_006051	chr5	-	139937852	139944189	APBB3	6337	139941689	139946689
NM_001127511	chr5	+	112043201	112181936	APC	138735	112040701	112045701
NM_005883	chr19	+	1450147	1473243	APC2	23096	1447647	1452647
NM_153000	chr18	+	10454624	10488698	APCDD1	34074	10452124	10457124
NM_153360	chr20	-	57034159	57089994	APCDD1L	55835	57087494	57092494
NR_034147	chr20	+	57090434	57194948	APCDD1L-AS1	104514	57087934	57092934
NM_001640	chr3	+	49711434	49720934	APEH	9500	49708934	49713934
NM_001297550	chr4	+	165798139	165818679	APELA	20540	165795639	165800639
NM_080649	chr14	+	20923289	20925931	APEX1	2642	20920789	20925789
NM_014481	chrX	+	55026755	55034306	APEX2	7551	55024255	55029255
NM_016022	chr1	-	150237798	150241609	APH1A	3811	150239109	150244109
NM_001145646	chr15	+	63569748	63601325	APH1B	31577	63567248	63572248
NR_024625	chr11	+	43333504	43366080	API5	32576	43331004	43336004
NM_015957	chr11	-	34903842	34937958	APIP	34116	34935458	34940458
NM_173545	chr2	+	68694690	68807294	APLF	112604	68692190	68697190
NM_017413	chrX	-	128779235	128788933	APLN	9698	128786433	128791433
NM_005161	chr11	-	57001051	57004927	APLNR	3876	57002427	57007427
NM_005166	chr19	+	36359346	36370699	APLP1	11353	36356846	36361846
NM_001642	chr11	+	129939715	130014706	APLP2	74991	129937215	129942215
NM_020531	chr20	-	24943579	24973425	APMAP	29846	24970925	24975925
NR_126362	chr11	+	116706832	116726445	APOA1-AS	19613	116704332	116709332
NM_000482	chr11	-	116691417	116694011	APOA4	2594	116691511	116696511
NM_052968	chr11	-	116660085	116663136	APOA5	3051	116660636	116665636
NM_000384	chr2	-	21224300	21266945	APOB	42645	21264445	21269445
NM_001304566	chr12	-	7801995	7823195	APOBEC1	21200	7820695	7825695
NM_006789	chr6	+	41020939	41032630	APOBEC2	11691	41018439	41023439
NM_001270406	chr22	+	39353526	39359188	APOBEC3A	5662	39351026	39356026
NM_001193289	chr22	+	39353526	39388783	APOBEC3A_B	35257	39351026	39356026
NM_001270411	chr22	+	39378403	39388784	APOBEC3B	10381	39375903	39380903
NR_104187	chr22	-	39387563	39394225	APOBEC3B-AS1	6662	39391725	39396725
NM_014508	chr22	+	39410264	39414825	APOBEC3C	4561	39407764	39412764
NM_152426	chr22	+	39417117	39429256	APOBEC3D	12139	39414617	39419617
NM_145298	chr22	+	39436672	39451975	APOBEC3F	15303	39434172	39439172
NM_021822	chr22	+	39473009	39483748	APOBEC3G	10739	39470509	39475509
NM_001166003	chr22	+	39493228	39500072	APOBEC3H	6844	39490728	39495728
NM_203454	chr1	-	183615410	183622448	APOBEC4	7038	183619948	183624948
NM_018690	chr16	+	28505969	28510291	APOBR	4322	28503469	28508469
NM_001321066	chr19	+	45417503	45422606	APOC1	5103	45415003	45420003
NR_028413	chr19	+	45430059	45434643	APOC1P1	4584	45427559	45432559
NM_000483	chr19	+	45449238	45452822	APOC2	3584	45446738	45451738
NM_000040	chr11	+	116700623	116703787	APOC3	3164	116698123	116703123
NM_001646	chr19	+	45445494	45448753	APOC4	3259	45442994	45447994
NR_037932	chr19	+	45445494	45452822	APOC4-APOC2	7328	45442994	45447994
NM_001647	chr3	-	195295572	195311076	APOD	15504	195308576	195313576
NM_001302688	chr19	+	45409005	45412652	APOE	3647	45406505	45411505
NM_000042	chr17	-	64208146	64225556	APOH	17410	64223056	64228056
NM_001136540	chr22	+	36649116	36663577	APOL1	14461	36646616	36651616
NM_145637	chr22	-	36622254	36636000	APOL2	13746	36633500	36638500
NM_145642	chr22	-	36536370	36562225	APOL3	25855	36559725	36564725
NM_145660	chr22	-	36585175	36600879	APOL4	15704	36598379	36603379
NM_030642	chr22	+	36113918	36125529	APOL5	11611	36111418	36116418
NM_030641	chr22	+	36044423	36064456	APOL6	20033	36041923	36046923
NM_001130415	chr12	+	12878850	12944399	APOLD1	65549	12876350	12881350
NM_001256169	chr6	+	31620186	31625987	APOM	5801	31617686	31622686
NR_026545	chrX	-	23851464	23926057	APOO	74593	23923557	23928557
NM_198450	chrX	+	84258897	84348323	APOOL	89426	84256397	84261397
NM_032374	chr14	+	104029293	104058510	APOPT1	29217	104026793	104031793
NM_001136131	chr21	-	27252860	27543446	APP	290586	27540946	27545946
NM_001282476	chr17	-	58520509	58603601	APPBP2	83092	58601101	58606101
NM_012096	chr3	+	57261764	57307498	APPL1	45734	57259264	57264264
NM_018171	chr12	-	105567074	105630008	APPL2	62934	105627508	105632508
NR_134251	chr7	-	77286976	77325582	APTR	38606	77323082	77328082
NM_001195251	chr9	-	32972603	33001639	APTX	29036	32999139	33004139
NM_001329872	chr7	+	30951308	30965132	AQP1	13824	30948808	30953808
NM_080429	chr1	+	154293591	154297801	AQP10	4210	154291091	154296091
NM_173039	chr11	+	77300679	77321401	AQP11	20722	77298179	77303179
NM_198998	chr2	+	241631261	241637900	AQP12A	6639	241628761	241633761
NM_001102467	chr2	-	241615834	241622317	AQP12B	6483	241619817	241624817
NM_000486	chr12	+	50344523	50352664	AQP2	8141	50342023	50347023
NM_001318144	chr9	-	33441151	33447631	AQP3	6480	33445131	33450131
NM_001650	chr18	-	24432001	24445808	AQP4	13807	24443308	24448308
NR_026908	chr18	+	24445271	24515910	AQP4-AS1	70639	24442771	24447771
NM_001651	chr12	+	50355278	50359465	AQP5	4187	50352778	50357778
NM_001652	chr12	+	50366619	50370922	AQP6	4303	50364119	50369119
NR_134513	chr9	-	33384947	33402680	AQP7	17733	33400180	33405180
NR_002817	chr9	-	67270214	67289492	AQP7P1	19278	67286992	67291992
NR_026558	chr9	+	42858151	42893137	AQP7P3	34986	42855651	42860651
NM_001169	chr16	+	25228284	25240253	AQP8	11969	25225784	25230784
NM_001320636	chr15	+	58430367	58478110	AQP9	47743	58427867	58432867
NM_014691	chr15	-	35148551	35261995	AQR	113444	35259495	35264495
NM_000044	chrX	+	66764464	66950461	AR	185997	66761964	66766964
NM_001654	chrX	+	47420498	47431320	ARAF	10822	47417998	47422998
NM_001040118	chr11	-	72396113	72463434	ARAP1	67321	72460934	72465934
NR_146780	chr11	+	72411518	72416652	ARAP1-AS2	5134	72409018	72414018
NR_146893	chr4	-	36007025	36245561	ARAP2	238536	36243061	36248061
NM_022481	chr5	-	141032967	141061800	ARAP3	28833	141059300	141064300
NM_015193	chr8	-	143692404	143695833	ARC	3429	143693333	143698333
NM_001655	chr11	+	118443101	118473747	ARCN1	30646	118440601	118445601
NM_001657	chr4	+	75310814	75320726	AREG	9912	75308314	75313314
NM_001039479	chr14	-	75127954	75179807	AREL1	51853	75177307	75182307
NM_001024226	chr1	+	228270360	228286913	ARF1	16553	228267860	228272860
NM_001659	chr12	-	49329991	49351252	ARF3	21261	49348752	49353752
NM_001660	chr3	-	57557089	57583215	ARF4	26126	57580715	57585715
NR_132369	chr3	+	57583515	57586642	ARF4-AS1	3127	57581015	57586015
NM_001662	chr7	+	127228405	127231759	ARF5	3354	127225905	127230905
NM_001663	chr14	+	50359735	50363772	ARF6	4037	50357235	50362235
NM_018209	chr20	+	61904136	61921142	ARFGAP1	17006	61901636	61906636
NM_001242832	chr11	-	47185848	47198676	ARFGAP2	12828	47196176	47201176
NM_014570	chr22	-	43192531	43253408	ARFGAP3	60877	43250908	43255908
NM_006421	chr8	-	68109883	68255912	ARFGEF1	146029	68253412	68258412
NM_006420	chr20	+	47538274	47653230	ARFGEF2	114956	47535774	47540774
NM_020340	chr6	+	138483052	138665800	ARFGEF3	182748	138480552	138485552
NM_001025593	chr4	+	153701088	153833063	ARFIP1	131975	153698588	153703588
NM_001242855	chr11	-	6495912	6502709	ARFIP2	6797	6500209	6505209
NM_001267549	chr20	-	62329994	62339365	ARFRP1	9371	62336865	62341865
NM_001244438	chr6	+	131894343	131905472	ARG1	11129	131891843	131896843
NM_001172	chr14	+	68086578	68118436	ARG2	31858	68084078	68089078
NM_001012659	chr3	+	121286777	121309469	ARGFX	22692	121284277	121289277
NM_018011	chr13	-	107195661	107220514	ARGLU1	24853	107218014	107223014
NM_004308	chr11	-	46698624	46722215	ARHGAP1	23591	46719715	46724715
NM_024605	chr4	+	148653452	148993927	ARHGAP10	340475	148650952	148655952
NM_001286479	chr15	+	32907344	32932138	ARHGAP11A	24794	32904844	32909844
NM_001039841	chr15	+	30918878	30931013	ARHGAP11B	12135	30916378	30921378
NM_001270696	chr10	-	32094325	32217804	ARHGAP12	123479	32215304	32220304
NM_018460	chr2	+	143886898	144525921	ARHGAP15	639023	143884398	143889398
NM_001006634	chr16	-	24930704	25026699	ARHGAP17	95995	25024199	25029199
NM_033515	chr6	-	129898239	130031370	ARHGAP18	133131	130028870	130033870
NM_032900	chr10	-	98981929	99052430	ARHGAP19	70501	99049930	99054930
NR_037909	chr10	-	98912798	99052430	ARHGAP19-SLIT1	139632	99049930	99054930
NM_001258418	chr11	-	110447758	110583912	ARHGAP20	136154	110581412	110586412
NM_020824	chr10	-	24872537	25012597	ARHGAP21	140060	25010097	25015097
NR_045675	chr10	-	49654067	49864310	ARHGAP22	210243	49861810	49866810
NM_001199417	chr17	+	36584719	36668628	ARHGAP23	83909	36582219	36587219
NM_001025616	chr4	+	86396283	86923823	ARHGAP24	527540	86393783	86398783
NM_001166277	chr2	+	68961912	69053957	ARHGAP25	92045	68959412	68964412
NM_015071	chr5	+	142149948	142608576	ARHGAP26	458628	142147448	142152448
NR_046680	chr5	-	142239169	142248475	ARHGAP26-AS1	9306	142245975	142250975
NM_001282290	chr17	-	43471267	43507663	ARHGAP27	36396	43505163	43510163
NR_027487	chr17	-	62774256	62777622	ARHGAP27P1	3366	62775122	62780122
NR_026899	chr17	-	62745779	62778117	ARHGAP27P1-BPTFP1-KPNA2P3	32338	62775617	62780617
NM_001010000	chr18	+	6834431	6915712	ARHGAP28	81281	6831931	6836931
NM_001328665	chr1	-	94634462	94713316	ARHGAP29	78854	94710816	94715816
NM_001287600	chr1	-	161016731	161039760	ARHGAP30	23029	161037260	161042260
NM_020754	chr3	+	119013219	119138323	ARHGAP31	125104	119010719	119015719
NR_046748	chr3	-	119033139	119041607	ARHGAP31-AS1	8468	119039107	119044107
NM_001142685	chr11	-	128834954	129062093	ARHGAP32	227139	129059593	129064593
NM_052948	chr19	+	36266416	36279724	ARHGAP33	13308	36263916	36268916
NM_004491	chr19	+	47421932	47508333	ARHGAP35	86401	47419432	47424432
NM_001282607	chrX	+	130192215	130223859	ARHGAP36	31644	130189715	130194715
NM_001308208	chr8	-	145754562	145911197	ARHGAP39	156635	145908697	145913697
NM_001164741	chrX	-	153172829	153191714	ARHGAP4	18885	153189214	153194214
NM_001164431	chr20	+	37230576	37279295	ARHGAP40	48719	37228076	37233076
NM_152432	chr11	+	100557970	100864676	ARHGAP42	306706	100555470	100560470
NM_001321167	chr17	+	12692828	12894961	ARHGAP44	202133	12690328	12695328
NM_001258328	chr19	+	1065921	1087830	ARHGAP45	21909	1063421	1068421
NM_001173	chr14	+	32546494	32628934	ARHGAP5	82440	32543994	32548994
NM_013427	chrX	-	11155662	11683821	ARHGAP6	528159	11681321	11686321
NM_181335	chr22	+	45148437	45258664	ARHGAP8	110227	45145937	45150937
NM_001319850	chr12	-	57866037	57882597	ARHGAP9	16560	57880097	57885097
NM_001301243	chr17	-	79825594	79829282	ARHGDIA	3688	79826782	79831782
NM_001175	chr12	-	15094948	15114704	ARHGDIB	19756	15112204	15117204
NM_198977	chr19	+	42387266	42411604	ARHGEF1	24338	42384766	42389766
NM_001308153	chr8	+	1772141	1906807	ARHGEF10	134666	1769641	1774641
NM_018125	chr1	+	17866329	18024370	ARHGEF10L	158041	17863829	17868829
NM_014784	chr1	-	156904631	157015162	ARHGEF11	110531	157012662	157017662
NM_001198665	chr11	+	120207617	120360645	ARHGEF12	153028	120205117	120210117
NM_173728	chr17	+	8213555	8225834	ARHGEF15	12279	8211055	8216055
NM_014448	chr1	+	3371146	3397677	ARHGEF16	26531	3368646	3373646
NM_014786	chr11	+	73019662	73080425	ARHGEF17	60763	73017162	73022162
NM_015318	chr19	+	7459998	7537371	ARHGEF18	77373	7457498	7462498
NM_153213	chr1	-	16524348	16539166	ARHGEF19	14818	16536666	16541666
NM_001350112	chr1	-	155916629	155949351	ARHGEF2	32722	155946851	155951851
NM_001111270	chr12	+	58003962	58011028	ARHGEF25	7066	58001462	58006462
NM_001251962	chr3	+	153838791	153975616	ARHGEF26	136825	153836291	153841291
NR_037901	chr3	-	153742189	153838999	ARHGEF26-AS1	96810	153836499	153841499
NM_001177693	chr5	+	72921982	73237818	ARHGEF28	315836	72919482	72924482
NM_001128615	chr3	-	56761445	57113336	ARHGEF3	351891	57110836	57115836
NR_046572	chr3	+	56974067	56994880	ARHGEF3-AS1	20813	56971567	56976567
NM_001145451	chr2	+	39146503	39202590	ARHGEF33	56087	39144003	39149003
NR_033942	chr7	-	143956088	143983096	ARHGEF34P	27008	143980596	143985596
NM_001003702	chr7	-	143883175	143892791	ARHGEF35	9616	143890291	143895291
NM_001001669	chr5	+	148961134	149014527	ARHGEF37	53393	148958634	148963634
NM_001242729	chr4	+	106473776	106602070	ARHGEF38	128294	106471276	106476276
NR_046840	chr4	+	106482747	106491392	ARHGEF38-IT1	8645	106480247	106485247
NM_032818	chr9	-	35659340	35665278	ARHGEF39	5938	35662778	35667778
NM_015320	chr2	+	131674223	131804826	ARHGEF4	130603	131671723	131676723
NM_001278529	chr14	+	21538418	21558406	ARHGEF40	19988	21535918	21540918
NM_005435	chr7	+	144052488	144077725	ARHGEF5	25237	144049988	144054988
NM_004840	chrX	-	135747711	135863503	ARHGEF6	115792	135861003	135866003
NM_001320852	chr13	+	111766965	111958081	ARHGEF7	191116	111764465	111769465
NR_046516	chr13	-	111796651	111800912	ARHGEF7-AS1	4261	111798412	111803412
NM_001330495	chrX	-	62854846	63005426	ARHGEF9	150580	63002926	63007926
NM_006015	chr1	+	27022521	27108601	ARID1A	86080	27020021	27025021
NM_001346813	chr6	+	157098988	157531913	ARID1B	432925	157096488	157101488
NM_152641	chr12	+	46123491	46301823	ARID2	178332	46120991	46125991
NM_005224	chr19	+	926036	972803	ARID3A	46767	923536	928536
NM_001307939	chr15	+	74833517	74890472	ARID3B	56955	74831017	74836017
NM_001017363	chr9	-	34621454	34628011	ARID3C	6557	34625511	34630511
NM_002892	chr14	+	58765221	58840451	ARID4A	75230	58762721	58767721
NR_135074	chr1	-	235330209	235491534	ARID4B	161325	235489034	235494034
NM_001319093	chr2	+	97202455	97218375	ARID5A	15920	97199955	97204955
NM_032199	chr10	+	63661012	63856707	ARID5B	195695	63658512	63663512
NM_005744	chr15	+	72766666	72878896	ARIH1	112230	72764166	72769166
NM_006321	chr3	+	48956252	49022971	ARIH2	66719	48953752	48958752
NM_001177	chr12	-	101786897	101801598	ARL1	14701	101799098	101804098
NM_173664	chr5	+	175792470	175800503	ARL10	8033	175789970	175794970
NM_138450	chr13	+	50202434	50208008	ARL11	5574	50199934	50204934
NM_001162491	chrX	+	100224696	100245820	ARL13A	21124	100222196	100227196
NR_033427	chr3	+	93698982	93774522	ARL13B	75540	93696482	93701482
NM_152316	chr11	+	30344645	30359770	ARL14EP	15125	30342145	30347145
NM_001195581	chr5	+	115387162	115394827	ARL14EPL	7665	115384662	115389662
NM_019087	chr5	-	53180613	53606403	ARL15	425790	53603903	53608903
NM_001329608	chr17	-	79648194	79650954	ARL16	2760	79648454	79653454
NM_001288812	chr17	-	44586046	44657088	ARL17A	71042	44654588	44659588
NM_001103154	chr17_ctg5_hap1	+	391592	514420	ARL17B	122828	389092	394092
NM_001667	chr11	+	64781584	64789657	ARL2	8073	64779084	64784084
NR_037650	chr11	+	64781584	64808044	ARL2-SNX15	26460	64779084	64784084
NM_012106	chr16	+	57279037	57287545	ARL2BP	8508	57276537	57281537
NM_004311	chr10	-	104433483	104474190	ARL3	40707	104471690	104476690
NM_001037164	chr7	+	12726451	12730558	ARL4A	4107	12723951	12728951
NM_001282431	chr2	-	235401685	235405697	ARL4C	4012	235403197	235408197
NM_012097	chr2	-	152657479	152685009	ARL5A	27530	152682509	152687509
NM_178815	chr10	+	18948312	18966940	ARL5B	18628	18945812	18950812
NM_001143968	chr17	-	37313146	37322414	ARL5C	9268	37319914	37324914
NM_001278293	chr3	+	97483364	97520086	ARL6	36722	97480864	97485864
NM_015161	chr16	-	18802988	18813000	ARL6IP1	10012	18810500	18815500
NR_103512	chr12	+	123464606	123467460	ARL6IP4	2854	123462106	123467106
NM_006407	chr3	+	69134089	69155239	ARL6IP5	21150	69131589	69136589
NR_146422	chr2	+	153574206	153617767	ARL6IP6	43561	153571706	153576706
NM_001256129	chr1	-	202102531	202113871	ARL8A	11340	202111371	202116371
NM_018184	chr3	+	5163929	5222601	ARL8B	58672	5161429	5166429
NM_206919	chr4	+	57371374	57390058	ARL9	18684	57368874	57373874
NM_018120	chr8	-	66514690	66546452	ARMC1	31762	66543952	66548952
NM_001161013	chr7	+	102715327	102740210	ARMC10	24883	102712827	102717827
NM_001286576	chr6	+	35704808	35716690	ARMC12	11882	35702308	35707308
NM_001286609	chr6	+	109169618	109295675	ARMC2	126057	109167118	109172118
NR_104137	chr6	-	109229342	109245306	ARMC2-AS1	15964	109242806	109247806
NM_001282747	chr10	+	23216952	23327452	ARMC3	110500	23214452	23219452
NM_018076	chr10	-	28101092	28287979	ARMC4	186887	28285479	28290479
NR_138082	chr10	+	27547690	27623984	ARMC4P1	76294	27545190	27550190
NM_001288767	chr16	+	31469593	31478488	ARMC5	8895	31467093	31472093
NM_001199196	chr19	+	19144386	19168987	ARMC6	24601	19141886	19146886
NM_024585	chr17	+	73106046	73126360	ARMC7	20314	73103546	73108546
NM_001267042	chr3	+	137906089	138017228	ARMC8	111139	137903589	137908589
NM_001352754	chr2	+	232063259	232241549	ARMC9	178290	232060759	232065759
NM_016608	chrX	+	100805513	100809675	ARMCX1	4162	100803013	100808013
NM_001282231	chrX	-	100910267	100914876	ARMCX2	4609	100912376	100917376
NM_016607	chrX	+	100878119	100882831	ARMCX3	4712	100875619	100880619
NR_028407	chrX	+	100673250	100790975	ARMCX4	117725	100670750	100675750
NM_001168479	chrX	+	101854095	101859085	ARMCX5	4990	101851595	101856595
NR_146584	chrX	+	101854425	102163032	ARMCX5-GPRASP2	308607	101851925	101856925
NM_001009584	chrX	-	100870107	100872991	ARMCX6	2884	100870491	100875491
NM_001099667	chr10	+	124214178	124216868	ARMS2	2690	124211678	124216678
NM_024573	chr6	+	151773392	151791234	ARMT1	17842	151770892	151775892
NM_001668	chr1	-	150782180	150849244	ARNT	67064	150846744	150851744
NM_014862	chr15	+	80696691	80890277	ARNT2	193586	80694191	80699191
NM_001351804	chr11	+	13298198	13408812	ARNTL	110614	13295698	13300698
NM_001248005	chr12	+	27485786	27578746	ARNTL2	92960	27483286	27488286
NR_109975	chr12	-	27542721	27599567	ARNTL2-AS1	56846	27597067	27602067
NM_001190996	chr7	+	98923495	98963885	ARPC1A	40390	98920995	98925995
NM_005720	chr7	+	98972297	98992404	ARPC1B	20107	98969797	98974797
NM_152862	chr2	+	219081816	219119071	ARPC2	37255	219079316	219084316
NM_001278556	chr12	-	110872694	110888216	ARPC3	15522	110885716	110890716
NM_001024959	chr3	+	9834178	9848789	ARPC4	14611	9831678	9836678
NM_001198793	chr3	+	9834231	9878040	ARPC4-TTLL3	43809	9831731	9836731
NM_001270439	chr1	-	183595327	183605076	ARPC5	9749	183602576	183607576
NM_030978	chr9	+	127624396	127640012	ARPC5L	15616	127621896	127626896
NM_182616	chr15	-	90439763	90456222	ARPIN	16459	90453722	90458722
NM_001306191	chr15	-	52839241	52861643	ARPP19	22402	52859143	52864143
NM_001267617	chr3	+	35682509	35835988	ARPP21	153479	35680009	35685009
NM_004312	chrX	+	69488184	69501690	ARR3	13506	69485684	69490684
NM_020251	chr11	-	74971165	75062875	ARRB1	91710	75060375	75065375
NM_199004	chr17	+	4613788	4624795	ARRB2	11007	4611288	4616288
NM_001317968	chr9	+	140500091	140509812	ARRDC1	9721	140497591	140502591
NR_122035	chr9	-	140509783	140513347	ARRDC1-AS1	3564	140510847	140515847
NM_001025604	chr19	+	18111940	18124911	ARRDC2	12971	18109440	18114440
NM_020801	chr5	-	90664448	90679190	ARRDC3	14742	90676690	90681690
NR_027435	chr5	+	90676163	90716532	ARRDC3-AS1	40369	90673663	90678663
NM_183376	chr15	+	98503932	98517068	ARRDC4	13136	98501432	98506432
NM_001080523	chr19	-	4890448	4902879	ARRDC5	12431	4900379	4905379
NM_001085428	chr22	-	51061181	51066601	ARSA	5420	51064101	51069101
NM_000046	chr5	-	78073036	78282357	ARSB	209321	78279857	78284857
NM_001669	chrX	-	2822010	2847416	ARSD	25406	2844916	2849916
NM_001282631	chrX	-	2852672	2886351	ARSE	33679	2883851	2888851
NM_001201538	chrX	+	2958274	3030770	ARSF	72496	2955774	2960774
NM_001352904	chr17	+	66255322	66425514	ARSG	170192	66252822	66257822
NM_001011719	chrX	+	2924653	2951426	ARSH	26773	2922153	2927153
NM_001012301	chr5	-	149675901	149682525	ARSI	6624	149680025	149685025
NM_024590	chr4	-	114821439	114900878	ARSJ	79439	114898378	114903378
NM_198150	chr5	+	94890824	94940806	ARSK	49982	94888324	94893324
NM_004314	chr11	+	3666360	3685646	ART1	19286	3663860	3668860
NM_001130017	chr4	+	76932332	77033955	ART3	101623	76929832	76934832
NM_021071	chr12	-	14982244	14996413	ART4	14169	14993913	14998913
NR_123732	chr11	-	3659735	3663546	ART5	3811	3661046	3666046
NM_057090	chr1	+	44398991	44402912	ARTN	3921	44396491	44401491
NM_022786	chr1	+	231114794	231136479	ARV1	21685	231112294	231117294
NM_001670	chr22	-	19957401	20004309	ARVCF	46908	20001809	20006809
NM_139058	chrX	-	25021812	25034065	ARX	12253	25031565	25036565
NR_136149	chr10	-	129855995	129860689	AS-PTPRE	4694	129858189	129863189
NM_020682	chr10	+	104629209	104661655	AS3MT	32446	104626709	104631709
NM_004315	chr8	-	17913807	17942507	ASAH1	28700	17940007	17945007
NM_001143974	chr10	-	51946999	52008370	ASAH2	61371	52005870	52010870
NM_001079516	chr10	+	52499447	52516946	ASAH2B	17499	52496947	52501947
NM_018482	chr8	-	131064350	131455906	ASAP1	391556	131453406	131458406
NM_003887	chr2	+	9346893	9545812	ASAP2	198919	9344393	9349393
NM_017707	chr1	-	23755055	23810750	ASAP3	55695	23808250	23813250
NM_001040445	chr2	+	239335568	239360891	ASB1	25323	239333068	239338068
NM_080871	chr7	-	150872784	150884919	ASB10	12135	150882419	150887419
NM_001201583	chrX	-	15299830	15333746	ASB11	33916	15331246	15336246
NM_130388	chrX	-	63444071	63450511	ASB12	6440	63448011	63453011
NR_037164	chr10	-	5680819	5708558	ASB13	27739	5706058	5711058
NM_001142733	chr3	-	57302378	57326710	ASB14	24332	57324210	57329210
NM_001290258	chr7	+	123241920	123277934	ASB15	36014	123239420	123244420
NM_080863	chr17	+	42248073	42256451	ASB16	8378	42245573	42250573
NR_049729	chr17	-	42253341	42264085	ASB16-AS1	10744	42261585	42266585
NR_026546	chr1	-	76384557	76398116	ASB17	13559	76395616	76400616
NM_212556	chr2	-	237102094	237172988	ASB18	70894	237170488	237175488
NM_001202429	chr14	-	94400498	94443076	ASB2	42578	94440576	94445576
NM_145863	chr2	-	53897116	54014146	ASB3	117030	54011646	54016646
NM_016116	chr7	+	95115212	95169543	ASB4	54331	95112712	95117712
NM_080874	chr4	-	177134825	177190373	ASB5	55548	177187873	177192873
NM_177999	chr9	-	132396882	132404448	ASB6	7566	132401948	132406948
NM_198243	chr15	+	101142754	101191904	ASB7	49150	101140254	101145254
NM_001319300	chr12	-	48541570	48551378	ASB8	9808	48548878	48553878
NM_001168531	chrX	-	15262108	15288589	ASB9	26481	15286089	15291089
NR_045564	chr10	-	73855789	73976892	ASCC1	121103	73974392	73979392
NM_032204	chr22	-	30184596	30234293	ASCC2	49697	30231793	30236793
NM_006828	chr6	-	100956070	101329248	ASCC3	373178	101326748	101331748
NM_004316	chr12	+	103351451	103354294	ASCL1	2843	103348951	103353951
NM_020646	chr11	-	8959118	8964580	ASCL3	5462	8962080	8967080
NM_014034	chr6	+	119215240	119230335	ASF1A	15095	119212740	119217740
NM_018154	chr19	-	14230320	14247440	ASF1B	17120	14244940	14249940
NM_001197216	chr17	-	7076750	7082883	ASGR1	6133	7080383	7085383
NM_001181	chr17	-	7004640	7018130	ASGR2	13490	7015630	7020630
NM_018489	chr1	-	155305051	155532324	ASH1L	227273	155529824	155534824
NM_004674	chr8	+	37963010	37997598	ASH2L	34588	37960510	37965510
NR_046389	chr12	+	50451419	50477405	ASIC1	25986	50448919	50453919
NM_001094	chr17	-	31340105	32483825	ASIC2	1143720	32481325	32486325
NM_020321	chr7	+	150745378	150749843	ASIC3	4465	150742878	150747878
NM_182847	chr2	+	220378891	220403494	ASIC4	24603	220376391	220381391
NM_017419	chr4	-	156750880	156787425	ASIC5	36545	156784925	156789925
NM_001672	chr20	+	32848170	32857148	ASIP	8978	32845670	32850670
NM_000048	chr7	+	65540775	65558329	ASL	17554	65538275	65543275
NM_004043	chrX	+	1714347	1761974	ASMT	47627	1711847	1716847
NM_001173473	chrX	-	1522031	1572655	ASMTL	50624	1570155	1575155
NR_026711	chrX	+	1519423	1534314	ASMTL-AS1	14891	1516923	1521923
NM_004317	chr19	+	12848272	12859138	ASNA1	10866	12845772	12850772
NM_001352496	chr7	-	97481428	97557874	ASNS	76446	97555374	97560374
NM_019048	chr2	+	190526124	190535557	ASNSD1	9433	190523624	190528624
NR_146077	chr8	-	47490836	47529265	ASNSP1	38429	47526765	47531765
NM_001128085	chr17	+	3377403	3402700	ASPA	25297	3374903	3379903
NM_001024656	chr19	-	51014856	51017947	ASPDH	3091	51015447	51020447
NM_001080464	chr14	+	104552022	104579046	ASPG	27024	104549522	104554522
NM_004318	chr8	-	62413114	62627199	ASPH	214085	62624699	62629699
NM_181718	chr16	+	29912146	29917377	ASPHD1	5231	29909646	29914646
NM_020437	chr22	+	26825279	26840978	ASPHD2	15699	26822779	26827779
NM_018136	chr1	-	197053256	197115824	ASPM	62568	197113324	197118324
NM_017680	chr9	-	95218488	95244844	ASPN	26356	95242344	95247344
NM_001330528	chr17	+	79935421	79975282	ASPSCR1	39861	79932921	79937921
NM_001083926	chr11	+	62104773	62160887	ASRGL1	56114	62102273	62107273
NM_054012	chr9	+	133320093	133376661	ASS1	56568	133317593	133322593
NM_014065	chr3	-	130732716	130745698	ASTE1	12982	130743198	130748198
NM_001002036	chr2	-	96789588	96804175	ASTL	14587	96801675	96806675
NM_001286164	chr1	-	176826440	177134040	ASTN1	307600	177131540	177136540
NM_014010	chr9	-	119187503	120177317	ASTN2	989814	120174817	120179817
NR_033973	chr9	+	119266561	119324572	ASTN2-AS1	58011	119264061	119269061
NM_015338	chr20	+	30946146	31027122	ASXL1	80976	30943646	30948646
NM_018263	chr2	-	25956621	26101385	ASXL2	144764	26098885	26103885
NM_030632	chr18	+	31158540	31331158	ASXL3	172618	31156040	31161040
NM_001301821	chr7	-	117003275	117067577	ASZ1	64302	117065077	117070077
NR_135914	chr10	-	89511268	89577988	ATAD1	66720	89575488	89580488
NM_014109	chr8	-	124332090	124408705	ATAD2	76615	124406205	124411205
NM_017552	chr2	-	23971533	24149984	ATAD2B	178451	24147484	24152484
NM_018188	chr1	+	1447522	1470067	ATAD3A	22545	1445022	1450022
NM_031921	chr1	+	1407134	1431584	ATAD3B	24450	1404634	1409634
NM_001039211	chr1	+	1385068	1405538	ATAD3C	20470	1382568	1387568
NM_024857	chr17	+	29158987	29222883	ATAD5	63896	29156487	29161487
NR_033823	chr6_mcf_hap5	+	1976474	1996458	ATAT1	19984	1973974	1978974
NM_033064	chr19	+	3880617	3928080	ATCAY	47463	3878117	3883117
NR_110006	chr10	-	123499935	123688316	ATE1	188381	123685816	123690816
NR_120495	chr10	+	123687826	123711480	ATE1-AS1	23654	123685326	123690326
NM_005171	chr12	+	51157788	51214943	ATF1	57155	51155288	51160288
NM_001880	chr2	-	175936977	176032934	ATF2	95957	176030434	176035434
NM_001030287	chr1	+	212738675	212794119	ATF3	55444	212736175	212741175
NM_012068	chr19	+	50431958	50437193	ATF5	5235	50429458	50434458
NM_007348	chr1	+	161736033	161933860	ATF6	197827	161733533	161738533
NM_004381	chr6	-	32083044	32096017	ATF6B	12973	32093517	32098517
NR_073163	chr12	-	53901639	54020199	ATF7	118560	54017699	54022699
NM_018179	chr12	+	14518565	14655869	ATF7IP	137304	14516065	14521065
NR_045815	chr16	+	10479855	10577500	ATF7IP2	97645	10477355	10482355
NM_031482	chr5	+	81267843	81551216	ATG10	283373	81265343	81270343
NM_021934	chr12	+	52463757	52471279	ATG101	7522	52461257	52466257
NR_073603	chr5	-	115163893	115177548	ATG12	13655	115175048	115180048
NM_001205122	chr11	+	46638825	46697568	ATG13	58743	46636325	46641325
NM_014924	chr14	-	55833108	55878576	ATG14	45468	55876076	55881076
NM_017974	chr2	+	234160216	234204320	ATG16L1	44104	234157716	234162716
NM_001318766	chr11	+	72525450	72540680	ATG16L2	15230	72522950	72527950
NM_015104	chr11	-	64662003	64684722	ATG2A	22719	64682222	64687222
NM_018036	chr14	-	96745538	96829738	ATG2B	84200	96827238	96832238
NM_022488	chr3	-	112251353	112280810	ATG3	29457	112278310	112283310
NM_178271	chrX	+	107334896	107397901	ATG4A	63005	107332396	107337396
NM_013325	chr2	+	242577026	242613271	ATG4B	36245	242574526	242579526
NM_032852	chr1	+	63249776	63330941	ATG4C	81165	63247276	63252276
NM_032885	chr19	+	10654569	10664099	ATG4D	9530	10652069	10657069
NM_001286107	chr6	-	106632351	106773695	ATG5	141344	106771195	106776195
NM_001349238	chr3	+	11314009	11606126	ATG7	292117	11311509	11316509
NM_001077198	chr2	-	220084101	220094410	ATG9A	10309	220091910	220096910
NR_073169	chr7	-	150709296	150721586	ATG9B	12290	150719086	150724086
NM_004044	chr2	+	216176678	216214496	ATIC	37818	216174178	216179178
NM_001127713	chr14	+	50999799	51099784	ATL1	99985	50997299	51002299
NM_001330462	chr2	-	38521098	38605726	ATL2	84628	38603226	38608226
NM_001290048	chr11	-	63391553	63439446	ATL3	47893	63436946	63441946
NM_000051	chr11	+	108093558	108239826	ATM	146268	108091058	108096058
NM_015251	chr16	+	81069457	81080951	ATMIN	11494	81066957	81071957
NM_001007026	chr12	+	7033625	7051484	ATN1	17859	7031125	7036125
NM_032827	chr2	+	85980908	86018506	ATOH8	37598	85978408	85983408
NM_004045	chr5	-	151122382	151138210	ATOX1	15828	151135710	151140710
NM_024490	chr15	-	25923859	26108349	ATP10A	184490	26105849	26110849
NM_025153	chr5	-	159990126	160279219	ATP10B	289093	160276719	160281719
NM_020453	chr4	+	47487409	47595503	ATP10D	108094	47484909	47489909
NM_015205	chr13	+	113344642	113541482	ATP11A	196840	113342142	113347142
NR_046661	chr13	-	113399762	113409045	ATP11A-AS1	9283	113406545	113411545
NM_207440	chr13	+	113301357	113338811	ATP11AUN	37454	113298857	113303857
NM_014616	chr3	+	182511290	182639421	ATP11B	128131	182508790	182513790
NM_173694	chrX	-	138808504	138914447	ATP11C	105943	138911947	138916947
NM_001676	chr13	+	25254548	25285923	ATP12A	31375	25252048	25257048
NM_020410	chr19	-	19756009	19774503	ATP13A1	18494	19772003	19777003
NM_022089	chr1	-	17312452	17338467	ATP13A2	26015	17335967	17340967
NM_024524	chr3	-	194123402	194188968	ATP13A3	65566	194186468	194191468
NM_032279	chr3	-	193116755	193272911	ATP13A4	156156	193270411	193275411
NM_198505	chr3	-	192992577	193096632	ATP13A5	104055	193094132	193099132
NR_046758	chr3	+	193025032	193032310	ATP13A5-AS1	7278	193022532	193027532
NM_000701	chr1	+	116915794	116947396	ATP1A1	31602	116913294	116918294
NR_027646	chr1	-	116935486	116961244	ATP1A1-AS1	25758	116958744	116963744
NM_000702	chr1	+	160085519	160113374	ATP1A2	27855	160083019	160088019
NM_001256214	chr19	-	42470733	42498428	ATP1A3	27695	42495928	42500928
NM_144699	chr1	+	160121351	160156767	ATP1A4	35416	160118851	160123851
NM_001677	chr1	+	169075946	169101960	ATP1B1	26014	169073446	169078446
NM_001303263	chr17	+	7549944	7561089	ATP1B2	11145	7547444	7552444
NM_001679	chr3	+	141595433	141645390	ATP1B3	49957	141592933	141597933
NM_001142447	chrX	+	119495939	119517104	ATP1B4	21165	119493439	119498439
NM_001320408	chr12	+	58335286	58351052	ATP23	15766	58332786	58337786
NM_004320	chr16	+	28889808	28915830	ATP2A1	26022	28887308	28892308
NM_170665	chr12	+	110719031	110788897	ATP2A2	69866	110716531	110721531
NM_174957	chr17	-	3827162	3867758	ATP2A3	40596	3865258	3870258
NM_001682	chr12	-	89981825	90049844	ATP2B1	68019	90047344	90052344
NR_028138	chr12	+	90102731	90105729	ATP2B1-AS1	2998	90100231	90105231
NM_001330611	chr3	-	10365706	10547374	ATP2B2	181668	10544874	10549874
NM_021949	chrX	+	152801579	152848387	ATP2B3	46808	152799079	152804079
NM_001684	chr1	+	203595914	203713209	ATP2B4	117295	203593414	203598414
NM_001199182	chr3	+	130569368	130735555	ATP2C1	166187	130566868	130571868
NM_001286527	chr16	+	84402128	84497793	ATP2C2	95665	84399628	84404628
NR_146503	chr16	-	84492864	84500967	ATP2C2-AS1	8103	84498467	84503467
NM_000704	chr19	-	36041094	36054560	ATP4A	13466	36052060	36057060
NM_000705	chr13	-	114303121	114312513	ATP4B	9392	114310013	114315013
NM_001001937	chr18	-	43664109	43684199	ATP5A1	20090	43681699	43686699
NM_001686	chr12	-	57031958	57039852	ATP5B	7894	57037352	57042352
NM_005174	chr10	+	7830066	7849762	ATP5C1	19696	7827566	7832566
NM_001687	chr19	+	1241748	1244824	ATP5D	3076	1239248	1244248
NM_006886	chr20	-	57603732	57607422	ATP5E	3690	57604922	57609922
NM_001688	chr1	+	111991742	112004525	ATP5F1	12783	111989242	111994242
NM_005175	chr17	+	46970147	46973232	ATP5G1	3085	46967647	46972647
NM_001002031	chr12	-	54058943	54070512	ATP5G2	11569	54068012	54073012
NM_001190329	chr2	-	176040985	176046490	ATP5G3	5505	176043990	176048990
NM_006356	chr17	-	73034954	73043074	ATP5H	8120	73040574	73045574
NM_001320266	chr21	-	27096790	27107965	ATP5J	11175	27105465	27110465
NM_001039178	chr7	-	99055783	99063824	ATP5J2	8041	99061324	99066324
NM_001198879	chr7	-	99014361	99063824	ATP5J2-PTCD1	49463	99061324	99066324
NR_033759	chr11	+	118272103	118280562	ATP5L	8459	118269603	118274603
NM_001697	chr21	-	35275756	35288158	ATP5O	12402	35285658	35290658
NR_033761	chr14	+	50779046	50792946	ATP5S	13900	50776546	50781546
NM_001183	chrX	+	153656977	153664863	ATP6AP1	7886	153654477	153659477
NM_001349371	chr5	+	81574468	81615751	ATP6AP1L	41283	81571968	81576968
NM_005765	chrX	+	40440215	40465888	ATP6AP2	25673	40437715	40442715
NM_005177	chr17	+	40610861	40674597	ATP6V0A1	63736	40608361	40613361
NM_012463	chr12	+	124196864	124246301	ATP6V0A2	49437	124194364	124199364
NM_020632	chr7	-	138391038	138482941	ATP6V0A4	91903	138480441	138485441
NM_001294333	chr1	+	44440319	44443972	ATP6V0B	3653	44437819	44442819
NM_001198569	chr16	+	2563726	2570224	ATP6V0C	6498	2561226	2566226
NM_004691	chr16	-	67471916	67515089	ATP6V0D1	43173	67512589	67517589
NM_152565	chr8	+	87111138	87166454	ATP6V0D2	55316	87108638	87113638
NM_003945	chr5	+	172410762	172461900	ATP6V0E1	51138	172408262	172413262
NM_145230	chr7	+	149570056	149577801	ATP6V0E2	7745	149567556	149572556
NR_027040	chr7	-	149564782	149570951	ATP6V0E2-AS1	6169	149568451	149573451
NM_001690	chr3	+	113465865	113530905	ATP6V1A	65040	113463365	113468365
NM_001692	chr2	+	71162997	71192561	ATP6V1B1	29564	71160497	71165497
NR_110274	chr2	-	71169142	71175741	ATP6V1B1-AS1	6599	71173241	71178241
NM_001693	chr8	+	20054703	20079207	ATP6V1B2	24504	20052203	20057203
NM_001695	chr8	+	104033247	104085285	ATP6V1C1	52038	104030747	104035747
NM_001039362	chr2	+	10861774	10925236	ATP6V1C2	63462	10859274	10864274
NM_015994	chr14	-	67804580	67826720	ATP6V1D	22140	67824220	67829220
NM_001696	chr22	-	18074902	18111588	ATP6V1E1	36686	18109088	18114088
NM_001318063	chr2	-	46738973	46769696	ATP6V1E2	30723	46767196	46772196
NM_004231	chr7	+	128502856	128505903	ATP6V1F	3047	128500356	128505356
NM_004888	chr9	+	117349993	117361152	ATP6V1G1	11159	117347493	117352493
NR_037853	chr6	-	31497995	31514625	ATP6V1G2-DDX39B	16630	31512125	31517125
NM_133326	chr1	-	198492351	198510075	ATP6V1G3	17724	198507575	198512575
NM_213619	chr8	-	54628102	54755871	ATP6V1H	127769	54753371	54758371
NM_001282224	chrX	+	77166152	77305892	ATP7A	139740	77163652	77168652
NM_001243182	chr13	-	52506805	52585630	ATP7B	78825	52583130	52588130
NM_006095	chr4	-	42410391	42659122	ATP8A1	248731	42656622	42661622
NM_016529	chr13	+	25946148	26599989	ATP8A2	653841	25943648	25948648
NM_005603	chr18	-	55313658	55470327	ATP8B1	156669	55467827	55472827
NM_020452	chr1	+	154300275	154323780	ATP8B2	23505	154297775	154302775
NM_138813	chr19	-	1782073	1812275	ATP8B3	30202	1809775	1814775
NM_024837	chr15	-	50150434	50411419	ATP8B4	260985	50408919	50413919
NR_003581	chr9	+	35406751	35483026	ATP8B5P	76275	35404251	35409251
NM_006045	chr20	-	50213313	50384950	ATP9A	171637	50382450	50387450
NM_001306085	chr18	+	76829274	77138282	ATP9B	309008	76826774	76831774
NM_001042546	chr1	-	47100710	47134099	ATPAF1	33389	47131599	47136599
NM_145691	chr17	-	17921333	17942480	ATPAF2	21147	17939980	17944980
NM_001184	chr3	-	142168076	142297668	ATR	129592	142295168	142300168
NM_080592	chr2	+	27434898	27440046	ATRAID	5148	27432398	27437398
NM_001271022	chr3	+	48488113	48507054	ATRIP	18941	48485613	48490613
NM_139321	chr20	+	3451664	3631769	ATRN	180105	3449164	3454164
NM_207303	chr10	+	116853123	117708509	ATRNL1	855386	116850623	116855623
NM_000489	chrX	-	76760355	77041755	ATRX	281400	77039255	77044255
NM_000332	chr6	-	16299342	16761721	ATXN1	462379	16759221	16764221
NM_001167621	chr22	+	46067677	46241187	ATXN10	173510	46065177	46070177
NM_001137675	chr16	+	71879893	71891236	ATXN1L	11343	71877393	71882393
NR_132311	chr12	-	111890017	112037480	ATXN2	147463	112034980	112039980
NM_148416	chr16	+	28834368	28848558	ATXN2L	14190	28831868	28836868
NM_001164782	chr14	-	92524895	92572965	ATXN3	48070	92570465	92575465
NM_000333	chr3	+	63850232	63989136	ATXN7	138904	63847732	63852732
NM_020725	chr7	-	105245220	105517031	ATXN7L1	271811	105514531	105519531
NM_153340	chr1	+	110026526	110035420	ATXN7L2	8894	110024026	110029026
NM_020218	chr17	-	42269172	42275529	ATXN7L3	6357	42273029	42278029
NM_001136262	chr12	+	74931550	74935232	ATXN7L3B	3682	74929050	74934050
NR_002717	chr13	+	70681344	70713885	ATXN8OS	32541	70678844	70683844
NM_001306190	chr9	-	93976096	94124251	AUH	148155	94121751	94126751
NM_001287490	chr1	-	26158403	26185949	AUNIP	27546	26183449	26188449
NR_126511	chr2	-	74753774	74757024	AUP1	3250	74754524	74759524
NM_003600	chr20	-	54944444	54967393	AURKA	22949	54964893	54969893
NR_132730	chr17	-	8108048	8113944	AURKB	5896	8111444	8116444
NM_003160	chr19	+	57742376	57746916	AURKC	4540	57739876	57744876
NM_015570	chr7	+	69063904	70258054	AUTS2	1194150	69061404	69066404
NM_020371	chr15	-	34158427	34331303	AVEN	172876	34328803	34333803
NM_006576	chr12	-	58191159	58209852	AVIL	18693	58207352	58212352
NM_015060	chr7	+	32535037	32628353	AVL9	93316	32532537	32537537
NM_021732	chr10	-	99437180	99447015	AVPI1	9835	99444515	99449515
NM_000706	chr12	-	63536538	63546590	AVPR1A	10052	63544090	63549090
NM_000707	chr1	+	206224282	206231482	AVPR1B	7200	206221782	206226782
NR_027419	chrX	+	153167984	153172620	AVPR2	4636	153165484	153170484
NM_001013579	chrX	+	69454504	69460511	AWAT1	6007	69452004	69457004
NM_001002254	chrX	-	69260391	69269788	AWAT2	9397	69267288	69272288
NM_144696	chr1	+	179334854	179523870	AXDND1	189016	179332354	179337354
NM_003502	chr16	-	337439	402676	AXIN1	65237	400176	405176
NM_004655	chr17	-	63524682	63557740	AXIN2	33058	63555240	63560240
NM_001699	chr19	+	41725103	41767672	AXL	42569	41722603	41727603
NM_001185	chr7	-	99564349	99573735	AZGP1	9386	99571235	99576235
NR_036679	chr7	+	99578384	99581860	AZGP1P1	3476	99575884	99580884
NM_022461	chr3	-	28363843	28390618	AZI2	26775	28388118	28393118
NM_148174	chr8	-	103838529	103876428	AZIN1	37899	103873928	103878928
NR_126339	chr8	+	103876498	103990104	AZIN1-AS1	113606	103873998	103878998
NM_001350398	chr1	+	33546713	33586132	AZIN2	39419	33544213	33549213
NM_001700	chr19	+	827825	832018	AZU1	4193	825325	830325
NM_004048	chr15	+	45003684	45010357	B2M	6673	45001184	45006184
NM_001349146	chr3	-	160801670	160823160	B3GALNT1	21490	160820660	160825660
NM_152490	chr1	-	235610504	235667781	B3GALNT2	57277	235665281	235670281
NM_020981	chr2	+	168675181	168727366	B3GALT1	52185	168672681	168677681
NM_003783	chr1	-	193147859	193155743	B3GALT2	7884	193153243	193158243
NM_001278650	chr21	+	40984866	41034816	B3GALT5	49950	40982366	40987366
NR_026542	chr21	-	40969074	40984749	B3GALT5-AS1	15675	40982249	40987249
NM_080605	chr1	+	1167628	1170420	B3GALT6	2792	1165128	1170128
NM_054025	chr11	-	134248397	134281812	B3GAT1	33415	134279312	134284312
NM_080742	chr6	-	71571068	71666788	B3GAT2	95720	71664288	71669288
NM_012200	chr11	-	62382767	62389647	B3GAT3	6880	62387147	62392147
NM_194318	chr13	+	31774111	31906411	B3GLCT	132300	31771611	31776611
NM_006577	chr2	+	62423261	62451866	B3GNT2	28605	62420761	62425761
NM_014256	chr19	+	17905918	17924385	B3GNT3	18467	17903418	17908418
NM_030765	chr12	+	122688227	122693499	B3GNT4	5272	122685727	122690727
NM_032047	chr3	+	182971031	182991179	B3GNT5	20148	182968531	182973531
NM_138706	chr11	+	76745384	76753005	B3GNT6	7621	76742884	76747884
NM_145236	chr2	+	232260334	232265875	B3GNT7	5541	232257834	232262834
NM_198540	chr19	-	41931263	41934635	B3GNT8	3372	41932135	41937135
NM_033309	chr16	-	67182004	67184902	B3GNT9	2898	67182402	67187402
NM_001009905	chr17	-	80900024	81009686	B3GNTL1	109662	81007186	81012186
NM_001478	chr12	-	58019677	58027022	B4GALNT1	7345	58024522	58029522
NM_001159388	chr17	+	47209821	47247351	B4GALNT2	37530	47207321	47212321
NM_173593	chr12	+	569542	671058	B4GALNT3	101516	567042	572042
NM_178537	chr11	+	369794	382117	B4GALNT4	12323	367294	372294
NM_001497	chr9	-	33110638	33167356	B4GALT1	56718	33164856	33169856
NR_108109	chr9	+	33166945	33179981	B4GALT1-AS1	13036	33164445	33169445
NM_003780	chr1	+	44444873	44456843	B4GALT2	11970	44442373	44447373
NM_003779	chr1	-	161141099	161147758	B4GALT3	6659	161145258	161150258
NM_212543	chr3	-	118930588	118959752	B4GALT4	29164	118957252	118962252
NR_046574	chr3	+	118945332	119009513	B4GALT4-AS1	64181	118942832	118947832
NM_004776	chr20	-	48249482	48330421	B4GALT5	80939	48327921	48332921
NM_001330570	chr18	-	29200998	29264686	B4GALT6	63688	29262186	29267186
NM_007255	chr5	+	177027118	177037346	B4GALT7	10228	177024618	177029618
NM_001243475	chr17	-	19238685	19281506	B9D1	42821	19279006	19284006
NM_030578	chr19	-	41860321	41870078	B9D2	9757	41867578	41872578
NM_024812	chr8	+	104152920	104242533	BAALC	89613	104150420	104155420
NR_109954	chr8	-	104169217	104184368	BAALC-AS1	15151	104181868	104186868
NR_027071	chr8	-	104145190	104153570	BAALC-AS2	8380	104151070	104156070
NM_001701	chr9	-	104122698	104147287	BAAT	24589	104144787	104149787
NM_014173	chr19	+	17378184	17390162	BABAM1	11978	17375684	17380684
NM_001329112	chr2	+	28111575	28561767	BABAM2	450192	28109075	28114075
NM_138973	chr11	-	117156401	117186972	BACE1	30571	117184472	117189472
NM_012105	chr21	+	42539727	42654461	BACE2	114734	42537227	42542227
NR_027655	chr21	+	30677524	30734217	BACH1	56693	30675024	30680024
NR_146594	chr21	+	30868366	30872702	BACH1-IT3	4336	30865866	30870866
NM_021813	chr6	-	90636246	91006627	BACH2	370381	91004127	91009127
NM_004322	chr11	-	64037299	64052176	BAD	14877	64049676	64054676
NM_001172415	chr9	-	33252469	33264759	BAG1	12290	33262259	33267259
NM_004282	chr6	+	57037103	57050012	BAG2	12909	57034603	57039603
NM_004281	chr10	+	121410881	121437329	BAG3	26448	121408381	121413381
NM_004874	chr8	+	38034105	38070819	BAG4	36714	38031605	38036605
NM_001015048	chr14	-	104022880	104029151	BAG5	6271	104026651	104031651
NM_080703	chr6_cox_hap2	-	3116415	3130096	BAG6	13681	3127596	3132596
NM_001187	chr21	-	11057795	11098937	BAGE	41142	11096437	11101437
NM_182482	chr21	-	11020841	11098925	BAGE2	78084	11096425	11101425
NM_182481	chr21	-	11020841	11098925	BAGE3	78084	11096425	11101425
NM_181704	chr21	-	11020841	11098925	BAGE4	78084	11096425	11101425
NM_182484	chr21	-	11020841	11098925	BAGE5	78084	11096425	11101425
NM_001291324	chr17	+	79373520	79433358	BAHCC1	59838	79371020	79376020
NM_001301132	chr15	+	40731919	40760441	BAHD1	28522	40729419	40734419
NM_006340	chr17	+	79008946	79091232	BAIAP2	82286	79006446	79011446
NR_026857	chr17	-	79002932	79008519	BAIAP2-AS1	5587	79006019	79011019
NM_018842	chr7	-	97920961	98030427	BAIAP2L1	109466	98027927	98032927
NM_025045	chr22	-	38480895	38506676	BAIAP2L2	25781	38504176	38509176
NM_001286464	chr16	+	1383605	1399442	BAIAP3	15837	1381105	1386105
NM_001188	chr6	-	33540322	33548070	BAK1	7748	33545570	33550570
NM_012342	chr10	+	28966423	28971868	BAMBI	5445	28963923	28968923
NR_047671	chr9	-	71911596	71921972	BANCR	10376	71919472	71924472
NM_001159495	chr20	+	17674319	17716517	BANF2	42198	17671819	17676819
NM_017935	chr4	+	102711763	102995969	BANK1	284206	102709263	102714263
NM_017869	chr16	+	87985037	88110924	BANP	125887	87982537	87987537
NM_004656	chr3	-	52435019	52444121	BAP1	9102	52441621	52446621
NR_104215	chr2	-	215590369	215674435	BARD1	84066	215671935	215676935
NM_020064	chr9	+	135457992	135465640	BARHL1	7648	135455492	135460492
NM_020063	chr1	-	91177578	91182794	BARHL2	5216	91180294	91185294
NM_021570	chr9	-	96713908	96717608	BARX1	3700	96715108	96720108
NM_003658	chr11	+	129245880	129322174	BARX2	76294	129243380	129248380
NM_001271606	chr5	+	17216931	17276954	BASP1	60023	17214431	17219431
NM_006399	chr14	+	75988783	76013334	BATF	24551	75986283	75991283
NM_138456	chr11	-	64755416	64764517	BATF2	9101	64762017	64767017
NM_018664	chr1	-	212859758	212873327	BATF3	13569	212870827	212875827
NM_138763	chr19	+	49458116	49465055	BAX	6939	49455616	49460616
NM_182648	chr14	-	35221936	35344853	BAZ1A	122917	35342353	35347353
NM_032408	chr7	-	72854727	72936615	BAZ1B	81888	72934115	72939115
NM_013449	chr12	-	56989379	57030163	BAZ2A	40784	57027663	57032663
NM_001289975	chr2	-	160175489	160473112	BAZ2B	297623	160470612	160475612
NM_001127242	chr19	-	47724078	47736023	BBC3	11945	47733523	47738523
NM_001195305	chr10	-	112658487	112679124	BBIP1	20637	112676624	112681624
NM_025057	chr14	+	74486058	74532796	BBOF1	46738	74483558	74488558
NM_003986	chr11	+	27062508	27149354	BBOX1	86846	27060008	27065008
NR_125768	chr11	-	27068732	27240315	BBOX1-AS1	171583	27237815	27242815
NM_024649	chr11	+	66278118	66301084	BBS1	22966	66275618	66280618
NM_024685	chr12	-	76738265	76742222	BBS10	3957	76739722	76744722
NM_001178007	chr4	+	123653856	123666098	BBS12	12242	123651356	123656356
NM_031885	chr16	-	56518258	56554008	BBS2	35750	56551508	56556508
NM_033028	chr15	+	72978519	73030817	BBS4	52298	72976019	72981019
NM_152384	chr2	+	170336005	170363165	BBS5	27160	170333505	170338505
NM_176824	chr4	-	122745483	122791652	BBS7	46169	122789152	122794152
NM_001348041	chr7	+	33169151	33676526	BBS9	507375	33166651	33171651
NM_001276286	chr3	+	107241782	107530176	BBX	288394	107239282	107244282
NM_005581	chr19	+	45312315	45324678	BCAM	12363	45309815	45314815
NM_021948	chr1	+	156611739	156629324	BCAN	17585	156609239	156614239
NR_027830	chr7	+	107220421	107263762	BCAP29	43341	107217921	107222921
NM_001256447	chrX	-	152965946	152990201	BCAP31	24255	152987701	152992701
NM_001170715	chr16	-	75262927	75301951	BCAR1	39024	75299451	75304451
NM_001261408	chr1	-	94027342	94312706	BCAR3	285364	94310206	94315206
NR_131217	chr16	-	11913690	11922689	BCAR4	8999	11920189	11925189
NM_003657	chr20	-	52560076	52687304	BCAS1	127228	52684804	52689804
NM_005872	chr1	-	115110180	115124265	BCAS2	14085	115121765	115126765
NM_001330414	chr17	+	58755135	59470199	BCAS3	715064	58752635	58757635
NM_017843	chr20	+	49411430	49493714	BCAS4	82284	49408930	49413930
NM_001178091	chr12	-	24962957	25102393	BCAT1	139436	25099893	25104893
NM_001284325	chr19	-	49298318	49314320	BCAT2	16002	49311820	49316820
NM_016567	chr10	+	127512103	127542264	BCCIP	30161	127509603	127514603
NM_181708	chr12	-	50229825	50236912	BCDIN3D	7087	50234412	50239412
NR_027501	chr12	+	50222325	50234937	BCDIN3D-AS1	12612	50219825	50224825
NM_000055	chr3	-	165490690	165555260	BCHE	64570	165552760	165557760
NM_000709	chr19	+	41903693	41930910	BCKDHA	27217	41901193	41906193
NR_134945	chr6	+	80816326	81055987	BCKDHB	239661	80813826	80818826
NM_005881	chr16	+	31119614	31124112	BCKDK	4498	31117114	31122114
NM_001320715	chr1	-	85731459	85742587	BCL10	11128	85740087	85745087
NM_138559	chr2	-	60678301	60780633	BCL11A	102332	60778133	60783133
NM_022898	chr14	-	99635624	99738050	BCL11B	102426	99735550	99740550
NM_000633	chr18	-	60790578	60986613	BCL2	196035	60984113	60989113
NM_004049	chr15	-	80253231	80263643	BCL2A1	10412	80261143	80266143
NM_001317921	chr20	-	30252254	30311802	BCL2L1	59548	30309302	30314302
NM_020396	chr15	-	52401465	52404972	BCL2L10	3507	52402472	52407472
NM_001204107	chr2	+	111878490	111926022	BCL2L11	47532	111875990	111880990
NR_104202	chr19	+	50168398	50177173	BCL2L12	8775	50165898	50170898
NM_015367	chr22	+	18121349	18213621	BCL2L13	92272	18118849	18123849
NM_138723	chr12	+	12223877	12252627	BCL2L14	28750	12221377	12226377
NM_001010922	chr1	-	114419435	114430169	BCL2L15	10734	114427669	114432669
NM_004050	chr14	+	23775970	23780968	BCL2L2	4998	23773470	23778470
NM_001199864	chr14	+	23775970	23795394	BCL2L2-PABPN1	19424	23773470	23778470
NM_005178	chr19	+	45251977	45263301	BCL3	11324	45249477	45254477
NM_001706	chr3	-	187439164	187463513	BCL6	24349	187461013	187466013
NM_181844	chr17	+	6926368	6932961	BCL6B	6593	6923868	6928868
NM_020993	chr12	+	122459791	122499950	BCL7A	40159	122457291	122462291
NM_001301061	chr7	-	72950682	72972065	BCL7B	21383	72969565	72974565
NM_001286526	chr16	-	30845361	30905623	BCL7C	60262	30903123	30908123
NM_004326	chr1	+	147013270	147098020	BCL9	84750	147010770	147015770
NM_182557	chr11	-	118766850	118781613	BCL9L	14763	118779113	118784113
NM_001301038	chr6	-	136578000	136610989	BCLAF1	32989	136608489	136613489
NM_198279	chrX	-	19930979	19988382	BCLAF3	57403	19985882	19990882
NM_017429	chr16	+	81272295	81324747	BCO1	52452	81269795	81274795
NM_001256398	chr11	+	112046207	112089649	BCO2	43442	112043707	112048707
NM_001123383	chrX	-	39910498	40036582	BCOR	126084	40034082	40039082
NM_021946	chrX	+	129139163	129192058	BCORL1	52895	129136663	129141663
NR_002923	chrY	-	21617316	21665039	BCORP1	47723	21662539	21667539
NM_021574	chr22	+	23522551	23660224	BCR	137673	23520051	23525051
NR_037566	chr22	+	21457304	21476575	BCRP2	19271	21454804	21459804
NR_024494	chr22	+	25028881	25049327	BCRP3	20446	25026381	25031381
NM_001320717	chr2	+	219524378	219528166	BCS1L	3788	219521878	219526878
NR_001568	chrX	-	70430034	70948962	BCYRN1	518928	70946462	70951462
NM_203315	chr3	-	197236653	197300194	BDH1	63541	197297694	197302694
NM_020139	chr4	-	103998781	104021024	BDH2	22243	104018524	104023524
NM_000710	chr14	+	96722546	96731100	BDKRB1	8554	96720046	96725046
NM_000623	chr14	+	96671134	96710666	BDKRB2	39532	96668634	96673634
NM_170731	chr11	-	27676440	27743605	BDNF	67165	27741105	27746105
NR_033312	chr11	+	27528398	27719718	BDNF-AS	191320	27525898	27530898
NM_018429	chr5	+	70751441	70863649	BDP1	112208	70748941	70753941
NM_001197225	chr16	+	66461199	66529191	BEAN1	67992	66458699	66463699
NR_109960	chr16	-	66503698	66510305	BEAN1-AS1	6607	66507805	66512805
NM_001314000	chr17	-	40962149	40976333	BECN1	14184	40973833	40978833
NM_020836	chr14	-	101003483	101036131	BEGAIN	32648	101033631	101038631
NM_153346	chrX	-	18181050	18239024	BEND2	57974	18236524	18241524
NM_001080450	chr6	-	107386384	107435636	BEND3	49252	107433136	107438136
NR_027512	chr10	+	81442730	81448650	BEND3P3	5920	81440230	81445230
NM_001159547	chr4	-	42112869	42154895	BEND4	42026	42152395	42157395
NM_024603	chr1	-	49193194	49242641	BEND5	49447	49240141	49245141
NM_152731	chr6	+	56819772	56892142	BEND6	72370	56817272	56822272
NM_152751	chr10	-	13480483	13544976	BEND7	64493	13542476	13547476
NR_134580	chr11	+	61717355	61731935	BEST1	14580	61714855	61719855
NM_017682	chr19	+	12863406	12869271	BEST2	5865	12860906	12865906
NM_001282614	chr12	-	70037287	70093196	BEST3	55909	70090696	70095696
NM_153274	chr1	-	45249256	45253426	BEST4	4170	45250926	45255926
NR_133908	chr7	-	93592081	93633694	BET1	41613	93631194	93636194
NM_016526	chr11	-	202923	207422	BET1L	4499	204922	209922
NM_016561	chr16	+	14726667	14763093	BFAR	36426	14724167	14729167
NM_001278608	chr20	-	17474549	17549865	BFSP1	75316	17547365	17552365
NM_003571	chr3	+	133118838	133194056	BFSP2	75218	133116338	133121338
NR_135277	chr3	-	133145245	133209990	BFSP2-AS1	64745	133207490	133212490
NM_001711	chrX	+	152760346	152775012	BGN	14666	152757846	152762846
NM_001142528	chrX	+	101975641	102007369	BHLHB9	31728	101973141	101978141
NM_152414	chr8	+	65492794	65496191	BHLHE22	3397	65490294	65495294
NM_003670	chr3	+	5021096	5026865	BHLHE40	5769	5018596	5023596
NR_037903	chr3	-	4938492	5021646	BHLHE40-AS1	83154	5019146	5024146
NM_030762	chr12	-	26272958	26278003	BHLHE41	5045	26275503	26280503
NM_001310124	chr19	+	46236508	46267797	BHMG1	31289	46234008	46239008
NM_001713	chr5	+	78407603	78428113	BHMT	20510	78405103	78410103
NM_017614	chr5	+	78365546	78385897	BHMT2	20351	78363046	78368046
NM_001080512	chr10	+	60272903	60591197	BICC1	318294	60270403	60275403
NM_001714	chr12	+	32260184	32531141	BICD1	270957	32257684	32262684
NM_015250	chr9	-	95473644	95527083	BICD2	53439	95524583	95529583
NM_207311	chr12	+	120427647	120532299	BICDL1	104652	120425147	120430147
NM_001103175	chr16	-	3077867	3085542	BICDL2	7675	3083042	3088042
NM_015711	chr19	+	48111452	48206534	BICRA	95082	48108952	48113952
NM_001318819	chr6	+	42714695	42836298	BICRAL	121603	42712195	42717195
NM_001244567	chr22	-	18216905	18257431	BID	40526	18254931	18259931
NM_001197	chr22	+	43506753	43525718	BIK	18965	43504253	43509253
NM_001320641	chr2	-	127805598	127864903	BIN1	59305	127862403	127867403
NM_001290007	chr12	-	51674821	51718464	BIN2	43643	51715964	51720964
NM_018688	chr8	-	22477946	22526661	BIN3	48715	22524161	22529161
NM_001256166	chr11	+	102217912	102249401	BIRC2	31489	102215412	102220412
NM_001165	chr11	+	102188180	102210135	BIRC3	21955	102185680	102190680
NM_001168	chr17	+	76210276	76221716	BIRC5	11440	76207776	76212776
NM_016252	chr2	+	32582095	32843965	BIRC6	261870	32579595	32584595
NR_125793	chr2	-	32782587	32799885	BIRC6-AS2	17298	32797385	32802385
NM_139317	chr20	+	61867234	61871859	BIRC7	4625	61864734	61869734
NR_130766	chr19	+	17516494	17526545	BISPR	10051	17513994	17518994
NM_017693	chr13	+	103451398	103493888	BIVM	42490	103448898	103453898
NM_001204425	chr13	+	103459495	103528351	BIVM-ERCC5	68856	103456995	103461995
NR_103783	chr1	-	205404013	205425214	BLACAT1	21201	205422714	205427714
NR_103545	chr7	-	155149682	155160628	BLACE	10946	155158128	155163128
NM_006698	chr20	-	36145818	36156333	BLCAP	10515	36153833	36158833
NM_001330465	chr8	+	11351500	11422113	BLK	70613	11349e3	11354e3
NM_000057	chr15	+	91260557	91358692	BLM	98135	91258057	91263057
NM_000386	chr17	-	28575212	28619184	BLMH	43972	28616684	28621684
NM_001114094	chr10	-	97951454	98031333	BLNK	79879	98028833	98033833
NR_037655	chr12	+	56109817	56113491	BLOC1S1	3674	56107317	56112317
NR_037658	chr12	+	56109817	56118526	BLOC1S1-RDH5	8709	56107317	56112317
NM_001282437	chr10	-	102033034	102046469	BLOC1S2	13435	102043969	102048969
NM_212550	chr19	+	45682002	45685059	BLOC1S3	3057	45679502	45684502
NM_001199322	chr6	-	8013799	8064647	BLOC1S5	50848	8062147	8067147
NR_037616	chr6	-	7881482	8064647	BLOC1S5-TXNDC5	183165	8062147	8067147
NR_132351	chr15	+	45879320	45901914	BLOC1S6	22594	45876820	45881820
NM_001253823	chr7	+	43798271	43846941	BLVRA	48670	43795771	43800771
NM_000713	chr19	-	40953690	40971725	BLVRB	18035	40969225	40974225
NM_003666	chr1	+	169337116	169365780	BLZF1	28664	169334616	169339616
NM_001003943	chr15	-	40380090	40401085	BMF	20995	40398585	40403585
NM_005180	chr10	+	22610138	22620414	BMI1	10276	22607638	22612638
NM_006129	chr8	+	22022652	22069840	BMP1	47188	22020152	22025152
NM_014482	chr2	-	69088047	69098649	BMP10	10602	69096149	69101149
NM_005448	chrX	+	50653734	50659641	BMP15	5907	50651234	50656234
NM_001200	chr20	+	6748744	6760925	BMP2	12181	6746244	6751244
NM_198892	chr4	+	79697531	79833341	BMP2K	135810	79695031	79700031
NM_001201	chr4	+	81952118	81978779	BMP3	26661	81949618	81954618
NM_001202	chr14	-	54416454	54423609	BMP4	7155	54421109	54426109
NM_001329756	chr6	-	55618450	55740388	BMP5	121938	55737888	55742888
NM_001718	chr6	+	7726331	7881961	BMP6	155630	7723831	7728831
NM_001719	chr20	-	55743808	55841707	BMP7	97899	55839207	55844207
NM_181809	chr1	+	39957317	39995541	BMP8A	38224	39954817	39959817
NM_001720	chr1	-	40222853	40254533	BMP8B	31680	40252033	40257033
NM_133468	chr7	+	33944522	34195484	BMPER	250962	33942022	33947022
NM_004329	chr10	+	88516395	88684945	BMPR1A	168550	88513895	88518895
NM_001203	chr4	+	95679127	96079601	BMPR1B	400474	95676627	95681627
NR_121610	chr4	-	95664818	95678684	BMPR1B-AS1	13866	95676184	95681184
NM_001204	chr2	+	203241049	203432474	BMPR2	191425	203238549	203243549
NM_014753	chr10	+	43277953	43330385	BMS1	52432	43275453	43280453
NR_146105	chr9	-	67324218	67340165	BMS1P14	15947	67337665	67342665
NR_073460	chr14	-	19670791	19681016	BMS1P17	10225	19678516	19683516
NR_073459	chr14	-	19670791	19681016	BMS1P18	10225	19678516	19683516
NR_027293	chr22	+	22652462	22677324	BMS1P20	24862	22649962	22654962
NR_033857	chr10	+	81664653	81691557	BMS1P21	26904	81662153	81667153
NR_133911	chr14	-	19670791	19686002	BMS1P22	15211	19683502	19688502
NR_026592	chr10	-	75458908	75490272	BMS1P4	31364	75487772	75492772
NR_003611	chr10	-	46737612	46762892	BMS1P5	25280	46760392	46765392
NR_024495	chr10	+	48185838	48203780	BMS1P6	17942	48183338	48188338
NM_152556	chr7	-	112459201	112579932	BMT2	120731	112577432	112582432
NM_203281	chrX	+	15518899	15574652	BMX	55753	15516399	15521399
NM_001717	chr15	-	83924654	83953468	BNC1	28814	83950968	83955968
NM_001317940	chr9	-	16409500	16870786	BNC2	461286	16868286	16873286
NM_013979	chr5	+	172571444	172591390	BNIP1	19946	172568944	172573944
NM_001320674	chr15	-	59951344	59981733	BNIP2	30389	59979233	59984233
NM_004052	chr10	-	133781186	133795517	BNIP3	14331	133793017	133798017
NM_004331	chr8	+	26240522	26270644	BNIP3L	30122	26238022	26243022
NM_138278	chr1	+	151009028	151020076	BNIPL	11048	151006528	151011528
NM_033254	chr3	+	112930311	113006310	BOC	75999	112927811	112932811
NM_138369	chr5	-	173034147	173043666	BOD1	9519	173041166	173046166
NM_148894	chr4	-	13570365	13629328	BOD1L1	58963	13626828	13631828
NM_001257964	chr18	+	54814292	54817639	BOD1L2	3347	54811792	54816792
NM_032515	chr2	+	242498145	242513553	BOK	15408	242495645	242500645
NR_033346	chr2	-	242483800	242498558	BOK-AS1	14758	242496058	242501058
NM_001320622	chr16	-	29454225	29466285	BOLA2-SMG1P6	12060	29463785	29468785
NM_212552	chr2	-	74362527	74375039	BOLA3	12512	74372539	74377539
NR_045634	chr2	+	74375107	74379516	BOLA3-AS1	4409	74372607	74377607
NM_001284358	chr2	-	198591602	198651036	BOLL	59434	198648536	198653536
NM_015201	chr8	-	145486001	145515120	BOP1	29119	145512620	145517620
NM_024808	chr13	+	73301886	73330336	BORA	28450	73299386	73304386
NM_058169	chr12	+	12510012	12624155	BORCS5	114143	12507512	12512512
NM_001136200	chr10	+	104613966	104624718	BORCS7	10752	104611466	104616466
NR_037644	chr10	+	104613966	104661655	BORCS7-ASMT	47689	104611466	104616466
NM_001145784	chr19	-	19287712	19303400	BORCS8	15688	19300900	19305900
NM_005919	chr19	-	19256375	19303400	BORCS8-MEF2B	47025	19300900	19305900
NR_026783	chr3	+	138823026	138844005	BPESC1	20979	138820526	138825526
NM_001293085	chr7	+	134331530	134364567	BPGM	33037	134329030	134334030
NR_026649	chr6	+	3118609	3153432	BPHL	34823	3116109	3121109
NM_001725	chr20	+	36932551	36965905	BPI	33354	36930051	36935051
NM_016583	chr20	+	31823801	31831115	BPIFA1	7314	31821301	31826301
NM_001319164	chr20	+	31749653	31769223	BPIFA2	19570	31747153	31752153
NM_178466	chr20	+	31805115	31815612	BPIFA3	10497	31802615	31807615
NR_026760	chr20	+	31781410	31798268	BPIFA4P	16858	31778910	31783910
NM_033197	chr20	+	31870940	31897684	BPIFB1	26744	31868440	31873440
NM_025227	chr20	+	31595383	31611515	BPIFB2	16132	31592883	31597883
NM_182658	chr20	+	31643136	31661443	BPIFB3	18307	31640636	31645636
NM_182519	chr20	+	31669317	31699557	BPIFB4	30240	31666817	31671817
NM_174897	chr20	+	31619453	31631853	BPIFB6	12400	31616953	31621953
NM_174932	chr22	-	32809833	32853373	BPIFC	43540	32850873	32855873
NM_001286149	chr1	-	220230823	220263195	BPNT1	32372	220260695	220265695
NM_004459	chr17	+	65821779	65980494	BPTF	158715	65819279	65824279
NM_004678	chrY	+	26764150	26785352	BPY2	21202	26761650	26766650
NM_001002760	chrY	+	26764150	26785352	BPY2B	21202	26761650	26766650
NM_001002761	chrY	+	26764150	26785352	BPY2C	21202	26761650	26766650
NM_004333	chr7	-	140433812	140624564	BRAF	190752	140622064	140627064
NM_006768	chr12	-	112079949	112123800	BRAP	43851	112121300	112126300
NM_152743	chr7	-	2577443	2595392	BRAT1	17949	2592892	2597892
NM_007300	chr17	-	41196311	41277500	BRCA1	81189	41275e3	4128e4
NM_000059	chr13	+	32889616	32973809	BRCA2	84193	32887116	32892116
NR_109864	chr5	-	44744429	44808895	BRCAT54	64466	44806395	44811395
NM_001242640	chrX	+	154299694	154351349	BRCC3	51655	154297194	154302194
NM_001304808	chr22	-	50166925	50221575	BRD1	54650	50219075	50224075
NM_005104	chr6_ssto_hap7	+	4367204	4430060	BRD2	62856	4364704	4369704
NM_007371	chr9	-	136895445	136933141	BRD3	37696	136930641	136935641
NM_001330384	chr19	-	15363805	15443354	BRD4	79549	15440854	15445854
NM_001173984	chr16	-	50352928	50402845	BRD7	49917	50400345	50405345
NM_139199	chr5	-	137475458	137514358	BRD8	38900	137511858	137516858
NM_023924	chr5	-	863849	892939	BRD9	29090	890439	895439
NM_001242805	chr1	+	92414927	92479985	BRDT	65058	92412427	92417427
NM_001242786	chr14	-	105675622	105781914	BRF1	106292	105779414	105784414
NM_018310	chr8	-	37701397	37707431	BRF2	6034	37704931	37709931
NM_001159491	chr7	+	97910978	97922275	BRI3	11297	97908478	97913478
NM_080626	chr12	+	125478193	125510349	BRI3BP	32156	125475693	125480693
NM_014618	chr9	-	121928907	122131739	BRINP1	202832	122129239	122134239
NM_021165	chr1	+	177140523	177251558	BRINP2	111035	177138023	177143023
NM_199051	chr1	-	190066796	190447012	BRINP3	380216	190444512	190449512
NM_032043	chr17	-	59756546	59940920	BRIP1	184374	59938420	59943420
NM_018321	chr5	+	34915819	34925787	BRIX1	9968	34913319	34918319
NM_018462	chr3	+	10157332	10168874	BRK1	11542	10154832	10159832
NM_001024957	chr11	-	66104803	66112582	BRMS1	7779	66110082	66115082
NM_032352	chr14	+	36295596	36341169	BRMS1L	45573	36293096	36298096
NM_001288579	chr1	+	222885894	222908538	BROX	22644	222883394	222888394
NM_001319049	chr3	+	9773412	9789701	BRPF1	16289	9770912	9775912
NM_015695	chr6	+	36164549	36200567	BRPF3	36018	36162049	36167049
NM_001727	chrX	+	135570124	135574598	BRS3	4474	135567624	135572624
NM_032430	chr19	+	55795533	55823903	BRSK1	28370	55793033	55798033
NR_046331	chr11	+	1411128	1483919	BRSK2	72791	1408628	1413628
NM_033656	chr21	-	40557403	40685712	BRWD1	128309	40683212	40688212
NR_046655	chr21	+	40687632	40695144	BRWD1-AS1	7512	40685132	40690132
NM_153252	chrX	-	79924986	80065233	BRWD3	140247	80062733	80067733
NR_037949	chr11	-	62457733	62477091	BSCL2	19358	62474591	62479591
NR_125352	chr1	-	32830233	32860062	BSDC1	29829	32857562	32862562
NM_198591	chr19	+	571276	583493	BSG	12217	568776	573776
NM_003458	chr3	+	49591921	49708982	BSN	117061	49589421	49594421
NR_038866	chr3	-	49586738	49591799	BSN-AS2	5061	49589299	49594299
NM_057176	chr1	+	55464616	55474465	BSND	9849	55462116	55467116
NM_001128326	chr19	-	48471302	48495427	BSPH1	24125	48492927	48497927
NM_001317944	chr9	+	116111811	116133513	BSPRY	21702	116109311	116114311
NM_004334	chr4	+	15704572	15733796	BST1	29224	15702072	15707072
NM_004335	chr19	-	17513747	17516457	BST2	2710	17513957	17518957
NM_001098169	chr11	-	122848356	122852379	BSX	4023	122849879	122854879
NM_003972	chr10	+	93683735	93790080	BTAF1	106345	93681235	93686235
NM_025238	chr15	-	83685180	83736106	BTBD1	50926	83733606	83738606
NM_001297741	chr11	-	13409542	13484844	BTBD10	75302	13482344	13487344
NM_001347943	chr12	+	107712196	108053419	BTBD11	341223	107709696	107714696
NM_144587	chr10	+	124030810	124097695	BTBD16	66885	124028310	124033310
NM_001080466	chr17	-	72352554	72357958	BTBD17	5404	72355458	72360458
NM_001145101	chr11	-	57510985	57519253	BTBD18	8268	57516753	57521753
NM_001136537	chr1	+	45274153	45279801	BTBD19	5648	45271653	45276653
NM_017797	chr19	-	1985446	2015702	BTBD2	30256	2013202	2018202
NM_181443	chr20	+	11871370	11907243	BTBD3	35873	11868870	11873870
NM_033271	chr14	+	105714878	105717430	BTBD6	2552	105712378	105717378
NM_001002860	chr14	-	93703895	93799438	BTBD7	95543	93796938	93801938
NM_183242	chr1	+	92545861	92613401	BTBD8	67540	92543361	92548361
NM_052893	chr6	-	38136226	38607924	BTBD9	471698	38605424	38610424
NM_001316963	chr4	-	75669969	75719896	BTC	49927	75717396	75722396
NM_001281723	chr3	+	15642858	15689141	BTD	46283	15640358	15645358
NM_001207	chr5	+	72794249	72801448	BTF3	7199	72791749	72796749
NM_152265	chr1	+	52521856	52556388	BTF3L4	34532	52519356	52524356
NM_001731	chr12	-	92534053	92539673	BTG1	5620	92537173	92542173
NM_006763	chr1	+	203274663	203278729	BTG2	4066	203272163	203277163
NM_001130914	chr21	-	18965967	18985268	BTG3	19301	18982768	18987768
NM_017589	chr11	-	111338255	111383079	BTG4	44824	111380579	111385579
NM_001287344	chrX	-	100604434	100645784	BTK	41350	100643284	100648284
NM_001085357	chr3	-	112182812	112218408	BTLA	35596	112215908	112220908
NM_001732	chr6	+	26501494	26510652	BTN1A1	9158	26498994	26503994
NM_001197234	chr6	+	26458131	26476849	BTN2A1	18718	26455631	26460631
NM_001197238	chr6	+	26383323	26395100	BTN2A2	11777	26380823	26385823
NR_027795	chr6	+	26421618	26430816	BTN2A3P	9198	26419118	26424118
NM_001145009	chr6	+	26402464	26415444	BTN3A1	12980	26399964	26404964
NM_001197247	chr6	+	26365386	26378548	BTN3A2	13162	26362886	26367886
NM_197974	chr6	+	26440699	26453643	BTN3A3	12944	26438199	26443199
NM_001304561	chr6_mann_hap4	-	3703951	3717767	BTNL2	13816	3715267	3720267
NM_197975	chr5	+	180415844	180433727	BTNL3	17883	180413344	180418344
NM_001159709	chr5	+	180326076	180377906	BTNL8	51830	180323576	180328576
NM_152547	chr5	+	180467224	180488523	BTNL9	21299	180464724	180469724
NM_033637	chr10	+	103113789	103317078	BTRC	203289	103111289	103116289
NM_004336	chr2	-	111395274	111435684	BUB1	40410	111433184	111438184
NM_001211	chr15	+	40453209	40513337	BUB1B	60128	40450709	40455709
NM_001128629	chr15	+	40509628	40569688	BUB1B-PAK6	60060	40507128	40512128
NM_004725	chr10	+	124913759	124924886	BUB3	11127	124911259	124916259
NM_001159736	chr11	-	116618885	116643714	BUD13	24829	116641214	116646214
NR_037776	chr7	+	73097897	73112551	BUD23	14654	73095397	73100397
NM_003910	chr7	+	99006600	99017239	BUD31	10639	99004100	99009100
NM_001199563	chr6	-	105544698	105585049	BVES	40351	105582549	105587549
NR_037157	chr6	+	105585561	105617819	BVES-AS1	32258	105583061	105588061
NM_004053	chr6	+	41888964	41900784	BYSL	11820	41886464	41891464
NM_014670	chr2	+	201676268	201688569	BZW1	12301	201673768	201678768
NR_027624	chr7	+	16685758	16746148	BZW2	60390	16683258	16688258
NM_007021	chr10	-	45471708	45474330	C10orf10	2622	45471830	45476830
NM_001168390	chr10	-	73471457	73497581	C10orf105	26124	73495081	73500081
NM_173554	chr10	+	63422718	63526091	C10orf107	103373	63420218	63425218
NM_001177483	chr10	-	21414691	21435488	C10orf113	20797	21432988	21437988
NM_001278522	chr10	+	29135336	29170826	C10orf126	35490	29132836	29137836
NM_001010863	chr10	-	50362768	50396459	C10orf128	33691	50393959	50398959
NR_126421	chr10	-	45489379	45496358	C10orf25	6979	45493858	45498858
NM_145306	chr10	+	71390002	71393355	C10orf35	3353	71387502	71392502
NM_182554	chr10	+	50887683	50916956	C10orf53	29273	50885183	50890183
NM_001001791	chr10	-	75669726	75682535	C10orf55	12809	75680035	75685035
NM_001351306	chr10	-	23591164	23633774	C10orf67	42610	23631274	23636274
NM_001135196	chr10	+	50507186	50535537	C10orf71	28351	50504686	50509686
NR_108038	chr10	-	50504327	50506938	C10orf71-AS1	2611	50504438	50509438
NM_024541	chr10	-	103605355	103815932	C10orf76	210577	103813432	103818432
NM_001350930	chr10	-	118421722	118429775	C10orf82	8053	118427275	118432275
NM_024942	chr10	-	124690418	124713919	C10orf88	23501	124711419	124716419
NM_001350921	chr10	-	128113565	128359079	C10orf90	245514	128356579	128361579
NM_173541	chr10	+	134258713	134261825	C10orf91	3112	134256213	134261213
NM_207373	chr10	+	85933553	85945050	C10orf99	11497	85931053	85936053
NM_022761	chr11	+	111749947	111754797	C11orf1	4850	111747447	111752447
NM_020643	chr11	-	8941622	8954553	C11orf16	12931	8952053	8957053
NR_138249	chr11	-	2316869	2324279	C11orf21	7410	2321779	2326779
NM_001300913	chr11	-	68028802	68039469	C11orf24	10667	68036969	68041969
NM_144663	chr11	-	4592652	4599050	C11orf40	6398	4596550	4601550
NM_173525	chr11	+	6226797	6232365	C11orf42	5568	6224297	6229297
NM_001271983	chr11	+	130542850	130587247	C11orf44	44397	130540350	130545350
NR_045767	chr11	-	128769459	128776126	C11orf45	6667	128773626	128778626
NM_001003678	chr11	+	46958239	47185931	C11orf49	227692	46955739	46960739
NM_080659	chr11	+	111789600	111797595	C11orf52	7995	111787100	111792100
NM_198498	chr11	+	111126706	111157129	C11orf53	30423	111124206	111129206
NM_014039	chr11	+	93474759	93496268	C11orf54	21509	93472259	93477259
NM_001301019	chr11	+	111944967	111955874	C11orf57	10907	111942467	111947467
NM_014267	chr11	+	16760147	16779901	C11orf58	19754	16757647	16762647
NM_024806	chr11	+	122753235	122830430	C11orf63	77195	122750735	122755735
NM_001330368	chr11	-	108179245	108338258	C11orf65	159013	108335758	108340758
NM_032930	chr11	+	101918168	101955291	C11orf70	37123	101915668	101920668
NM_019021	chr11	-	114262169	114271272	C11orf71	9103	114268772	114273772
NR_130935	chr11	-	67370350	67374177	C11orf72	3827	67371677	67376677
NM_001276725	chr11	+	36616042	36680841	C11orf74	64799	36613542	36618542
NM_024650	chr11	+	66512206	66610987	C11orf80	98781	66509706	66514706
NM_138471	chr11	+	63580845	63595190	C11orf84	14345	63578345	63583345
NM_207645	chr11	+	109292845	109299893	C11orf87	7048	109290345	109295345
NM_001100388	chr11	+	111385509	111407756	C11orf88	22247	111383009	111388009
NM_001166692	chr11	-	33719653	33722286	C11orf91	2633	33719786	33724786
NM_001144936	chr11	-	63527363	63536113	C11orf95	8750	63533613	63538613
NM_001190462	chr11	+	94245694	94265289	C11orf97	19595	94243194	94248194
NM_021640	chr12	+	53693469	53700965	C12orf10	7496	53690969	53695969
NM_001009894	chr12	+	88429267	88443937	C12orf29	14670	88426767	88431767
NM_020374	chr12	-	4596895	4647674	C12orf4	50779	4645174	4650174
NR_135051	chr12	+	40019968	40302102	C12orf40	282134	40017468	40022468
NR_103526	chr12	-	103631368	103889788	C12orf42	258420	103887288	103892288
NR_104409	chr12	-	121440224	121454305	C12orf43	14081	121451805	121456805
NM_152318	chr12	+	105380097	105388505	C12orf45	8408	105377597	105382597
NM_024738	chr12	-	117151124	117175875	C12orf49	24751	117173375	117178375
NM_152589	chr12	-	88373815	88423176	C12orf50	49361	88420676	88425676
NM_152319	chr12	+	48876285	48890297	C12orf54	14012	48873785	48878785
NM_001099676	chr12	-	64660762	64784345	C12orf56	123583	64781845	64786845
NM_001301836	chr12	+	7052600	7055166	C12orf57	2566	7050100	7055100
NM_175874	chr12	+	14956505	14976791	C12orf60	20286	14954005	14959005
NM_152269	chr12	+	123717843	123742506	C12orf65	24663	123715343	123720343
NM_001300940	chr12	-	64580091	64616076	C12orf66	35985	64613576	64618576
NM_001135570	chr12	-	104343980	104350993	C12orf73	7013	104348493	104353493
NM_001037671	chr12	+	93096618	93102325	C12orf74	5707	93094118	93099118
NM_001145199	chr12	+	105724413	105765296	C12orf75	40883	105721913	105726913
NM_207435	chr12	-	110478981	110505500	C12orf76	26519	110503e3	110508e3
NM_001101339	chr12	-	25146364	25150373	C12orf77	4009	25147873	25152873
NM_001242696	chr12	-	52599364	52604639	C12orf80	5275	52602139	52607139
NR_102431	chr13	-	51656983	51746524	C13orf42	89541	51744024	51749024
NM_001283058	chr14	-	57936017	57960581	C14orf105	24564	57958081	57963081
NM_017924	chr14	+	23564682	23569665	C14orf119	4983	23562182	23567182
NM_001282463	chr14	+	96505660	96560308	C14orf132	54648	96503160	96508160
NR_146612	chr14	+	104689920	104754406	C14orf144	64486	104687420	104692420
NM_001102366	chr14	+	91580356	91691740	C14orf159	111384	91577856	91582856
NM_016039	chr14	+	52456227	52471420	C14orf166	15193	52453727	52458727
NM_182560	chr14	+	99177949	99184103	C14orf177	6154	99175449	99180449
NM_174943	chr14	+	78227172	78236085	C14orf178	8913	78224672	78229672
NM_001008404	chr14	+	105046020	105056184	C14orf180	10164	105043520	105048520
NM_004894	chr14	-	104378624	104387903	C14orf2	9279	104385403	104390403
NM_001017923	chr14	+	45366506	45376460	C14orf28	9954	45364006	45369006
NM_001001872	chr14	-	58470773	58618957	C14orf37	148184	58616457	58621457
NM_174978	chr14	-	60902673	60952764	C14orf39	50091	60950264	60955264
NM_001198983	chr14	+	105956191	105965585	C14orf80	9394	105953691	105958691
NM_021944	chr14	-	23456109	23479410	C14orf93	23301	23476910	23481910
NM_001301106	chr15	+	93014906	93044347	C15orf32	29441	93012406	93017406
NM_001199058	chr15	-	90373830	90456222	C15orf38-AP3S2	82392	90453722	90458722
NM_015492	chr15	+	75494220	75504510	C15orf39	10290	75491720	75496720
NM_001160116	chr15	-	83657714	83680393	C15orf40	22679	83677893	83682893
NM_001130010	chr15	+	36871803	37102461	C15orf41	230658	36869303	36874303
NM_032413	chr15	+	45722726	45725647	C15orf48	2921	45720226	45725226
NM_207380	chr15	-	40623652	40633168	C15orf52	9516	40630668	40635668
NM_207444	chr15	+	38988798	38992239	C15orf53	3441	38986298	38991298
NR_144508	chr15	+	39542869	39547043	C15orf54	4174	39540369	39545369
NM_001303254	chr15	-	74027771	74044711	C15orf59	16940	74042211	74047211
NM_001143936	chr15	+	67813521	67819641	C15orf61	6120	67811021	67816021
NM_001198784	chr15	+	55700722	55710910	C15orf65	10188	55698222	55703222
NM_033201	chr16	+	15528324	15682116	C16orf45	153792	15525824	15530824
NM_001100873	chr16	-	81087101	81110872	C16orf46	23771	81108372	81113372
NM_207385	chr16	-	73160536	73178346	C16orf47	17810	73175846	73180846
NM_001164579	chr16	+	22019455	22095972	C16orf52	76517	22016955	22021955
NM_175900	chr16	-	29753785	29757340	C16orf54	3555	29754840	29759840
NM_022744	chr16	-	31500795	31519740	C16orf58	18945	31517240	31522240
NM_025108	chr16	+	2510114	2514964	C16orf59	4850	2507614	2512614
NM_001300743	chr16	+	19566736	19712485	C16orf62	145749	19564236	19569236
NM_001320540	chr16	+	67143795	67182447	C16orf70	38652	67141295	67146295
NM_139170	chr16	+	4784288	4799397	C16orf71	15109	4781788	4786788
NM_014117	chr16	+	9185536	9213555	C16orf72	28019	9183036	9188036
NM_206967	chr16	-	85741123	85784689	C16orf74	43566	85782189	85787189
NM_144602	chr16	+	49407718	49433342	C16orf78	25624	49405218	49410218
NM_001348660	chr16	-	46830518	46865319	C16orf87	34801	46862819	46867819
NM_152459	chr16	-	5094122	5116146	C16orf89	22024	5113646	5118646
NM_001353382	chr16	-	3543483	3546652	C16orf90	3169	3544152	3549152
NM_001353379	chr16	+	30034654	30039057	C16orf92	4403	30032154	30037154
NM_001195125	chr16	-	87336403	87351026	C16orf95	14623	87348526	87353526
NM_001145011	chr16	+	4606490	4650318	C16orf96	43828	4603990	4608990
NM_001242473	chr16	-	52060263	52107847	C16orf97	47584	52105347	52110347
NM_207454	chr17	-	32901141	32906388	C17orf102	5247	32903888	32908888
NM_001136483	chr17	+	41857802	41862054	C17orf105	4252	41855302	41860302
NM_001145536	chr17	+	4802947	4806227	C17orf107	3280	4800447	4805447
NM_001038704	chr17	-	56618947	56621733	C17orf47	2786	56619233	56624233
NM_174893	chr17	+	6918055	6920843	C17orf49	2788	6915555	6920555
NM_145272	chr17	+	34087915	34092098	C17orf50	4183	34085415	34090415
NM_001113434	chr17	-	21431570	21454941	C17orf51	23371	21452441	21457441
NM_001171251	chr17	+	42219269	42239844	C17orf53	20575	42216769	42221769
NM_181656	chr17	-	65987214	65989765	C17orf58	2551	65987265	65992265
NR_036514	chr17	-	80400462	80408707	C17orf62	8245	80406207	80411207
NM_181707	chr17	+	58499864	58508787	C17orf64	8923	58497364	58502364
NM_001085430	chr17	-	54869273	54911287	C17orf67	42014	54908787	54913787
NM_022344	chr17	-	30655459	30669228	C17orf75	13769	30666728	30671728
NM_001302809	chr17	+	72580817	72590348	C17orf77	9531	72578317	72583317
NM_173625	chr17	+	35732927	35749662	C17orf78	16735	35730427	35735427
NM_001288770	chr17	+	71228228	71245095	C17orf80	16867	71225728	71230728
NM_001013672	chr17	+	260117	264457	C17orf97	4340	257617	262617
NM_001080465	chr17	-	36991340	36997642	C17orf98	6302	36995142	37000142
NM_001163075	chr17	+	76142433	76162364	C17orf99	19931	76139933	76144933
NR_146617	chr18	+	13239541	13242075	C18orf15	2534	13237041	13242041
NM_001201474	chr18	+	33552587	33559250	C18orf21	6663	33550087	33555087
NM_145055	chr18	+	43753987	43846955	C18orf25	92968	43751487	43756487
NM_001035005	chr18	-	47007547	47013644	C18orf32	6097	47011144	47016144
NM_001288980	chr18	+	51884286	51908405	C18orf54	24119	51881786	51886786
NR_049896	chr18	+	12200777	12224709	C18orf61	23932	12198277	12203277
NM_001174123	chr18	+	71983109	72026422	C18orf63	43313	71980609	71985609
NM_001272093	chr18	+	74207476	74210045	C18orf65	2569	74204976	74209976
NM_001276342	chr18	+	21083433	21111771	C18orf8	28338	21080933	21085933
NM_001256047	chr19	-	30189792	30206696	C19orf12	16904	30204196	30209196
NM_152474	chr19	-	58469804	58485902	C19orf18	16098	58483402	58488402
NM_017914	chr19	+	1275519	1279243	C19orf24	3724	1273019	1278019
NM_152482	chr19	-	1473199	1479228	C19orf25	6029	1476728	1481728
NM_198532	chr19	-	2274630	2282181	C19orf35	7551	2279681	2284681
NM_001136482	chr19	+	10959105	10980360	C19orf38	21255	10956605	10961605
NM_032207	chr19	+	16607121	16632180	C19orf44	25059	16604621	16609621
NM_001256440	chr19	-	40826966	40854434	C19orf47	27468	40851934	40856934
NM_001290149	chr19	-	51300949	51308110	C19orf48	7161	51305610	51310610
NM_014047	chr19	+	13885256	13889586	C19orf53	4330	13882756	13887756
NM_198476	chr19	-	41246760	41255828	C19orf54	9068	41253328	41258328
NM_001345843	chr19	-	13993160	14016978	C19orf57	23818	14014478	14019478
NM_001100419	chr19	+	18699494	18703147	C19orf60	3653	18696994	18701994
NM_018381	chr19	+	10196794	10203928	C19orf66	7134	10194294	10199294
NM_001277378	chr19	-	14192443	14196607	C19orf67	4164	14194107	14199107
NM_199341	chr19	+	48673948	48700877	C19orf68	26929	48671448	48676448
NM_001135580	chr19	+	3539154	3544028	C19orf71	4874	3536654	3541654
NM_001195076	chr19	+	51152701	51162567	C19orf81	9866	51150201	51155201
NM_006333	chr2	-	68269331	68290159	C1D	20828	68287659	68292659
NM_020156	chr7	+	7222245	7288280	C1GALT1	66035	7219745	7224745
NM_001011551	chrX	-	119759528	119764005	C1GALT1C1	4477	119761505	119766505
NM_001347465	chr1	+	22962998	22966175	C1QA	3177	22960498	22965498
NM_000491	chr1	+	22979473	22988129	C1QB	8656	22976973	22981973
NM_001212	chr17	-	5336098	5342471	C1QBP	6373	5339971	5344971
NM_172369	chr1	+	22970109	22974604	C1QC	4495	22967609	22972609
NM_006688	chr17	-	43037060	43045644	C1QL1	8584	43043144	43048144
NM_182528	chr2	-	119913818	119916471	C1QL2	2653	119913971	119918971
NM_001010908	chr10	-	16555741	16564004	C1QL3	8263	16561504	16566504
NM_001008223	chr12	-	49726199	49730971	C1QL4	4772	49728471	49733471
NM_153372	chr17	+	77019015	77045870	C1QTNF1	26855	77016515	77021515
NR_040019	chr17	-	77015290	77023737	C1QTNF1-AS1	8447	77021237	77026237
NM_001014980	chr1	-	1177825	1182102	C1QTNF12	4277	1179602	1184602
NM_031908	chr5	-	159774774	159797648	C1QTNF2	22874	159795148	159800148
NR_146599	chr5	-	34017962	34244829	C1QTNF3	226867	34242329	34247329
NR_037951	chr5	-	33987090	34124633	C1QTNF3-AMACR	137543	34122133	34127133
NM_031909	chr11	-	47611215	47615961	C1QTNF4	4746	47613461	47618461
NM_015645	chr11	-	119209643	119217383	C1QTNF5	7740	119214883	119219883
NM_182486	chr22	-	37576205	37584330	C1QTNF6	8125	37581830	37586830
NM_001135170	chr4	+	15341559	15447791	C1QTNF7	106232	15339059	15344059
NM_207419	chr16	-	1138225	1146244	C1QTNF8	8019	1143744	1148744
NM_001303138	chr13	+	24881303	24896669	C1QTNF9	15366	24878803	24883803
NR_104426	chr13	-	24465237	24471641	C1QTNF9B	6404	24469141	24474141
NM_001733	chr12	-	7187514	7245043	C1R	57529	7242543	7247543
NM_001297640	chr12	-	7247145	7261874	C1RL	14729	7259374	7264374
NR_026947	chr12	+	7260903	7274447	C1RL-AS1	13544	7258403	7263403
NM_001346850	chr12	+	7167964	7178335	C1S	10371	7165464	7170464
NM_001012970	chr1	+	244515936	244552388	C1orf100	36452	244513436	244518436
NM_139240	chr1	+	172389827	172437969	C1orf105	48142	172387327	172392327
NM_018265	chr1	+	200860626	200884864	C1orf106	24238	200858126	200863126
NM_001350763	chr1	-	38147241	38157946	C1orf109	10705	38155446	38160446
NM_001320048	chr1	+	169764139	169822230	C1orf112	58091	169761639	169766639
NM_024709	chr1	+	220863627	220872499	C1orf115	8872	220861127	220866127
NM_023938	chr1	-	207191865	207206101	C1orf116	14236	207203601	207208601
NM_017887	chr1	-	53679771	53686311	C1orf123	6540	53683811	53688811
NM_001170754	chr1	-	11006529	11042094	C1orf127	35565	11039594	11044594
NM_001300830	chr1	-	231359508	231376933	C1orf131	17425	231374433	231379433
NR_135298	chr1	-	207974862	207996048	C1orf132	21186	207993548	207998548
NM_001013643	chr1	+	117236733	117249225	C1orf137	12492	117234233	117239233
NR_024236	chr1	-	221503269	221509638	C1orf140	6369	221507138	221512138
NM_001276351	chr1	-	67557858	67600654	C1orf141	42796	67598154	67603154
NR_146760	chr1	+	218683436	218699320	C1orf143	15884	218680936	218685936
NM_001012425	chr1	+	92683572	92711367	C1orf146	27795	92681072	92686072
NM_001330361	chr1	+	12806133	12821102	C1orf158	14969	12803633	12808633
NM_017891	chr1	-	1017197	1051736	C1orf159	34539	1049236	1054236
NM_001300835	chr1	+	112016490	112021134	C1orf162	4644	112013990	112018990
NM_001010881	chr1	+	11822249	11849642	C1orf167	27393	11819749	11824749
NM_207356	chr1	-	3805696	3816857	C1orf174	11161	3814357	3819357
NM_001136508	chr1	+	51567899	51613757	C1orf185	45858	51565399	51570399
NM_001007544	chr1	-	206238871	206288647	C1orf186	49776	206286147	206291147
NM_001010979	chr1	-	154171561	154178841	C1orf189	7280	154176341	154181341
NM_001122961	chr1	-	109648572	109656479	C1orf194	7907	109653979	109658979
NM_001278502	chr1	-	15490691	15498120	C1orf195	7429	15495620	15500620
NM_001136494	chr1	-	230972864	231005335	C1orf198	32471	231002835	231007835
NM_030806	chr1	+	184356149	184598155	C1orf21	242006	184353649	184358649
NM_001164829	chr1	-	43747555	43751288	C1orf210	3733	43748788	43753788
NM_152374	chr1	-	36179476	36184790	C1orf216	5314	36182290	36187290
NR_033186	chr1	+	178511930	178518024	C1orf220	6094	178509430	178514430
NM_001085375	chr1	+	162351519	162356608	C1orf226	5089	162349019	162354019
NM_001145636	chr1	+	45140393	45191263	C1orf228	50870	45137893	45142893
NM_017847	chr1	+	186344889	186390503	C1orf27	45614	186342389	186347389
NM_024319	chr1	-	228288427	228291163	C1orf35	2736	228288663	228293663
NM_015449	chr1	-	154179176	154193273	C1orf43	14097	154190773	154195773
NR_040733	chr1	+	43232915	43241413	C1orf50	8498	43230415	43235415
NR_024113	chr1	-	85715636	85725355	C1orf52	9719	85722855	85727855
NM_001024594	chr1	+	197871681	197876497	C1orf53	4816	197869181	197874181
NM_001301039	chr1	+	150244686	150253335	C1orf54	8649	150242186	150247186
NM_017860	chr1	+	151020215	151023272	C1orf56	3057	151017715	151022715
NM_001320453	chr1	-	156374043	156399340	C1orf61	25297	156396840	156401840
NM_152485	chr1	-	209952552	209958075	C1orf74	5523	209955575	209960575
NM_152377	chr1	-	60456065	60539442	C1orf87	83377	60536942	60541942
NM_032884	chr1	+	34632483	34684731	C1orf94	52248	34629983	34634983
NM_001282457	chr6_dbb_hap3	+	3151143	3199039	C2	47896	3148643	3153643
NR_104191	chr6_mann_hap4	-	3245059	3252311	C2-AS1	7252	3249811	3254811
NR_033263	chr20	-	61141437	61148768	C20orf166-AS1	7331	61146268	61151268
NR_026933	chr20	-	34108569	34117481	C20orf173	8912	34114981	34119981
NR_146878	chr20	+	11007191	11010014	C20orf187	2823	11004691	11009691
NM_001009984	chr20	-	3229947	3388309	C20orf194	158362	3385809	3390809
NM_152504	chr20	+	5731032	5845053	C20orf196	114021	5728532	5733532
NM_001302813	chr20	+	58630979	58648008	C20orf197	17029	58628479	58633479
NM_001009612	chr20	+	1184097	1188918	C20orf202	4821	1181597	1186597
NM_182584	chr20	-	31219426	31261743	C20orf203	42317	31259243	31264243
NM_001348090	chr20	+	62665079	62670354	C20orf204	5275	62662579	62667579
NM_018840	chr20	+	35234136	35240960	C20orf24	6824	35231636	35236636
NR_047675	chr20	-	3734145	3749035	C20orf27	14890	3746535	3751535
NM_001302818	chr20	-	18789994	18810847	C20orf78	20853	18808347	18813347
NM_178456	chr20	+	56725982	56736183	C20orf85	10201	56723482	56728482
NM_153269	chr20	-	251503	271419	C20orf96	19916	268919	273919
NM_001271440	chr21	-	45748826	45759285	C21orf2	10459	45756785	45761785
NM_004649	chr21	+	45553493	45565605	C21orf33	12112	45550993	45555993
NM_001286476	chr21	-	47721043	47743813	C21orf58	22770	47741313	47746313
NM_021254	chr21	-	33971664	33985181	C21orf59	13517	33982681	33987681
NR_146638	chr21	-	33935814	33985181	C21orf59-TCP10L	49367	33982681	33987681
NM_001162496	chr21	-	34162983	34186053	C21orf62	23070	34183553	34188553
NR_024623	chr21	+	34144410	34170016	C21orf62-AS1	25606	34141910	34146910
NM_017447	chr21	-	19161283	19191703	C21orf91	30420	19189203	19194203
NR_038871	chr21	-	19149720	19164826	C21orf91-OT1	15106	19162326	19167326
NM_001331041	chr22	+	24105200	24108050	C22orf15	2850	24102700	24107700
NM_001207062	chr22	-	38339056	38349676	C22orf23	10620	38347176	38352176
NR_126507	chr22	-	32329506	32341348	C22orf24	11842	32338848	32343848
NM_015370	chr22	-	29454659	29457907	C22orf31	3248	29455407	29460407
NR_110522	chr22	-	49808173	50051190	C22orf34	243017	50048690	50053690
NM_001166242	chr22	-	19428409	19435755	C22orf39	7346	19433255	19438255
NM_001010859	chr22	-	32545518	32555243	C22orf42	9725	32552743	32557743
NM_001142964	chr22	+	42086546	42094140	C22orf46	7594	42084046	42089046
NM_015500	chr21	-	43305218	43373999	C2CD2	68781	43371499	43376499
NM_014807	chr11	+	118978059	118987834	C2CD2L	9775	118975559	118980559
NM_001286577	chr11	-	73723758	73882064	C2CD3	158306	73879564	73884564
NM_207322	chr15	+	62359175	62363116	C2CD4A	3941	62356675	62361675
NM_001136263	chr19	-	405442	409170	C2CD4C	3728	406670	411670
NM_001136003	chr1	-	151810338	151813033	C2CD4D	2695	151810533	151815533
NM_014802	chr12	-	22601479	22697480	C2CD5	96001	22694980	22699980
NM_001168216	chr2	-	202352143	202483905	C2CD6	131762	202481405	202486405
NM_144706	chr2	+	99758075	99767928	C2orf15	9853	99755575	99760575
NM_032266	chr2	+	27799388	27805589	C2orf16	6201	27796888	27801888
NM_013310	chr2	+	132480063	132524977	C2orf27A	44914	132477563	132482563
NM_214461	chr2	-	132552533	132559234	C2orf27B	6701	132556734	132561734
NM_032411	chr2	+	106682112	106694609	C2orf40	12497	106679612	106684612
NM_017880	chr2	-	70377011	70418203	C2orf42	41192	70415703	70420703
NM_182626	chr2	+	10281508	10351856	C2orf48	70348	10279008	10284008
NM_001286537	chr2	+	105953815	105965271	C2orf49	11456	105951315	105956315
NM_182500	chr2	+	11273178	11286916	C2orf50	13738	11270678	11275678
NM_001085437	chr2	-	241825464	241835573	C2orf54	10109	241833073	241838073
NM_213608	chr2	-	197669138	197675000	C2orf66	5862	197672500	197677500
NM_001013649	chr2	-	85832375	85839179	C2orf68	6804	85836679	85841679
NM_153689	chr2	+	200775978	200792996	C2orf69	17018	200773478	200778478
NM_001105519	chr2	+	26785426	26802400	C2orf70	16974	26782926	26787926
NM_001029883	chr2	-	29284555	29297127	C2orf71	12572	29294627	29299627
NM_001144994	chr2	+	231902280	231914427	C2orf72	12147	231899780	231904780
NM_001100396	chr2	+	54558070	54588714	C2orf73	30644	54555570	54560570
NM_001316317	chr2	+	61372202	61391964	C2orf74	19762	61369702	61374702
NM_001322332	chr2	-	120059792	120124404	C2orf76	64612	120121904	120126904
NM_001080474	chr2	+	74011315	74044274	C2orf78	32959	74008815	74013815
NM_001099334	chr2	-	209030070	209054773	C2orf80	24703	209052273	209057273
NM_001316765	chr2	-	74641302	74648757	C2orf81	7455	74646257	74651257
NM_001346122	chr2	+	233733723	233743414	C2orf82	9691	233731223	233736223
NM_001162483	chr2	-	228474805	228498036	C2orf83	23231	228495536	228500536
NM_001042521	chr2	+	191002485	191068210	C2orf88	65725	190999985	191004985
NM_001242815	chr2	-	42162507	42180943	C2orf91	18436	42178443	42183443
NM_000064	chr19	-	6677845	6720693	C3	42848	6718193	6723193
NM_004054	chr12	-	8209439	8219067	C3AR1	9628	8216567	8221567
NR_027300	chr19	+	10152031	10184813	C3P1	32782	10149531	10154531
NM_001291941	chr3	+	62304647	62321888	C3orf14	17241	62302147	62307147
NM_001171741	chr3	-	50595455	50608458	C3orf18	13003	50605958	50610958
NM_001184957	chr3	+	14716605	14814543	C3orf20	97938	14714105	14719105
NR_130715	chr3	-	126245841	126277808	C3orf22	31967	126275308	126280308
NM_152539	chr3	+	118864996	118870302	C3orf30	5306	118862496	118867496
NM_173657	chr3	-	155480400	155524076	C3orf33	43676	155521576	155526576
NR_126513	chr3	+	37440967	37476988	C3orf35	36021	37438467	37443467
NM_173824	chr3	+	88198892	88207115	C3orf38	8223	88196392	88201392
NR_026866	chr3	+	63805040	63834312	C3orf49	29272	63802540	63807540
NM_001171747	chr3	+	111805181	111837073	C3orf52	31892	111802681	111807681
NM_001007534	chr3	+	126911973	126917027	C3orf56	5054	126909473	126914473
NM_173552	chr3	+	143690639	143711210	C3orf58	20571	143688139	143693139
NM_198562	chr3	-	49306029	49314508	C3orf62	8479	49312008	49317008
NM_001351530	chr3	-	58727732	59035758	C3orf67	308026	59033258	59038258
NR_110820	chr3	+	58810196	59004819	C3orf67-AS1	194623	58807696	58812696
NM_001025266	chr3	-	184794625	184870836	C3orf70	76211	184868336	184873336
NM_001101337	chr3	+	153202283	153220486	C3orf79	18203	153199783	153204783
NM_001168214	chr3	+	159943422	159946000	C3orf80	2578	159940922	159945922
NM_001080528	chr3	-	49215068	49229291	C3orf84	14223	49226791	49231791
NM_001351622	chr3	+	108855560	108868951	C3orf85	13391	108853060	108858060
NM_001252204	chr6_dbb_hap3	+	3235414	3256039	C4A	20625	3232914	3237914
NM_001002029	chr6_dbb_hap3	+	3235414	3256040	C4B	20626	3232914	3237914
NM_000715	chr1	+	207277606	207318317	C4BPA	40711	207275106	207280106
NM_001017366	chr1	+	207262186	207273337	C4BPB	11151	207259686	207264686
NM_001242823	chr6_dbb_hap3	+	3235414	3256040	C4B_2	20626	3232914	3237914
NM_032149	chr4	+	100432160	100463460	C4orf17	31300	100429660	100434660
NM_001104629	chr4	+	37455551	37595132	C4orf19	139581	37453051	37458051
NM_152770	chr4	+	81256873	81884910	C4orf22	628037	81254373	81259373
NM_001257072	chr4	+	76481257	76491103	C4orf26	9846	76478757	76483757
NM_001170330	chr4	-	120217573	120225600	C4orf3	8027	120223100	120228100
NM_152400	chr4	+	113066552	113110237	C4orf32	43685	113064052	113069052
NM_173487	chr4	+	130014828	130033843	C4orf33	19015	130012328	130017328
NM_144645	chr4	-	87797357	87813575	C4orf36	16218	87811075	87816075
NM_152543	chr4	-	159814683	159956333	C4orf45	141650	159953833	159958833
NR_077234	chr4	-	159587826	159593407	C4orf46	5581	159590907	159595907
NM_001114357	chr4	+	186350487	186370982	C4orf47	20495	186347987	186352987
NM_001080531	chr4	+	146601355	146653948	C4orf51	52593	146598855	146603855
NM_001317163	chr9	-	123714613	123837452	C5	122839	123834952	123839952
NM_001736	chr19	+	47813103	47825327	C5AR1	12224	47810603	47815603
NM_001271749	chr19	+	47835403	47845272	C5AR2	9869	47832903	47837903
NM_020199	chr5	-	133291197	133304406	C5orf15	13209	133301906	133306906
NR_131245	chr5	+	23951456	24178374	C5orf17	226918	23948956	23953956
NR_134298	chr5	+	31532372	31555165	C5orf22	22793	31529872	31534872
NM_152409	chr5	+	134181369	134195425	C5orf24	14056	134178869	134183869
NM_033211	chr5	+	102594402	102614361	C5orf30	19959	102591902	102596902
NM_198566	chr5	-	43486802	43515273	C5orf34	28471	43512773	43517773
NM_001294337	chr5	+	2752244	2755511	C5orf38	3267	2749744	2754744
NM_023073	chr5	-	37106329	37249530	C5orf42	143201	37247030	37252030
NM_206966	chr5	-	147272270	147286101	C5orf46	13831	147283601	147288601
NM_001144954	chr5	+	173416161	173433143	C5orf47	16982	173413661	173418661
NM_001089584	chr5	-	7830490	7851603	C5orf49	21113	7849103	7854103
NM_175921	chr5	+	41904445	41921738	C5orf51	17293	41901945	41906945
NM_001145132	chr5	+	157098560	157107162	C5orf52	8602	157096060	157101060
NR_045116	chr5	+	131746464	131811736	C5orf56	65272	131743964	131748964
NR_131092	chr5	+	169659920	169679572	C5orf58	19652	169657420	169662420
NM_001305388	chr5	-	179068544	179072047	C5orf60	3503	179069547	179074547
NM_001164479	chr5	-	126378249	126409184	C5orf63	30935	126406684	126411684
NR_126525	chr5	+	60933607	61026824	C5orf64	93217	60931107	60936107
NR_105000	chr5	-	61028616	61031525	C5orf64-AS1	2909	61029025	61034025
NM_001277348	chr5	+	134368969	134680370	C5orf66	311401	134366469	134371469
NR_037895	chr5	-	134571923	134583867	C5orf66-AS2	11944	134581367	134586367
NM_001287053	chr5	-	55807220	55902059	C5orf67	94839	55899559	55904559
NM_001115131	chr5	-	41142247	41261540	C6	119293	41259040	41264040
NM_001286475	chr6_mann_hap4	-	3603310	3682528	C6orf10	79218	3680028	3685028
NM_024294	chr6	-	34555056	34664627	C6orf106	109571	34662127	34667127
NM_144980	chr6	-	165693152	165723111	C6orf118	29959	165720611	165725611
NM_001029863	chr6	+	170102207	170106453	C6orf120	4246	170099707	170104707
NM_001164446	chr6	-	42068856	42110715	C6orf132	41859	42108215	42113215
NM_145029	chr6	+	30614815	30620987	C6orf136	6172	30612315	30617315
NR_146854	chr6	+	49518112	49529625	C6orf141	11513	49515612	49520612
NM_001010868	chr6	+	88054570	88075181	C6orf163	20611	88052070	88057070
NM_001277339	chr6	+	109557816	109591717	C6orf183	33901	109555316	109560316
NR_104463	chr6	+	4079439	4130999	C6orf201	51560	4076939	4081939
NM_001142470	chr6	+	107349375	107372790	C6orf203	23415	107346875	107351875
NM_001010903	chr6	-	36283534	36304662	C6orf222	21128	36302162	36307162
NM_001171992	chr6	+	43968336	43975352	C6orf223	7016	43965836	43970836
NM_001287485	chr6	+	31802691	31807543	C6orf48	4852	31800191	31805191
NR_026736	chr6	-	10671650	10695030	C6orf52	23380	10692530	10697530
NM_001010905	chr6	+	127898318	127912963	C6orf58	14645	127895818	127900818
NM_030939	chr6	-	24705089	24719403	C6orf62	14314	24716903	24721903
NM_001286636	chr6	+	36839645	36896740	C6orf89	57095	36837145	36842145
NM_001302840	chr6	+	159290898	159331385	C6orf99	40487	159288398	159293398
NM_000587	chr5	+	40909353	40984742	C7	75389	40906853	40911853
NM_024054	chr7	-	42948871	42951689	C7orf25	2818	42949189	42954189
NM_024067	chr7	+	6629651	6648357	C7orf26	18706	6627151	6632151
NM_138811	chr7	-	25174315	25219817	C7orf31	45502	25217317	25222317
NM_145304	chr7	+	148287656	148312952	C7orf33	25296	148285156	148290156
NM_001303470	chr7	-	99752042	99756344	C7orf43	4302	99753844	99758844
NM_001305630	chr7	-	134777060	134855578	C7orf49	78518	134853078	134858078
NM_001318252	chr7	-	1036621	1177893	C7orf50	141272	1175393	1180393
NM_001244584	chr7	+	139025877	139108203	C7orf55-LUC7L2	82326	139023377	139028377
NM_001267865	chr7	+	48075107	48100894	C7orf57	25787	48072607	48077607
NM_001004323	chr7	-	100054237	100061894	C7orf61	7657	100059394	100064394
NM_001123065	chr7	+	47694841	47701246	C7orf65	6405	47692341	47697341
NM_001302627	chr7	+	47834888	47859444	C7orf69	24556	47832388	47837388
NM_001145531	chr7	+	26677489	26686889	C7orf71	9400	26674989	26679989
NM_001161834	chr7	+	50135681	50198852	C7orf72	63171	50133181	50138181
NM_001130929	chr7	+	135347220	135361160	C7orf73	13940	135344720	135349720
NM_001024603	chr7	-	124417345	124430864	C7orf77	13519	124428364	124433364
NM_000562	chr1	+	57320442	57383894	C8A	63452	57317942	57322942
NM_000066	chr1	-	57394882	57431813	C8B	36931	57429313	57434313
NM_001256596	chr8	+	49966894	49988642	C8orf22	21748	49964394	49969394
NM_173687	chr8	+	144120625	144135720	C8orf31	15095	144118125	144123125
NM_023080	chr8	+	146277823	146281416	C8orf33	3593	146275323	146280323
NM_052958	chr8	+	69242607	69731258	C8orf34	488651	69240107	69245107
NR_038877	chr8	-	69215702	69243726	C8orf34-AS1	28024	69241226	69246226
NM_177965	chr8	-	96257140	96281462	C8orf37	24322	96278962	96283962
NR_038205	chr8	+	96281063	96822371	C8orf37-AS1	541308	96278563	96283563
NM_019607	chr8	+	67579786	67593377	C8orf44	13591	67577286	67582286
NM_001204173	chr8	+	67579786	67774257	C8orf44-SGK3	194471	67577286	67582286
NM_152765	chr8	+	67405490	67430759	C8orf46	25269	67402990	67407990
NM_001198827	chr8	+	22457113	22461662	C8orf58	4549	22454613	22459613
NM_001293320	chr8	-	86126287	86132651	C8orf59	6364	86130151	86135151
NM_001040032	chr8	+	10530146	10558103	C8orf74	27957	10527646	10532646
NM_032847	chr8	-	124232195	124253638	C8orf76	21443	124251138	124256138
NM_001001795	chr8	-	145751602	145754458	C8orf82	2856	145751958	145756958
NM_001303531	chr8	-	38368351	38386180	C8orf86	17829	38383680	38388680
NM_001242668	chr8	-	94146323	94179079	C8orf87	32756	94176579	94181579
NM_001190972	chr8	-	91970705	91997485	C8orf88	26780	91994985	91999985
NM_001243237	chr8	-	74153658	74171737	C8orf89	18079	74169237	74174237
NM_001737	chr5	-	39284246	39364662	C9	80416	39362162	39367162
NM_001048265	chr9	-	138387025	138391761	C9orf116	4736	138389261	138394261
NM_001098808	chr9	-	96080480	96108696	C9orf129	28216	96106196	96111196
NM_001040412	chr9	+	35041091	35045988	C9orf131	4897	35038591	35043591
NM_001010940	chr9	+	72435720	72521151	C9orf135	85431	72433220	72438220
NM_207511	chr9	+	139921915	139931234	C9orf139	9319	139919415	139924415
NM_001350649	chr9	-	115214082	115249467	C9orf147	35385	115246967	115251967
NM_001012993	chr9	-	112961845	112970413	C9orf152	8568	112967913	112972913
NM_001276366	chr9	-	88835179	88874572	C9orf153	39393	88872072	88877072
NM_024112	chr9	+	130922538	130926207	C9orf16	3669	130920038	130925038
NM_152571	chr9	+	139377946	139380519	C9orf163	2573	139375446	139380446
NM_001001709	chr9	+	89763558	89774641	C9orf170	11083	89761058	89766058
NM_001080482	chr9	+	139738866	139741797	C9orf172	2931	139736366	139741366
NM_032596	chr9	-	34379016	34397849	C9orf24	18833	34395349	34400349
NM_032823	chr9	+	97488950	97849500	C9orf3	360550	97486450	97491450
NM_017998	chr9	-	77561498	77567802	C9orf40	6304	77565302	77570302
NR_121183	chr9	+	77567880	77612296	C9orf41-AS1	44416	77565380	77570380
NM_001278629	chr9	+	116172923	116191964	C9orf43	19041	116170423	116175423
NM_001142413	chr9	+	91605777	91611057	C9orf47	5280	91603277	91608277
NM_199350	chr9	-	132374503	132383055	C9orf50	8552	132380555	132385555
NM_001128618	chr9	-	74666296	74675521	C9orf57	9225	74673021	74678021
NM_173520	chr9	+	138235094	138238404	C9orf62	3310	138232594	138237594
NM_001317997	chr9	-	86553226	86571901	C9orf64	18675	86569401	86574401
NM_152569	chr9	-	213107	215893	C9orf66	2786	213393	218393
NM_001256054	chr9	-	27546543	27573864	C9orf72	27321	27571364	27576364
NM_016520	chr9	-	132589563	132597572	C9orf78	8009	132595072	132600072
NR_109816	chr9	-	114448798	114557288	C9orf84	108490	114554788	114559788
NM_182505	chr9	+	74526422	74588371	C9orf85	61949	74523922	74528922
NR_073471	chr9	-	16203932	16276311	C9orf92	72379	16273811	16278811
NM_001738	chr8	-	86240457	86290383	CA1	49926	86287883	86292883
NM_001082534	chr17	-	49707673	50237377	CA10	529704	50234877	50239877
NM_001217	chr19	-	49141198	49149569	CA11	8371	49147069	49152069
NR_135511	chr15	-	63613576	63674365	CA12	60789	63671865	63676865
NM_198584	chr8	+	86157715	86196302	CA13	38587	86155215	86160215
NM_012113	chr1	+	150230137	150237480	CA14	7343	150227637	150232637
NM_001293675	chr8	+	86376130	86393721	CA2	17591	86373630	86378630
NM_005181	chr8	+	86351055	86361267	CA3	10212	86348555	86353555
NR_121630	chr8	-	86354036	86377144	CA3-AS1	23108	86374644	86379644
NR_137422	chr17	+	58227296	58256382	CA4	29086	58224796	58229796
NM_001739	chr16	-	87921624	87970112	CA5A	48488	87967612	87972612
NM_007220	chrX	+	15756411	15805748	CA5B	49337	15753911	15758911
NR_026551	chrX	+	15693038	15721474	CA5BP1	28436	15690538	15695538
NM_001215	chr1	+	9005892	9035148	CA6	29256	9003392	9008392
NM_005182	chr16	+	66878281	66888049	CA7	9768	66875781	66880781
NM_004056	chr8	-	61097978	61193982	CA8	96004	61191482	61196482
NM_001216	chr9	+	35673914	35681154	CA9	7240	35671414	35676414
NM_024828	chr9	-	26840682	26892826	CAAP1	52144	26890326	26895326
NM_016289	chr2	+	231577556	231685790	CAB39	108234	231575056	231580056
NM_001287337	chr13	-	49882785	50018262	CAB39L	135477	50015762	50020762
NM_001201429	chr22	+	24407764	24574596	CABIN1	166832	24405264	24410264
NM_001256438	chr18	+	20714527	20840434	CABLES1	125907	20712027	20717027
NM_031215	chr20	-	60963685	60982339	CABLES2	18654	60979839	60984839
NM_001033677	chr12	+	121078421	121105127	CABP1	26706	121075921	121080921
NM_001318496	chr11	-	67286417	67290899	CABP2	4482	67288399	67293399
NM_001300896	chr11	+	67219885	67229246	CABP4	9361	67217385	67222385
NM_019855	chr19	-	48532639	48547311	CABP5	14672	48544811	48549811
NM_182527	chr22	+	30116343	30127820	CABP7	11477	30113843	30118843
NM_153768	chr18	+	21718919	21741564	CABYR	22645	21716419	21721419
NM_017586	chr9	+	136325086	136335909	CACFD1	10823	136322586	136327586
NM_020925	chr1	+	64936475	65158741	CACHD1	222266	64933975	64938975
NM_001127221	chr19	-	13317255	13617274	CACNA1A	300019	13614774	13619774
NM_001243812	chr9	+	140772240	141019076	CACNA1B	246836	140769740	140774740
NM_001129840	chr12	+	2162415	2807115	CACNA1C	644700	2159915	2164915
NR_045725	chr12	-	2785166	2800323	CACNA1C-AS1	15157	2797823	2802823
NR_046579	chr12	-	2777665	2781386	CACNA1C-AS2	3721	2778886	2783886
NR_046578	chr12	-	2329702	2332647	CACNA1C-AS4	2945	2330147	2335147
NR_046769	chr12	+	2378941	2397911	CACNA1C-IT3	18970	2376441	2381441
NM_001128839	chr3	+	53529075	53846492	CACNA1D	317417	53526575	53531575
NM_001205293	chr1	+	181452685	181775921	CACNA1E	323236	181450185	181455185
NM_001256790	chrX	-	49061522	49089833	CACNA1F	28311	49087333	49092333
NM_001256359	chr17	+	48638428	48704832	CACNA1G	66404	48635928	48640928
NR_038439	chr17	-	48633567	48639469	CACNA1G-AS1	5902	48636969	48641969
NM_021098	chr16	+	1203240	1271772	CACNA1H	68532	1200740	1205740
NM_021096	chr22	+	39966757	40085740	CACNA1I	118983	39964257	39969257
NM_000069	chr1	-	201008639	201081694	CACNA1S	73055	201079194	201084194
NM_000722	chr7	-	81575759	82073122	CACNA2D1	497363	82070622	82075622
NM_001291101	chr3	-	50400043	50541675	CACNA2D2	141632	50539175	50544175
NM_018398	chr3	+	54156692	55108584	CACNA2D3	951892	54154192	54159192
NR_046666	chr3	-	54908631	54935282	CACNA2D3-AS1	26651	54932782	54937782
NM_172364	chr12	-	1901122	2027870	CACNA2D4	126748	2025370	2030370
NM_000723	chr17	-	37329708	37353956	CACNB1	24248	37351456	37356456
NM_201597	chr10	+	18429605	18830688	CACNB2	401083	18427105	18432105
NM_001206917	chr12	+	49208214	49222726	CACNB3	14512	49205714	49210714
NM_000726	chr2	-	152689285	152955681	CACNB4	266396	152953181	152958181
NM_000727	chr17	+	65040651	65052911	CACNG1	12260	65038151	65043151
NM_006078	chr22	-	36956915	37098903	CACNG2	141988	37096403	37101403
NM_006539	chr16	+	24266873	24373737	CACNG3	106864	24264373	24269373
NM_014405	chr17	+	64960979	65029518	CACNG4	68539	64958479	64963479
NM_145811	chr17	+	64873390	64881395	CACNG5	8005	64870890	64875890
NR_102308	chr19	+	54494402	54515920	CACNG6	21518	54491902	54496902
NM_031896	chr19	+	54415990	54446969	CACNG7	30979	54413490	54418490
NM_031895	chr19	+	54466289	54493469	CACNG8	27180	54463789	54468789
NM_001080543	chr19	-	3610626	3626813	CACTIN	16187	3624313	3629313
NR_038865	chr19	+	3607244	3613928	CACTIN-AS1	6684	3604744	3609744
NM_153810	chr10	-	120440493	120514758	CACUL1	74265	120512258	120517258
NM_001007214	chr1	+	174968570	174981163	CACYBP	12593	174966070	174971070
NM_001306079	chr2	+	27440257	27466660	CAD	26403	27437757	27442757
NM_001301044	chr11	-	115044344	115375241	CADM1	330897	115372741	115377741
NM_001167675	chr3	+	85008132	86123579	CADM2	1115447	85005632	85010632
NR_046752	chr3	-	85849136	85877200	CADM2-AS2	28064	85874700	85879700
NM_021189	chr1	+	159141353	159173103	CADM3	31750	159138853	159143853
NR_037870	chr1	-	159165774	159172212	CADM3-AS1	6438	159169712	159174712
NM_145296	chr19	-	44126521	44143991	CADM4	17470	44141491	44146491
NM_183393	chr3	-	62384020	62861064	CADPS	477044	62858564	62863564
NM_001167940	chr7	-	121958477	122526813	CADPS2	568336	122524313	122529313
NM_001170692	chr6	-	7326886	7389942	CAGE1	63056	7387442	7392442
NM_004929	chr8	-	91070835	91095109	CALB1	24274	91092609	91097609
NM_001740	chr16	+	71392615	71424342	CALB2	31727	71390115	71395115
NR_125898	chr11	-	14988214	14993832	CALCA	5618	14991332	14996332
NM_000728	chr11	+	15095145	15100177	CALCB	5032	15092645	15097645
NR_026554	chr12	-	54104901	54121307	CALCOCO1	16406	54118807	54123807
NM_005831	chr17	+	46908349	46942607	CALCOCO2	34258	46905849	46910849
NM_001164737	chr7	-	93053798	93204042	CALCR	150244	93201542	93206542
NM_005795	chr2	-	188206689	188313021	CALCRL	106332	188310521	188315521
NM_004342	chr7	+	134464163	134655480	CALD1	191317	134461663	134466663
NM_001001412	chr10	-	105213143	105218648	CALHM1	5505	105216148	105221148
NM_015916	chr10	-	105206542	105212162	CALHM2	5620	105209662	105214662
NM_001129742	chr10	-	105232560	105238997	CALHM3	6437	105236497	105241497
NM_006888	chr14	+	90863326	90874619	CALM1	11293	90860826	90865826
NM_001305625	chr2	-	47387220	47404075	CALM2	16855	47401575	47406575
NM_001329921	chr19	+	47104330	47114039	CALM3	9709	47101830	47106830
NR_120496	chr10	-	5556206	5568209	CALML3-AS1	12003	5565709	5570709
NM_033429	chr15	-	68483042	68498448	CALML4	15406	68495948	68500948
NM_031468	chr7	-	71244475	71877360	CALN1	632885	71874860	71879860
NM_004343	chr19	+	13049413	13055304	CALR	5891	13046913	13051913
NM_145046	chr19	-	16589867	16607003	CALR3	17136	16604503	16609503
NM_001219	chr7	+	128379345	128413477	CALU	34132	128376845	128381845
NM_001321617	chr10	-	135138926	135150487	CALY	11561	135147987	135152987
NM_003656	chr3	-	9799028	9811668	CAMK1	12640	9809168	9814168
NM_153498	chr10	+	12391541	12877545	CAMK1D	486004	12389041	12394041
NM_020439	chr1	+	209757044	209787284	CAMK1G	30240	209754544	209759544
NM_171825	chr5	-	149599053	149669403	CAMK2A	70350	149666903	149671903
NM_172083	chr7	-	44256748	44365230	CAMK2B	108482	44362730	44367730
NM_001321590	chr4	-	114372187	114683083	CAMK2D	310896	114680583	114685583
NM_172169	chr10	-	75572258	75634349	CAMK2G	62091	75631849	75636849
NM_018584	chr1	-	20808883	20812728	CAMK2N1	3845	20810228	20815228
NM_001323375	chr5	+	110559350	110830582	CAMK4	271232	110556850	110561850
NM_032294	chr17	-	3763616	3796337	CAMKK1	32721	3793837	3798837
NM_153500	chr12	-	121675494	121736111	CAMKK2	60617	121733611	121738611
NM_024766	chr2	+	44589042	44999731	CAMKMT	410689	44586542	44591542
NM_001320147	chr3	-	49895413	49907655	CAMKV	12242	49905155	49910155
NM_001745	chr5	+	134074169	134087850	CAMLG	13681	134071669	134076669
NM_015447	chr9	-	138700332	138799005	CAMSAP1	98673	138796505	138801505
NM_001297707	chr1	+	200708685	200829835	CAMSAP2	121150	200706185	200711185
NM_020902	chr19	+	7660787	7683196	CAMSAP3	22409	7658287	7663287
NM_015215	chr1	+	6845383	7829766	CAMTA1	984383	6842883	6847883
NM_015099	chr17	-	4871286	4890960	CAMTA2	19674	4888460	4893460
NM_018448	chr12	+	67663060	67708472	CAND1	45412	67660560	67665560
NR_103765	chr11	+	10329859	10452220	CAND1.11	122361	10327359	10332359
NM_012298	chr3	+	12838170	12876313	CAND2	38143	12835670	12840670
NM_001159772	chr17	-	76987797	77005899	CANT1	18102	77003399	77008399
NM_001746	chr5	+	179125929	179158639	CANX	32710	179123429	179128429
NM_001350479	chr1	+	40505736	40538321	CAP1	32585	40503236	40508236
NM_006366	chr6	+	17393735	17558023	CAP2	164288	17391235	17396235
NM_001256139	chr2	-	85621870	85641197	CAPG	19327	85638697	85643697
NM_001198868	chr11	+	64948685	64979477	CAPN1	30792	64946185	64951185
NM_023083	chr2	+	241526132	241538526	CAPN10	12394	241523632	241528632
NR_103792	chr2	-	241522166	241525733	CAPN10-AS1	3567	241523233	241528233
NM_007058	chr6	+	44126547	44152139	CAPN11	25592	44124047	44129047
NM_144691	chr19	-	39220831	39235114	CAPN12	14283	39232614	39237614
NM_144575	chr2	-	30945637	31030311	CAPN13	84674	31027811	31032811
NM_001321270	chr2	-	31395921	31456823	CAPN14	60902	31454323	31459323
NM_005632	chr16	+	577855	604636	CAPN15	26781	575355	580355
NM_001146068	chr1	+	223889294	223963720	CAPN2	74426	223886794	223891794
NM_000070	chr15	+	42651697	42704515	CAPN3	52818	42649197	42654197
NM_004055	chr11	+	76777991	76837198	CAPN5	59207	76775491	76780491
NM_014289	chrX	-	110488326	110513774	CAPN6	25448	110511274	110516274
NM_014296	chr3	+	15247732	15294423	CAPN7	46691	15245232	15250232
NM_001143962	chr1	-	223714971	223853436	CAPN8	138465	223850936	223855936
NM_016452	chr1	+	230883129	230937518	CAPN9	54389	230880629	230885629
NM_001749	chr19	+	36630827	36641255	CAPNS1	10428	36628327	36633327
NM_005898	chr11	+	34073229	34124157	CAPRIN1	50928	34070729	34075729
NM_001319846	chr12	-	30862485	30907884	CAPRIN2	45399	30905384	30910384
NM_004058	chr19	+	5913654	5916222	CAPS	2568	5911154	5916154
NM_001286548	chr12	-	75670999	75784702	CAPS2	113703	75782202	75787202
NM_144647	chr5	-	35904397	35938881	CAPSL	34484	35936381	35941381
NM_006135	chr1	+	113162074	113214241	CAPZA1	52167	113159574	113164574
NM_006136	chr7	+	116502562	116559313	CAPZA2	56751	116500062	116505062
NM_004930	chr1	-	19665266	19812135	CAPZB	146869	19809635	19814635
NM_014550	chr22	-	37886399	37915210	CARD10	28811	37912710	37917710
NM_032415	chr7	-	2945709	3083579	CARD11	137870	3081079	3086079
NR_047566	chr17	+	78143790	78183130	CARD14	39340	78141290	78146290
NM_052889	chr11	-	104912052	104916051	CARD16	3999	104913551	104918551
NM_001007232	chr11	-	104963195	104972158	CARD17	8963	104969658	104974658
NR_134467	chr9	+	95858404	95875577	CARD19	17173	95855904	95860904
NM_032587	chr5	+	40841409	40855456	CARD6	14047	40838909	40843909
NM_001351787	chr19	-	48706404	48759203	CARD8	52799	48756703	48761703
NR_040599	chr19	+	48758931	48761450	CARD8-AS1	2519	48756431	48761431
NM_052814	chr9	-	139258407	139268133	CARD9	9726	139265633	139270633
NM_001104586	chr2	+	203776940	203852984	CARF	76044	203774440	203779440
NM_014316	chr16	-	8946798	8962869	CARHSP1	16071	8960369	8965369
NM_199141	chr19	+	10982252	11033448	CARM1	51196	10979752	10984752
NM_001173977	chr6	+	25279655	25620758	CARMIL1	341103	25277155	25282155
NM_001013838	chr16	+	67678842	67691472	CARMIL2	12630	67676342	67681342
NM_138360	chr14	+	24521205	24538937	CARMIL3	17732	24518705	24523705
NR_105060	chr5	+	148786407	148812399	CARMN	25992	148783907	148788907
NM_152420	chr9	-	77595709	77643346	CARNMT1	47637	77640846	77645846
NM_020811	chr11	+	67183148	67193078	CARNS1	9930	67180648	67185648
NM_001194997	chr11	-	3022151	3078681	CARS	56530	3076181	3081181
NR_046580	chr11	+	3050623	3062490	CARS-AS1	11867	3048123	3053123
NM_001352252	chr13	-	111293756	111358862	CARS2	65106	111356362	111361362
NM_001204101	chr12	-	25261222	25348096	CASC1	86874	25345596	25350596
NM_001010911	chr10	-	21783420	21786213	CASC10	2793	21783713	21788713
NR_117102	chr8	-	128712852	128746213	CASC11	33361	128743713	128748713
NR_015410	chr6	+	21666674	22194616	CASC15	527942	21664174	21669174
NR_033920	chr16	-	52585998	52640887	CASC16	54889	52638387	52643387
NR_104152	chr17	-	69093914	69198320	CASC17	104406	69195820	69200820
NR_110108	chr12	+	106097980	106137841	CASC18	39861	106095480	106100480
NR_120364	chr8	-	128200030	128209872	CASC19	9842	128207372	128212372
NR_026939	chr10	+	119806331	119969665	CASC2	163334	119803831	119808831
NR_109953	chr20	+	6407378	6509106	CASC20	101728	6404878	6409878
NR_117099	chr8	+	128256881	128404876	CASC21	147995	128254381	128259381
NR_135281	chr16	+	52292475	52314211	CASC22	21736	52289975	52294975
NR_125366	chr11	-	8032824	8038056	CASC23	5232	8035556	8040556
NM_007359	chr17	+	38296506	38328431	CASC3	31925	38294006	38299006
NM_138423	chr15	+	44580908	44707959	CASC4	127051	44578408	44583408
NR_104154	chr6	-	92338757	92400146	CASC6	61389	92397646	92402646
NR_117100	chr8	-	128301920	128494384	CASC8	192464	128491884	128496884
NR_103849	chr8	-	76135351	76191124	CASC9	55773	76188624	76193624
NM_022900	chr7	+	94139169	94186328	CASD1	47159	94136669	94141669
NM_003688	chrX	-	41374188	41782287	CASK	408099	41779787	41784787
NM_020764	chr16	-	2227183	2246465	CASKIN1	19282	2243965	2248965
NM_020753	chr17	-	73496340	73511664	CASKIN2	15324	73509164	73514164
NM_001257118	chr11	-	104896236	104905884	CASP1	9648	104903384	104908384
NM_001206542	chr2	+	202047620	202094129	CASP10	46509	202045120	202050120
NR_034067	chr11	-	104756444	104769397	CASP12	12953	104766897	104771897
NM_012114	chr19	+	15160290	15169103	CASP14	8813	15157790	15162790
NR_132322	chr16	+	3194291	3199947	CASP16P	5656	3191791	3196791
NR_131905	chr11	-	104933328	104942257	CASP1P2	8929	104939757	104944757
NM_032983	chr7	+	142985307	143004789	CASP2	19482	142982807	142987807
NM_032991	chr4	-	185548849	185570629	CASP3	21780	185568129	185573129
NM_001225	chr11	-	104813593	104839325	CASP4	25732	104836825	104841825
NM_001136112	chr11	-	104864966	104893895	CASP5	28929	104891395	104896395
NR_133012	chr4	-	110609784	110624629	CASP6	14845	110622129	110627129
NM_033340	chr10	+	115438920	115490668	CASP7	51748	115436420	115441420
NM_001228	chr2	+	202098165	202152434	CASP8	54269	202095665	202100665
NM_012115	chr6	+	90539618	90584155	CASP8AP2	44537	90537118	90542118
NM_032996	chr1	-	15817895	15851285	CASP9	33390	15848785	15853785
NM_001231	chr1	+	160160284	160171676	CASQ1	11392	160157784	160162784
NM_001232	chr1	-	116242625	116311426	CASQ2	68801	116308926	116313926
NM_000388	chr3	+	121902529	122005344	CASR	102815	121900029	121905029
NM_001164116	chr20	+	54987167	55034396	CASS4	47229	54984667	54989667
NM_001190442	chr5	+	95997740	96110385	CAST	112645	95995240	96000240
NM_001037666	chr22	-	30681106	30685616	CASTOR1	4510	30683116	30688116
NM_001145064	chr7	-	74800771	74867509	CASTOR2	66738	74865009	74870009
NM_001079843	chr1	-	10696665	10856733	CASZ1	160068	10854233	10859233
NM_001752	chr11	+	34460471	34493607	CAT	33136	34457971	34462971
NM_001320865	chr2	+	219221578	219232817	CATIP	11239	219219078	219224078
NR_125777	chr2	-	219190963	219222689	CATIP-AS2	31726	219220189	219225189
NM_053054	chr11	-	65784222	65793988	CATSPER1	9766	65791488	65796488
NM_172095	chr15	-	43922759	43941082	CATSPER2	18323	43938582	43943582
NR_002318	chr15	-	44028145	44038496	CATSPER2P1	10351	44035996	44040996
NM_178019	chr5	+	134303595	134347397	CATSPER3	43802	134301095	134306095
NM_198137	chr1	+	26517118	26529033	CATSPER4	11915	26514618	26519618
NM_024764	chr14	-	92047117	92198430	CATSPERB	151313	92195930	92200930
NM_152784	chr19	+	5720687	5778742	CATSPERD	58055	5718187	5723187
NM_001130957	chr1	+	244624672	244803662	CATSPERE	178990	244622172	244627172
NM_001330496	chr19	+	38826426	38861589	CATSPERG	35163	38823926	38828926
NM_001039496	chr11	+	64067862	64072239	CATSPERZ	4377	64065362	64070362
NM_001753	chr7	+	116164838	116201239	CAV1	36401	116162338	116167338
NM_001233	chr7	+	116139654	116148595	CAV2	8941	116137154	116142154
NM_033337	chr3	+	8775485	8788451	CAV3	12966	8772985	8777985
NM_012232	chr17	-	40554466	40575338	CAVIN1	20872	40572838	40577838
NM_004657	chr2	-	192699031	192712006	CAVIN2	12975	192709506	192714506
NM_001018116	chr9	+	103340360	103350669	CAVIN4	10309	103337860	103342860
NM_152769	chr19	-	1229946	1237990	CBARP	8044	1235490	1240490
NM_001032999	chr20	+	32077927	32237837	CBFA2T2	159910	32075427	32080427
NM_005187	chr16	-	88941262	89043504	CBFA2T3	102242	89041004	89046004
NM_022845	chr16	+	67063049	67134958	CBFB	71909	67060549	67065549
NM_005188	chr11	+	119076985	119178859	CBL	101874	119074485	119079485
NR_135810	chr3	-	105374304	105588266	CBLB	213962	105585766	105590766
NM_001130852	chr19	+	45281125	45303903	CBLC	22778	45278625	45283625
NM_024814	chr7	+	107384141	107402112	CBLL1	17971	107381641	107386641
NM_004352	chr16	-	49311828	49315742	CBLN1	3914	49313242	49318242
NM_182511	chr18	-	70203914	70211723	CBLN2	7809	70209223	70214223
NM_001039771	chr14	-	24895739	24898731	CBLN3	2992	24896231	24901231
NM_080617	chr20	-	54572412	54580528	CBLN4	8116	54578028	54583028
NM_001286789	chr21	+	37442221	37445475	CBR1	3254	37439721	37444721
NM_001236	chr21	+	37507262	37518860	CBR3	11598	37504762	37509762
NR_038893	chr21	-	37504064	37528606	CBR3-AS1	24542	37526106	37531106
NM_032783	chr4	-	169908741	169931468	CBR4	22727	169928968	169933968
NM_001320298	chr21	-	44473300	44496971	CBS	23671	44494471	44499471
NM_001321073	chr21	-	44473300	44496502	CBSL	23202	44494002	44499002
NM_001145356	chr9	-	121037	179075	CBWD1	58038	176575	181575
NM_172003	chr2	+	114195267	114253781	CBWD2	58514	114192767	114197767
NM_001291821	chr9	+	70856860	70914951	CBWD3	58091	70854360	70859360
NM_001286835	chr9	-	70432003	70490211	CBWD5	58208	70487711	70492711
NM_001085457	chr9	-	69204537	69262593	CBWD6	58056	69260093	69265093
NM_001127228	chr17	-	46147413	46178883	CBX1	31470	46176383	46181383
NM_005189	chr17	+	77751976	77761449	CBX2	9473	77749476	77754476
NM_007276	chr7	+	26240830	26253227	CBX3	12397	26238330	26243330
NR_033754	chr18	-	2652168	2655394	CBX3P2	3226	2652894	2657894
NM_003655	chr17	-	77806954	77813213	CBX4	6259	77810713	77815713
NM_012117	chr12	-	54624730	54673915	CBX5	49185	54671415	54676415
NM_014292	chr22	-	39257431	39268339	CBX6	10908	39265839	39270839
NM_175709	chr22	-	39526778	39548655	CBX7	21877	39546155	39551155
NM_020649	chr17	-	77768175	77770915	CBX8	2740	77768415	77773415
NM_015373	chr22	+	39052657	39069855	CBY1	17198	39050157	39055157
NM_017721	chr19	+	14016955	14041693	CC2D1A	24738	14014455	14019455
NM_001330585	chr1	-	52816264	52831877	CC2D1B	15613	52829377	52834377
NM_001080522	chr4	+	15471488	15603180	CC2D2A	131692	15468988	15473988
NM_001349008	chr10	+	97667726	97793502	CC2D2B	125776	97665226	97670226
NM_001282960	chr10	+	70480900	70552134	CCAR1	71234	70478400	70483400
NR_033902	chr8	+	22462144	22477983	CCAR2	15839	22459644	22464644
NR_108049	chr8	-	128219626	128231513	CCAT1	11887	128229013	128234013
NM_133459	chr18	-	57098170	57364644	CCBE1	266474	57362144	57367144
NM_033212	chr16	-	57546089	57570477	CCDC102A	24388	57567977	57572977
NM_001093729	chr18	+	66382490	66722426	CCDC102B	339936	66379990	66384990
NM_001258399	chr17	+	42977079	42981047	CCDC103	3968	42974579	42979579
NM_173482	chr19	+	15121538	15134083	CCDC105	12545	15119038	15124038
NM_013301	chr19	+	56158953	56164526	CCDC106	5573	56156453	56161453
NM_001195200	chr9	+	35658286	35661500	CCDC107	3214	35655786	35660786
NM_001145411	chr4	-	186366337	186392913	CCDC110	26576	186390413	186395413
NM_001040440	chr5	-	114602884	114632458	CCDC112	29574	114629958	114634958
NM_001142302	chr16	+	58283839	58317734	CCDC113	33895	58281339	58286339
NM_144577	chr19	-	48799708	48823332	CCDC114	23624	48820832	48825832
NR_104471	chr2	-	131095505	131100254	CCDC115	4749	131097754	131102754
NM_152612	chr22	+	21987085	21991616	CCDC116	4531	21984585	21989585
NM_001284263	chr22	+	29168661	29185289	CCDC117	16628	29166161	29171161
NM_144716	chr3	-	46963219	47023500	CCDC12	60281	47021e3	47026e3
NM_001271836	chrX	+	48910960	48927510	CCDC120	16550	48908460	48913460
NM_024584	chr2	-	27848505	27851898	CCDC121	3393	27849398	27854398
NM_144974	chr13	-	44410488	44453872	CCDC122	43384	44451372	44456372
NM_001136203	chr19	+	18043823	18054794	CCDC124	10971	18041323	18046323
NM_001297696	chr5	-	68576518	68628620	CCDC125	52102	68626120	68631120
NM_138771	chr7	+	23636997	23684327	CCDC126	47330	23634497	23639497
NM_145265	chr5	-	204874	218297	CCDC127	13423	215797	220797
NM_001257967	chr7	+	31553684	31696116	CCDC129	142432	31551184	31556184
NM_144719	chr3	-	42749873	42814745	CCDC13	64872	42812245	42817245
NR_046732	chr3	+	42774066	42786650	CCDC13-AS1	12584	42771566	42776566
NM_001320561	chr19	+	13842573	13874112	CCDC130	31539	13840073	13845073
NM_024821	chr22	+	42196625	42222303	CCDC134	25678	42194125	42199125
NM_001201372	chr7	+	128431463	128462187	CCDC136	30724	128428963	128433963
NM_199287	chr17	+	79633760	79640936	CCDC137	7176	79631260	79636260
NM_001351557	chr2	+	109403205	109501933	CCDC138	98728	109400705	109405705
NM_001308317	chr3	-	123632273	123680255	CCDC14	47982	123677755	123682755
NM_153038	chr2	+	223162865	223169936	CCDC140	7071	223160365	223165365
NM_173648	chr2	-	179694483	179914786	CCDC141	220303	179912286	179917286
NM_032779	chr2	-	74699958	74710357	CCDC142	10399	74707857	74712857
NM_014695	chr17	+	16593638	16678313	CCDC144A	84675	16591138	16596138
NR_036647	chr17	-	18441114	18528930	CCDC144B	87816	18526430	18531430
NR_023380	chr17	+	20224486	20305504	CCDC144CP	81018	20221986	20226986
NM_001004306	chr17	-	20766707	20799453	CCDC144NL	32746	20796953	20801953
NR_104185	chr17	+	20771745	20808543	CCDC144NL-AS1	36798	20769245	20774245
NM_020879	chr7	+	76751933	76924521	CCDC146	172588	76749433	76754433
NM_001301684	chr2	-	159027868	159313265	CCDC148	285397	159310765	159315765
NR_038850	chr2	+	159023161	159092681	CCDC148-AS1	69520	159020661	159025661
NM_173463	chr4	-	24807738	24981826	CCDC149	174088	24979326	24984326
NM_025004	chr11	+	124824016	124911385	CCDC15	87369	124821516	124826516
NM_001080539	chr2	+	197504355	197597530	CCDC150	93175	197501855	197506855
NM_001302453	chr19	-	11531272	11546603	CCDC151	15331	11544103	11549103
NM_001134848	chr5	+	42756919	42802539	CCDC152	45620	42754419	42759419
NM_001145018	chr11	-	119060962	119066584	CCDC153	5622	119064084	119069084
NM_001143980	chr16	-	1484388	1494490	CCDC154	10102	1491990	1496990
NM_144688	chr19	+	49891474	49921256	CCDC155	29782	49888974	49893974
NM_001318334	chr22	+	30752623	30774644	CCDC157	22021	30750123	30755123
NM_001042784	chr4	-	77234191	77328458	CCDC158	94267	77325958	77330958
NM_001080503	chr19	+	11457180	11465620	CCDC159	8440	11454680	11459680
NM_001101357	chrX	+	133371076	133379808	CCDC160	8732	133368576	133373576
NR_028595	chr6	+	109615505	109629423	CCDC162P	13918	109613005	109618005
NR_033297	chr1	-	45959597	45965751	CCDC163	6154	45963251	45968251
NM_138493	chr6	-	37450696	37467700	CCDC167	17004	37465200	37470200
NM_001146197	chr13	-	103381716	103411422	CCDC168	29706	103408922	103413922
NM_001144983	chr13	-	36801178	36871992	CCDC169	70814	36869492	36874492
NM_001198910	chr13	-	36742344	36871992	CCDC169-SOHLH2	129648	36869492	36874492
NM_001114938	chr1	-	46085715	46089731	CCDC17	4016	46087231	46092231
NM_025059	chr6	+	151815174	151942328	CCDC170	127154	151812674	151817674
NM_173550	chr9	+	15553004	15974037	CCDC171	421033	15550504	15555504
NM_198515	chr10	+	118083939	118139541	CCDC172	55602	118081439	118086439
NM_001085447	chr2	-	170501934	170550931	CCDC173	48997	170548431	170553431
NR_135523	chr3	+	14693252	14714166	CCDC174	20914	14690752	14695752
NM_001164399	chr14	-	59971784	60043549	CCDC175	71765	60041049	60046049
NM_001271507	chr14	-	70036530	70041600	CCDC177	5070	70039100	70044100
NM_198995	chr18	-	30517365	31020685	CCDC178	503320	31018185	31023185
NM_001195637	chr11	-	22868467	22881972	CCDC179	13505	22879472	22884472
NM_001306076	chr1	+	93646272	93744287	CCDC18	98015	93643772	93648772
NR_034089	chr1	-	93775665	93811368	CCDC18-AS1	35703	93808868	93813868
NM_020893	chr9	+	100069909	100141033	CCDC180	71124	100067409	100072409
NM_001300968	chr1	-	169364107	169429907	CCDC181	65800	169427407	169432407
NM_001039374	chr9	+	139690789	139702193	CCDC183	11404	139688289	139693289
NR_024580	chr9	-	139698378	139703300	CCDC183-AS1	4922	139700800	139705800
NR_135815	chr10	-	115880620	115933979	CCDC186	53359	115931479	115936479
NM_001014979	chr16	-	30768743	30773565	CCDC189	4822	30771065	30776065
NM_178550	chr1	-	162824086	162838605	CCDC190	14519	162836105	162841105
NM_020817	chr3	-	113682983	113775460	CCDC191	92477	113772960	113777960
NM_001317938	chr5	+	127039080	127277208	CCDC192	238128	127036580	127041580
NR_024338	chr14	+	66953088	66965271	CCDC196	12183	66950588	66955588
NR_024183	chr14	+	94463641	94478041	CCDC197	14400	94461141	94466141
NM_014008	chrX	+	49091926	49106987	CCDC22	15061	49089426	49094426
NM_152499	chr1	+	44457267	44462198	CCDC24	4931	44454767	44459767
NM_001304532	chr8	-	27590832	27630170	CCDC25	39338	27627670	27632670
NR_130917	chr8	-	130363939	130692485	CCDC26	328546	130689985	130694985
NM_152492	chr1	+	3668964	3688209	CCDC27	19245	3666464	3671464
NM_015439	chr6	+	139094656	139114456	CCDC28A	19800	139092156	139097156
NM_024296	chr1	+	32665986	32670991	CCDC28B	5005	32663486	32668486
NM_001282658	chr10	-	12938624	13141773	CCDC3	203149	13139273	13144273
NM_001080850	chr1	+	43000559	43120335	CCDC30	119776	42998059	43003059
NM_001289132	chr15	-	40823539	40857256	CCDC32	33717	40854756	40859756
NM_025055	chr15	+	74528629	74628482	CCDC33	99853	74526129	74531129
NM_030771	chr11	-	27360060	27384795	CCDC34	24735	27382295	27387295
NM_178173	chr3	+	49235860	49295537	CCDC36	59677	49233360	49238360
NM_182496	chr12	-	96260825	96336428	CCDC38	75603	96333928	96338928
NM_181426	chr3	-	180331795	180397283	CCDC39	65488	180394783	180399783
NM_017950	chr17	+	78010430	78074412	CCDC40	63982	78007930	78012930
NM_144681	chr17	-	8633245	8648154	CCDC42	14909	8645654	8650654
NM_144609	chr17	-	42754804	42767165	CCDC43	12361	42764665	42769665
NM_020198	chr17	-	61822609	61851088	CCDC47	28479	61848588	61853588
NM_174908	chr3	+	191046873	191116459	CCDC50	69586	191044373	191049373
NM_001256968	chr3	-	48473579	48481529	CCDC51	7950	48479029	48484029
NM_198082	chr17	-	80059329	80170754	CCDC57	111425	80168254	80173254
NM_001017928	chr3	-	122078437	122102078	CCDC58	23641	122099578	122104578
NR_033192	chr12	-	82746082	82752584	CCDC59	6502	82750084	82755084
NM_005436	chr10	-	61548505	61666414	CCDC6	117909	61663914	61668914
NM_178499	chr12	+	119772516	119978852	CCDC60	206336	119770016	119775016
NM_001267723	chr19	+	46498718	46521874	CCDC61	23156	46496218	46501218
NR_027918	chr12	+	123259055	123311927	CCDC62	52872	123256555	123261555
NM_001286243	chr12	+	111284763	111345339	CCDC63	60576	111282263	111287263
NM_033124	chr12	+	49297892	49315359	CCDC65	17467	49295392	49300392
NM_001012506	chr3	+	56591183	56655848	CCDC66	64665	56588683	56593683
NM_025214	chr18	-	52568739	52626739	CCDC68	58000	52624239	52629239
NM_015621	chr5	-	150560612	150603654	CCDC69	43042	150601154	150606154
NM_001321115	chr10	+	32735009	33171792	CCDC7	436783	32732509	32737509
NM_031290	chr13	+	52436083	52440372	CCDC70	4289	52433583	52438583
NM_022903	chr3	-	49199967	49203785	CCDC71	3818	49201285	49206285
NM_175884	chr7	-	106294807	106301634	CCDC71L	6827	106299134	106304134
NM_001008391	chr11	-	32623625	32816204	CCDC73	192579	32813704	32818704
NM_001349047	chr2	+	132285247	132291239	CCDC74A	5992	132282747	132287747
NM_001258307	chr2	-	130896855	130902707	CCDC74B	5852	130900207	130905207
NM_001130148	chr12	+	498515	551806	CCDC77	53291	496015	501015
NM_001031737	chr16	-	772581	776473	CCDC78	3892	773973	778973
NM_032040	chr19	-	46913585	46916919	CCDC8	3334	46914419	46919419
NM_199512	chr3	-	112323232	112359990	CCDC80	36758	112357490	112362490
NM_001156474	chr11	+	86085777	86134151	CCDC81	48374	86083277	86088277
NM_001318736	chr11	-	96085928	96123083	CCDC82	37155	96120583	96125583
NM_173556	chr11	+	85566143	85631063	CCDC83	64920	85563643	85568643
NR_104049	chr11	+	118868842	118886502	CCDC84	17660	118866342	118871342
NM_001080433	chr2	+	56411257	56613309	CCDC85A	202052	56408757	56413757
NM_001144995	chr14	-	99977602	100070727	CCDC85C	93125	100068227	100073227
NM_024098	chr11	+	60609428	60618561	CCDC86	9133	60606928	60611928
NM_018219	chr11	-	66357639	66360554	CCDC87	2915	66358054	66363054
NM_018084	chr2	-	55514977	55647057	CCDC88A	132080	55644557	55649557
NM_032251	chr11	+	64107689	64125006	CCDC88B	17317	64105189	64110189
NM_001080414	chr14	-	91737666	91884188	CCDC88C	146522	91881688	91886688
NM_015603	chr19	+	47759730	47775210	CCDC9	15480	47757230	47762230
NM_021825	chr11	-	82970134	82997450	CCDC90B	27316	82994950	82999950
NM_001352082	chr12	+	28343359	28703099	CCDC91	359740	28340859	28345859
NM_001304957	chr12	-	124420955	124457532	CCDC92	36577	124455032	124460032
NM_019044	chr2	-	118673053	118771739	CCDC93	98686	118769239	118774239
NM_018074	chr19	+	4247066	4269090	CCDC94	22024	4244566	4249566
NM_052848	chr19	+	41816067	41830788	CCDC97	14721	41813567	41818567
NR_131782	chr10	-	60933722	60936224	CCEPR	2502	60933724	60938724
NM_152638	chr12	-	91345991	91348953	CCER1	2962	91346453	91351453
NM_001243212	chr19	-	39399619	39402798	CCER2	3179	39400298	39405298
NM_019052	chr6_mcf_hap5	-	2492151	2507972	CCHCR1	15821	2505472	2510472
NM_000729	chr3	-	42299315	42307687	CCK	8372	42305187	42310187
NM_000730	chr4	-	26483017	26492042	CCKAR	9025	26489542	26494542
NM_176875	chr11	+	6280903	6293357	CCKBR	12454	6278403	6283403
NM_002981	chr17	-	32687346	32690252	CCL1	2906	32687752	32692752
NM_002986	chr17	+	32612686	32615199	CCL11	2513	32610186	32615186
NM_032962	chr17	-	34310691	34313764	CCL14	3073	34311264	34316264
NM_032965	chr17	-	34324617	34329084	CCL15	4467	34326584	34331584
NR_027922	chr17	-	34310691	34329084	CCL15-CCL14	18393	34326584	34331584
NM_004590	chr17	-	34303528	34308532	CCL16	5004	34306032	34311032
NM_002987	chr16	+	57438678	57449974	CCL17	11296	57436178	57441178
NM_002988	chr17	+	34391631	34398841	CCL18	7210	34389131	34394131
NM_001130046	chr2	+	228678557	228682280	CCL20	3723	228676057	228681057
NM_002990	chr16	+	57392694	57400102	CCL22	7408	57390194	57395194
NM_005064	chr17	-	34340095	34345005	CCL23	4910	34342505	34347505
NM_005624	chr19	+	8117645	8127547	CCL25	9902	8115145	8120145
NM_006072	chr7	-	75398841	75419064	CCL26	20223	75416564	75421564
NM_001301874	chr5	-	43376747	43412493	CCL28	35746	43409993	43414993
NM_001278736	chr17	-	34198495	34207377	CCL5	8882	34204877	34209877
NR_030770	chr7	+	45039344	45116069	CCM2	76725	45036844	45041844
NM_080625	chr20	+	30598244	30619984	CCM2L	21740	30595744	30600744
NM_001111047	chr13	+	37005966	37017019	CCNA1	11053	37003466	37008466
NM_001237	chr4	-	122737598	122745156	CCNA2	7558	122742656	122747656
NM_031966	chr5	+	68462836	68474070	CCNB1	11234	68460336	68465336
NM_182852	chr14	-	20779526	20801471	CCNB1IP1	21945	20798971	20803971
NM_004701	chr15	+	59397283	59417244	CCNB2	19961	59394783	59399783
NM_033031	chrX	+	50027539	50094911	CCNB3	67372	50025039	50030039
NM_005190	chr6	-	99990262	100016690	CCNC	26428	100014190	100019190
NM_053056	chr11	+	69455872	69469242	CCND1	13370	69453372	69458372
NM_001759	chr12	+	4382901	4414522	CCND2	31621	4380401	4385401
NR_125790	chr12	-	4357932	4385350	CCND2-AS1	27418	4382850	4387850
NM_001136017	chr6	-	41902670	42016632	CCND3	113962	42014132	42019132
NR_027514	chr15	+	43477465	43489375	CCNDBP1	11910	43474965	43479965
NM_001322262	chr19	+	30302900	30315224	CCNE1	12324	30300400	30305400
NM_057749	chr8	-	95892452	95907482	CCNE2	15030	95904982	95909982
NM_001761	chr16	+	2479394	2508859	CCNF	29465	2476894	2481894
NM_199246	chr5	+	162864576	162872022	CCNG1	7446	162862076	162867076
NM_004354	chr4	+	78078356	78091213	CCNG2	12857	78075856	78080856
NM_001239	chr5	-	86690078	86708850	CCNH	18772	86706350	86711350
NM_001348132	chr4	-	77969172	77997125	CCNI	27953	77994625	77999625
NM_001287253	chr5	+	132083136	132090095	CCNI2	6959	132080636	132085636
NM_019084	chr10	+	97803158	97820625	CCNJ	17467	97800658	97805658
NR_131769	chr5	-	159678658	159766599	CCNJL	87941	159764099	159769099
NM_001099402	chr14	+	99947738	99977852	CCNK	30114	99945238	99950238
NM_001308185	chr3	-	156864290	156878549	CCNL1	14259	156876049	156881049
NM_030937	chr1	-	1321090	1334722	CCNL2	13632	1332222	1337222
NM_021147	chr5	-	54526980	54529545	CCNO	2565	54527045	54532045
NM_001277842	chr12	-	49082240	49110781	CCNT1	28541	49108281	49113281
NM_001320748	chr2	+	135676391	135716915	CCNT2	40524	135673891	135678891
NR_036549	chr2	-	135624202	135676176	CCNT2-AS1	51974	135673676	135678676
NM_181698	chr10	+	35535908	35861598	CCNY	325690	35533408	35538408
NM_001142300	chr2	+	208576263	208620896	CCNYL1	44633	208573763	208578763
NR_103829	chr10	-	42903621	42967688	CCNYL2	64067	42965188	42970188
NM_001323569	chr16	+	19535178	19564728	CCP110	29550	19532678	19537678
NM_001204450	chr15	-	55647420	55700708	CCPG1	53288	55698208	55703208
NM_001295	chr3	-	46243199	46249832	CCR1	6633	46247332	46252332
NM_001123041	chr3	+	46395234	46402413	CCR2	7179	46392734	46397734
NM_178329	chr3	+	46283871	46308197	CCR3	24326	46281371	46286371
NM_005508	chr3	+	32993065	32996403	CCR4	3338	32990565	32995565
NM_000579	chr3	+	46411632	46417697	CCR5	6065	46409132	46414132
NM_004367	chr6	+	167525294	167552629	CCR6	27335	167522794	167527794
NM_001301714	chr17	-	38710021	38721736	CCR7	11715	38719236	38724236
NM_005201	chr3	+	39371196	39375171	CCR8	3975	39368696	39373696
NM_001256369	chr3	+	45927995	45944667	CCR9	16672	45925495	45930495
NM_005125	chr11	+	66360689	66373490	CCS	12801	66358189	66363189
NM_145257	chr1	-	229456751	229478688	CCSAP	21937	229476188	229481188
NM_001145065	chr4	+	91048683	92523370	CCSER1	1474687	91046183	91051183
NM_001284240	chr10	+	86088344	86278277	CCSER2	189933	86085844	86090844
NM_006431	chr12	+	69979207	69995357	CCT2	16150	69976707	69981707
NR_036564	chr1	-	156278751	156308206	CCT3	29455	156305706	156310706
NM_001256721	chr2	-	62095261	62115806	CCT4	20545	62113306	62118306
NM_001306154	chr5	+	10250032	10266524	CCT5	16492	10247532	10252532
NM_001762	chr7	+	56119377	56131682	CCT6A	12305	56116877	56121877
NM_001193530	chr17	-	33254877	33288528	CCT6B	33651	33286028	33291028
NR_003110	chr7	+	65216091	65228662	CCT6P1	12571	65213591	65218591
NR_033416	chr7	+	64498731	64535091	CCT6P3	36360	64496231	64501231
NM_001166284	chr2	+	73461363	73480150	CCT7	18787	73458863	73463863
NM_001282908	chr21	-	30428642	30446118	CCT8	17476	30443618	30448618
NM_015622	chr7	+	5938340	5965603	CCZ1	27263	5935840	5940840
NM_198097	chr7	-	6838565	6865926	CCZ1B	27361	6863426	6868426
NR_002822	chr7	-	97595719	97601670	CCZ1P-OR7E38P	5951	97599170	97604170
NM_001256109	chr1	+	117544371	117579173	CD101	34802	117541871	117546871
NM_001159588	chr6	+	74405807	74538041	CD109	132234	74403307	74408307
NM_001039490	chr11	+	832951	838835	CD151	5884	830451	835451
NR_103845	chr1	-	145695797	145715639	CD160	19842	145713139	145718139
NM_203416	chr12	-	7623411	7656414	CD163	33003	7653914	7658914
NM_174941	chr12	-	7507555	7596781	CD163L1	89226	7594281	7599281
NM_001142401	chr6	-	109687716	109704015	CD164	16299	109701515	109706515
NM_207397	chr1	-	27705665	27709823	CD164L2	4158	27707323	27712323
NM_020406	chr19	+	43857810	43867324	CD177	9514	43855310	43860310
NM_005582	chr5	-	66478103	66492617	CD180	14514	66490117	66495117
NM_001770	chr16	+	28943259	28950668	CD19	7409	28940759	28945759
NM_001320652	chr1	+	158218118	158228058	CD1A	9940	158215618	158220618
NM_001764	chr1	-	158297739	158301321	CD1B	3582	158298821	158303821
NM_001765	chr1	+	158259562	158264564	CD1C	5002	158257062	158262062
NM_001766	chr1	+	158149736	158156216	CD1D	6480	158147236	158152236
NM_001042583	chr1	+	158323485	158327343	CD1E	3858	158320985	158325985
NM_001328609	chr1	+	117297051	117311851	CD2	14800	117294551	117299551
NM_001318828	chr3	+	112051793	112081658	CD200	29865	112049293	112054293
NM_138806	chr3	-	112641531	112693937	CD200R1	52406	112691437	112696437
NM_001199215	chr3	-	112534555	112564797	CD200R1L	30242	112562297	112567297
NM_015717	chr2	-	71057342	71062953	CD207	5611	71060453	71065453
NR_026692	chr19	-	7804880	7812464	CD209	7584	7809964	7814964
NM_001185099	chr19	+	35820071	35838264	CD22	18193	35817571	35822571
NM_001303619	chr18	-	67530192	67624412	CD226	94220	67621912	67626912
NM_001291738	chrY	-	21152525	21438350	CD24	285825	21435850	21440850
NM_001166663	chr1	-	160799949	160832692	CD244	32743	160830192	160835192
NM_000734	chr1	-	167399876	167487847	CD247	87971	167485347	167490347
NM_020404	chr11	-	66081957	66084515	CD248	2558	66082015	66087015
NM_001242	chr12	+	6554050	6560884	CD27	6834	6551550	6556550
NR_015382	chr12	-	6548166	6560683	CD27-AS1	12517	6558183	6563183
NM_001267706	chr9	+	5450502	5470567	CD274	20065	5448002	5453002
NM_001024736	chr15	+	73976621	74006859	CD276	30238	73974121	73979121
NM_001243078	chr2	+	204571197	204603636	CD28	32439	204568697	204573697
NM_012120	chr6	+	47445524	47594996	CD2AP	149472	47443024	47448024
NM_006110	chr16	-	30362086	30366682	CD2BP2	4596	30364182	30369182
NM_001330457	chr17	+	72462511	72480937	CD300A	18426	72460011	72465011
NM_006678	chr17	-	72537204	72542310	CD300C	5106	72539810	72544810
NM_181449	chr17	-	72606021	72619897	CD300E	13876	72617397	72622397
NM_001324073	chr17	-	72556839	72563482	CD300H	6643	72560982	72565982
NM_174892	chr17	-	72517312	72527613	CD300LB	10301	72525113	72530113
NM_001115152	chr17	-	72576110	72588370	CD300LD	12260	72585870	72590870
NM_001289082	chr17	-	72690446	72709139	CD300LF	18693	72706639	72711639
NM_145273	chr17	+	41924515	41940997	CD300LG	16482	41922015	41927015
NM_001198764	chr2	-	160625138	160654766	CD302	29628	160652266	160657266
NM_016579	chr19	-	8367010	8373240	CD320	6230	8370740	8375740
NM_001772	chr19	+	51728334	51743274	CD33	14940	51725834	51730834
NM_001773	chr1	-	208059882	208084683	CD34	24801	208082183	208087183
NM_001001547	chr7	+	80231503	80303734	CD36	72231	80229003	80234003
NM_001774	chr19	+	49838676	49843861	CD37	5185	49836176	49841176
NR_132660	chr4	+	15779887	15854866	CD38	74979	15777387	15782387
NM_000732	chr11	-	118209788	118213459	CD3D	3671	118210959	118215959
NM_000733	chr11	+	118175294	118186890	CD3E	11596	118172794	118177794
NM_001297590	chr19	+	45909466	45914024	CD3EAP	4558	45906966	45911966
NM_000073	chr11	+	118215058	118224497	CD3G	9439	118212558	118217558
NM_001195014	chr12	+	6898637	6929976	CD4	31339	6896137	6901137
NR_126502	chr20	+	44746892	44758384	CD40	11492	44744392	44749392
NM_000074	chrX	+	135730335	135742549	CD40LG	12214	135727835	135732835
NM_001202556	chr11	+	35160416	35253949	CD44	93533	35157916	35162916
NM_172351	chr1	+	207925382	207968861	CD46	43479	207922882	207927882
NM_198793	chr3	-	107761940	107809935	CD47	47995	107807435	107812435
NM_001778	chr1	-	160648535	160681641	CD48	33106	160679141	160684141
NM_001346456	chr11	+	60861434	60895323	CD5	33889	60858934	60863934
NM_001803	chr1	+	26644410	26647014	CD52	2604	26641910	26646910
NM_001040033	chr1	+	111413820	111442558	CD53	28738	111411320	111416320
NR_125349	chr1	+	207494816	207534311	CD55	39495	207492316	207497316
NR_026665	chr1	-	117057155	117113715	CD58	56560	117111215	117116215
NM_203331	chr11	-	33724555	33758025	CD59	33470	33755525	33760525
NM_001347698	chr1	-	157796860	157811634	CD5L	14774	157809134	157814134
NR_045638	chr11	+	60739112	60787848	CD6	48736	60736612	60741612
NM_001257389	chr12	-	56119226	56123457	CD63	4231	56120957	56125957
NM_001251	chr17	+	7482804	7485429	CD68	2625	7480304	7485304
NM_001781	chr12	-	9905081	9913497	CD69	8416	9910997	9915997
NM_006137	chr17	-	80272745	80275480	CD7	2735	80272980	80277980
NM_001330332	chr19	-	6581656	6591163	CD70	9507	6588663	6593663
NM_001782	chr9	-	35609975	35618424	CD72	8449	35615924	35620924
NM_004355	chr5	-	149781199	149792499	CD74	11300	149789999	149794999
NM_021601	chr19	+	42381189	42385439	CD79A	4250	42378689	42383689
NM_021602	chr17	-	62006095	62009714	CD79B	3619	62007214	62012214
NM_005191	chr3	-	119243139	119278481	CD80	35342	119275981	119280981
NM_001297649	chr11	+	2397406	2418649	CD81	21243	2394906	2399906
NR_108080	chr11	-	2349978	2399222	CD81-AS1	49244	2396722	2401722
NM_002231	chr11	+	44587140	44641315	CD82	54175	44584640	44589640
NM_001251901	chr6	+	14117486	14137148	CD83	19662	14114986	14119986
NM_001184879	chr1	-	160510883	160549306	CD84	38423	160546806	160551806
NM_001206924	chr3	+	121774208	121839988	CD86	65780	121771708	121776708
NM_001145873	chr2	-	87011727	87035519	CD8A	23792	87033019	87038019
NM_172213	chr2	-	87042459	87089047	CD8B	46588	87086547	87091547
NM_001349727	chr2	+	107103811	107127551	CD8B2	23740	107101311	107106311
NM_001330312	chr12	+	6308872	6347437	CD9	38565	6306372	6311372
NM_012072	chr20	-	23059992	23066977	CD93	6985	23064477	23069477
NR_134917	chr3	+	111260925	111384838	CD96	123913	111258425	111263425
NM_002414	chrX	+	2609173	2659350	CD99	50177	2606673	2611673
NM_031462	chrX	-	149934808	150067289	CD99L2	132481	150064789	150069789
NR_033380	chrX	+	2527305	2575270	CD99P1	47965	2524805	2529805
NM_001785	chr1	+	20915443	20945400	CDA	29957	20912943	20917943
NM_001193478	chr13	+	49822046	49867622	CDADC1	45576	49819546	49824546
NM_138477	chr15	-	43015741	43029326	CDAN1	13585	43026826	43031826
NM_006023	chr10	+	12237960	12292589	CDC123	54629	12235460	12240460
NM_001319210	chr1	+	100818022	100985833	CDC14A	167811	100815522	100820522
NM_003671	chr9	-	99262389	99382112	CDC14B	119723	99379612	99384612
NR_003595	chr7	+	48964156	48967049	CDC14C	2893	48961656	48966656
NM_001318518	chr13	+	115000319	115038201	CDC16	37882	114997819	115002819
NM_001255	chr1	+	43824625	43828873	CDC20	4248	43822125	43827125
NM_001145734	chr5	-	54408798	54469005	CDC20B	60207	54466505	54471505
NM_004661	chr5	-	137523336	137549032	CDC23	25696	137546532	137551532
NM_001789	chr3	-	48198667	48229801	CDC25A	31134	48227301	48232301
NM_001287516	chr20	+	3767418	3786768	CDC25B	19350	3764918	3769918
NM_001287583	chr5	-	137620953	137674044	CDC25C	53091	137671544	137676544
NM_139286	chr9	-	116029289	116037869	CDC26	8580	116035369	116040369
NM_001114091	chr17	-	45195062	45266705	CDC27	71643	45264205	45269205
NM_004359	chr19	+	531732	542087	CDC34	10355	529232	534232
NM_007065	chr19	-	10501808	10514271	CDC37	12463	10511771	10516771
NM_017913	chr9	+	4679552	4708398	CDC37L1	28846	4677052	4682052
NR_121598	chr9	-	4676600	4679480	CDC37L1-AS1	2880	4676980	4681980
NM_015891	chr6	+	110501623	110553422	CDC40	51799	110499123	110504123
NM_001791	chr1	+	22379119	22419436	CDC42	40317	22376619	22381619
NM_014826	chr1	-	227177565	227505826	CDC42BPA	328261	227503326	227508326
NM_006035	chr14	-	103398715	103523742	CDC42BPB	125027	103521242	103526242
NM_017525	chr11	-	64591661	64612041	CDC42BPG	20380	64609541	64614541
NM_152243	chr22	+	37956470	37965410	CDC42EP1	8940	37953970	37958970
NM_006779	chr11	+	65082288	65089900	CDC42EP2	7612	65079788	65084788
NM_001270436	chr2	-	37869024	37899678	CDC42EP3	30654	37897178	37902178
NM_012121	chr17	-	71279762	71308143	CDC42EP4	28381	71305643	71310643
NM_145057	chr19	-	54976208	54984437	CDC42EP5	8229	54981937	54986937
NM_020239	chr1	-	151023446	151032125	CDC42SE1	8679	151029625	151034625
NM_020240	chr5	+	130599701	130730382	CDC42SE2	130681	130597201	130602201
NM_003504	chr22	+	19467348	19508135	CDC45	40787	19464848	19469848
NM_001253	chr6	+	44355250	44418161	CDC5L	62911	44352750	44357750
NM_001254	chr17	+	38444145	38459413	CDC6	15268	38441645	38446645
NM_001134419	chr1	+	91966403	91991321	CDC7	24918	91963903	91968903
NM_024529	chr1	+	193091087	193223942	CDC73	132855	193088587	193093587
NM_152562	chr8	+	25316446	25365433	CDCA2	48987	25313946	25318946
NM_001297603	chr12	-	6955888	6961094	CDCA3	5206	6958594	6963594
NM_017955	chr14	-	105475909	105487425	CDCA4	11516	105484925	105489925
NM_080668	chr11	-	64844926	64851615	CDCA5	6689	64849115	64854115
NM_031942	chr2	+	174219560	174233718	CDCA7	14158	174217060	174222060
NM_001127370	chr7	-	21940516	21985542	CDCA7L	45026	21983042	21988042
NM_001256875	chr1	+	38158072	38175391	CDCA8	17319	38155572	38160572
NM_022842	chr3	-	45123765	45187914	CDCP1	64149	45185414	45190414
NM_201546	chr1	-	54604667	54618679	CDCP2	14012	54616179	54621179
NM_004360	chr16	+	68771192	68869445	CDH1	98253	68768692	68773692
NM_006727	chr5	-	24487208	24645087	CDH10	157879	24642587	24647587
NM_001330576	chr16	-	64977656	65156040	CDH11	178384	65153540	65158540
NM_004061	chr5	-	21750974	22853731	CDH12	1102757	22851231	22856231
NM_001220490	chr16	+	82660398	83830215	CDH13	1169817	82657898	82662898
NM_004933	chr16	+	89238162	89261900	CDH15	23738	89235662	89240662
NM_001204744	chr16	-	66942024	66952887	CDH16	10863	66950387	66955387
NM_001144663	chr8	-	95139393	95229531	CDH17	90138	95227031	95232031
NM_001349556	chr5	-	19471404	20575982	CDH18	1104578	20573482	20578482
NR_146519	chr5	+	20305659	20332555	CDH18-AS1	26896	20303159	20308159
NR_073130	chr18	-	64168423	64271375	CDH19	102952	64268875	64273875
NM_001792	chr18	-	25530926	25757410	CDH2	226484	25754910	25759910
NM_031891	chr18	+	59000814	59223006	CDH20	222192	58998314	59003314
NM_021248	chr20	-	44802371	44937137	CDH22	134766	44934637	44939637
NM_022124	chr10	+	73156690	73575704	CDH23	419014	73154190	73159190
NR_120672	chr10	-	73267909	73271677	CDH23-AS1	3768	73269177	73274177
NM_144985	chr14	-	23516269	23526747	CDH24	10478	23524247	23529247
NM_177980	chr20	+	58533450	58589584	CDH26	56134	58530950	58535950
NM_001317196	chr16	+	68678738	68732970	CDH3	54232	68676238	68681238
NM_001794	chr20	+	59827481	60515673	CDH4	688192	59824981	59829981
NM_001795	chr16	+	66400509	66438689	CDH5	38180	66398009	66403009
NM_004932	chr5	+	31193761	31329253	CDH6	135492	31191261	31196261
NM_033646	chr18	+	63417487	63549202	CDH7	131715	63414987	63419987
NM_001796	chr16	-	61685914	62070739	CDH8	384825	62068239	62073239
NM_016279	chr5	-	26880708	27038689	CDH9	157981	27036189	27041189
NM_001171971	chr10	+	85954390	85979376	CDHR1	24986	85951890	85956890
NM_001171976	chr5	+	175969511	176022769	CDHR2	53258	175967011	175972011
NM_001301161	chr7	+	105603656	105676877	CDHR3	73221	105601156	105606156
NM_001007540	chr3	-	49828166	49837268	CDHR4	9102	49834768	49839768
NM_001171968	chr11	-	616564	625067	CDHR5	8503	622567	627567
NM_013399	chr16	-	4560676	4588816	CDIP1	28140	4586316	4591316
NM_006319	chr16	-	29869676	29874609	CDIPT	4933	29872109	29877109
NR_024370	chr16	+	29875003	29879374	CDIPT-AS1	4371	29872503	29877503
NM_001320918	chr10	+	62538088	62554611	CDK1	16523	62535588	62540588
NM_052988	chr16	+	89753075	89762772	CDK10	9697	89750575	89755575
NR_132740	chr1	-	1633822	1656004	CDK11A	22182	1653504	1658504
NM_033487	chr1	-	1570602	1655859	CDK11B	85257	1653359	1658359
NM_015083	chr17	+	37617763	37690818	CDK12	73055	37615263	37620263
NM_031267	chr7	+	39989958	40136733	CDK13	146775	39987458	39992458
NM_001287135	chr7	+	90225675	90839905	CDK14	614230	90223175	90228175
NM_139158	chr2	+	202671151	202760273	CDK15	89122	202668651	202673651
NM_033018	chrX	+	47077527	47089394	CDK16	11867	47075027	47080027
NM_001170464	chr12	-	96672038	96794366	CDK17	122328	96791866	96796866
NM_002596	chr1	+	205473683	205501921	CDK18	28238	205471183	205476183
NM_001300964	chr6	-	110931180	111137088	CDK19	205908	111134588	111139588
NM_001290230	chr12	+	56360552	56366573	CDK2	6021	56358052	56363052
NM_001170640	chr9	-	90581358	90589695	CDK20	8337	90587195	90592195
NR_073007	chr12	-	123745516	123756863	CDK2AP1	11347	123754363	123759363
NM_001258	chr17	+	73996986	74002080	CDK3	5094	73994486	73999486
NM_000075	chr12	-	58141509	58146230	CDK4	4721	58143730	58148730
NM_001164410	chr7	-	150750898	150755052	CDK5	4154	150752552	150757552
NM_003885	chr17	+	30814104	30818271	CDK5R1	4167	30811604	30816604
NM_003936	chr2	+	219824349	219826877	CDK5R2	2528	219821849	219826849
NM_016408	chr20	-	31946644	31989375	CDK5RAP1	42731	31986875	31991875
NR_073557	chr9	-	123151146	123342448	CDK5RAP2	191302	123339948	123344948
NM_001278197	chr17	+	46047893	46059152	CDK5RAP3	11259	46045393	46050393
NM_001145306	chr7	-	92234234	92465941	CDK6	231707	92463441	92468441
NM_001324072	chr5	+	68530621	68573257	CDK7	42636	68528121	68533121
NM_001318368	chr13	+	26828240	26979373	CDK8	151133	26825740	26830740
NM_001261	chr9	+	130548304	130553052	CDK9	4748	130545804	130550804
NM_017774	chr6	+	20534687	21232634	CDKAL1	697947	20532187	20537187
NM_004196	chr14	-	50796308	50862642	CDKL1	66334	50860142	50865142
NM_003948	chr4	-	76501703	76555724	CDKL2	54021	76553224	76558224
NM_001300853	chr5	-	133634114	133706738	CDKL3	72624	133704238	133709238
NR_144521	chr2	-	39395185	39471124	CDKL4	75939	39468624	39473624
NM_003159	chrX	+	18443724	18671749	CDKL5	228025	18441224	18446224
NM_001220777	chr6	+	36644236	36655116	CDKN1A	10880	36641736	36646736
NM_004064	chr12	+	12870203	12875316	CDKN1B	5113	12867703	12872703
NM_000076	chr11	-	2904447	2906995	CDKN1C	2548	2904495	2909495
NM_058195	chr9	-	21967750	21994490	CDKN2A	26740	21991990	21996990
NM_017632	chr4	+	184365743	184370218	CDKN2AIP	4475	184363243	184368243
NM_080656	chr5	-	133737755	133747598	CDKN2AIPNL	9843	133745098	133750098
NM_004936	chr9	-	22002901	22009312	CDKN2B	6411	22006812	22011812
NR_047536	chr9	+	21994789	22121093	CDKN2B-AS1	126304	21992289	21997289
NM_001262	chr1	+	51434366	51440306	CDKN2C	5940	51431866	51436866
NM_079421	chr19	-	10677137	10679655	CDKN2D	2518	10677155	10682155
NM_001330173	chr14	+	54863585	54886934	CDKN3	23349	54861085	54866085
NM_001029954	chr10	-	14861250	14879983	CDNF	18733	14877483	14882483
NM_001323566	chr5	-	115140429	115152405	CDO1	11976	115149905	115154905
NM_016952	chr11	-	125826712	125933187	CDON	106475	125930687	125935687
NM_207327	chr22	-	46639909	46646193	CDPF1	6284	46643693	46648693
NM_001802	chr16	-	22357256	22385938	CDR2	28682	22383438	22388438
NM_014603	chr17	+	72983726	73001892	CDR2L	18166	72981226	72986226
NM_001282540	chr17	-	15468795	15523018	CDRT1	54223	15520518	15525518
NM_001204477	chr17	-	15339331	15370925	CDRT4	31594	15368425	15373425
NM_001263	chr4	+	85504056	85572493	CDS1	68437	85501556	85506556
NM_003818	chr20	+	5107406	5178533	CDS2	71127	5104906	5109906
NM_001264	chr6_qbl_hap6	-	2378682	2384073	CDSN	5391	2381573	2386573
NM_030928	chr16	+	88870185	88875666	CDT1	5481	88867685	88872685
NM_017548	chr3	+	133292433	133309118	CDV3	16685	133289933	133294933
NM_001804	chr5	+	149546343	149564121	CDX1	17778	149543843	149548843
NM_001265	chr13	-	28536204	28543505	CDX2	7301	28541005	28546005
NM_005193	chrX	+	72667089	72674421	CDX4	7332	72664589	72669589
NM_004680	chrY	-	26191376	26194161	CDY1	2785	26191661	26196661
NM_001003895	chrY	-	26191376	26194161	CDY1B	2785	26191661	26196661
NR_026590	chr6	+	4706392	4955778	CDYL	249386	4703892	4708892
NM_152342	chr16	-	80631795	80838175	CDYL2	206380	80835675	80840675
NM_001205344	chr19	-	43011457	43032661	CEACAM1	21204	43030161	43035161
NM_001039213	chr19	+	45202420	45213986	CEACAM16	11566	45199920	45204920
NM_001278392	chr19	+	51981896	51993859	CEACAM18	11963	51979396	51984396
NM_020219	chr19	+	45174723	45187627	CEACAM19	12904	45172223	45177223
NM_001102599	chr19	-	45010210	45033548	CEACAM20	23338	45031048	45036048
NM_001288773	chr19	+	42055885	42093197	CEACAM21	37312	42053385	42058385
NR_027754	chr19	-	45041044	45060150	CEACAM22P	19106	45057650	45062650
NM_001277163	chr19	+	42300521	42315591	CEACAM3	15070	42298021	42303021
NM_001817	chr19	-	42125343	42133442	CEACAM4	8099	42130942	42135942
NM_004363	chr19	+	42212503	42234341	CEACAM5	21838	42210003	42215003
NM_002483	chr19	+	42259427	42276113	CEACAM6	16686	42256927	42261927
NM_006890	chr19	-	42177234	42192206	CEACAM7	14972	42189706	42194706
NM_001816	chr19	-	43084394	43099082	CEACAM8	14688	43096582	43101582
NM_001287435	chr19	-	33790839	33793470	CEBPA	2631	33790970	33795970
NR_125739	chr20	-	48801139	48808606	CEBPB-AS1	7467	48806106	48811106
NM_001806	chr19	+	33864574	33873592	CEBPG	9018	33862074	33867074
NM_005760	chr2	-	37428774	37458740	CEBPZ	29966	37456240	37461240
NR_136316	chr2	+	37423603	37443336	CEBPZOS	19733	37421103	37426103
NM_001290046	chr22	+	17840838	18037856	CECR2	197018	17838338	17843338
NR_038398	chr22	-	17737749	17747623	CECR3	9874	17745123	17750123
NR_015352	chr22	+	17517459	17539682	CECR7	22223	17514959	17519959
NM_001807	chr9	+	135937364	135947250	CEL	9886	135934864	135939864
NM_001971	chr12	-	51722226	51740463	CELA1	18237	51737963	51742963
NM_033440	chr1	+	15783222	15798586	CELA2A	15364	15780722	15785722
NM_015849	chr1	+	15802595	15817895	CELA2B	15300	15800095	15805095
NM_005747	chr1	+	22328148	22339035	CELA3A	10887	22325648	22330648
NM_007352	chr1	+	22303386	22315847	CELA3B	12461	22300886	22305886
NM_006560	chr11	-	47487488	47574792	CELF1	87304	47572292	47577292
NM_001326317	chr10	+	10504477	11373418	CELF2	868941	10501977	10506977
NR_126062	chr10	-	11358795	11386673	CELF2-AS1	27878	11384173	11389173
NR_046108	chr10	-	11113505	11147451	CELF2-AS2	33946	11144951	11149951
NM_001172649	chr1	-	151672533	151689296	CELF3	16763	151686796	151691796
NM_001025087	chr18	-	34823007	35146000	CELF4	322993	35143500	35148500
NM_021938	chr19	+	3224700	3297073	CELF5	72373	3222200	3227200
NM_052840	chr15	-	72577067	72612525	CELF6	35458	72610025	72615025
NR_001275	chr9	+	135957925	135962478	CELP	4553	135955425	135960425
NM_014246	chr22	-	46756730	46933067	CELSR1	176337	46930567	46935567
NM_001408	chr1	+	109792640	109818378	CELSR2	25738	109790140	109795140
NM_001407	chr3	-	48673895	48700348	CELSR3	26453	48697848	48702848
NR_111921	chr3	+	48701200	48706603	CELSR3-AS1	5403	48698700	48703700
NM_001293304	chr15	+	81071683	81244003	CEMIP	172320	81069183	81074183
NM_016564	chr11	-	787109	790126	CEND1	3017	787626	792626
NM_001809	chr2	+	27008881	27017455	CENPA	8574	27006381	27011381
NM_001810	chr20	-	3764497	3767337	CENPB	2840	3764837	3769837
NM_145039	chr16	-	90036182	90039240	CENPBD1	3058	90036740	90041740
NR_026052	chr19	+	59086765	59095762	CENPBD1P1	8997	59084265	59089265
NM_001812	chr4	-	68337988	68411256	CENPC	73268	68408756	68413756
NM_001286734	chr4	-	104026962	104119566	CENPE	92604	104117066	104122066
NM_016343	chr1	+	214776531	214837914	CENPF	61383	214774031	214779031
NM_022909	chr5	+	68485374	68506184	CENPH	20810	68482874	68487874
NM_001318521	chrX	+	100353170	100418662	CENPI	65492	100350670	100355670
NM_018451	chr13	-	25456411	25497027	CENPJ	40616	25494527	25499527
NM_001349369	chr5	-	64812103	64858995	CENPK	46892	64856495	64861495
NM_033319	chr1	-	173768687	173793777	CENPL	25090	173791277	173796277
NM_024053	chr22	-	42334724	42343168	CENPM	8444	42340668	42345668
NM_001100625	chr16	+	81040102	81066709	CENPN	26607	81037602	81042602
NM_024322	chr2	+	25015983	25045245	CENPO	29262	25013483	25018483
NM_001286969	chr9	+	95087749	95377437	CENPP	289688	95085249	95090249
NM_018132	chr6	+	49431095	49460820	CENPQ	29725	49428595	49433595
NM_199294	chr1	+	10490158	10502872	CENPS	12714	10487658	10492658
NM_001270517	chr1	+	10490158	10512060	CENPS-CORT	21902	10487658	10492658
NM_025082	chr16	-	67862059	67881361	CENPT	19302	67878861	67883861
NM_024629	chr4	-	185615218	185655286	CENPU	40068	185652786	185657786
NM_181716	chr17	-	16245847	16256812	CENPV	10965	16254312	16259312
NR_104462	chr6	+	126660934	126804466	CENPW	143532	126658434	126663434
NM_001330536	chr17	-	79976578	79980794	CENPX	4216	79978294	79983294
NM_014704	chr1	-	3728644	3773797	CEP104	45153	3771297	3776297
NM_001199165	chr17	-	63631657	64188349	CEP112	556692	64185849	64190849
NM_001166226	chr5	-	122680578	122759286	CEP120	78708	122756786	122761786
NM_020802	chr11	+	101785745	101871796	CEP126	86051	101783245	101788245
NM_152446	chr14	-	80962820	81405884	CEP128	443064	81403384	81408384
NM_001009811	chr17	-	79163392	79196789	CEP131	33397	79194289	79199289
NM_025009	chr4	+	56814973	56899529	CEP135	84556	56812473	56817473
NM_014985	chr15	-	49030134	49103343	CEP152	73209	49100843	49105843
NM_001286206	chr6	-	84833959	84937353	CEP162	103394	84934853	84939853
NM_001271933	chr11	+	117192493	117283982	CEP164	91489	117189993	117194993
NM_014812	chr1	-	243287729	243418708	CEP170	130979	243416208	243421208
NM_001112726	chr14	+	105331649	105363107	CEP170B	31458	105329149	105334149
NR_003135	chr4	+	119437494	119475359	CEP170P1	37865	119434994	119439994
NM_032898	chr3	-	196433147	196439165	CEP19	6018	196436665	196441665
NM_032142	chr18	+	12991360	13125051	CEP192	133691	12988860	12993860
NM_007186	chr20	+	34043222	34099804	CEP250	56582	34040722	34045722
NM_025114	chr12	-	88442789	88535993	CEP290	93204	88533493	88538493
NM_033395	chr11	+	93394815	93463522	CEP295	68707	93392315	93397315
NM_001243541	chr17	-	76886661	76899299	CEP295NL	12638	76896799	76901799
NM_014810	chr1	+	179923907	180084015	CEP350	160108	179921407	179926407
NR_046443	chr7	-	130033611	130081051	CEP41	47440	130078551	130083551
NM_001145314	chr4	+	175205054	175254531	CEP44	49477	175202554	175207554
NM_001127182	chr10	+	95256368	95288849	CEP55	32481	95253868	95258868
NM_001243776	chr11	+	95523624	95565857	CEP57	42233	95521124	95526124
NM_001271853	chr6	+	109415824	109488329	CEP57L1	72505	109413324	109418324
NM_001042384	chr3	+	134204565	134293855	CEP63	89290	134202065	134207065
NM_001319100	chr2	+	65283494	65314142	CEP68	30648	65280994	65285994
NM_001288967	chr3	-	138213180	138313225	CEP70	100045	138310725	138315725
NM_018140	chr5	+	612404	653666	CEP72	41262	609904	614904
NR_073537	chr18	-	12661954	12702776	CEP76	40822	12700276	12705276
NM_001349840	chr9	+	80850977	80893353	CEP78	42376	80848477	80853477
NM_001346457	chr12	-	94700169	94853764	CEP83	153595	94851264	94856264
NR_027035	chr12	+	94853778	94856344	CEP83-AS1	2566	94851278	94856278
NM_001281517	chr1	+	26560643	26605301	CEP85	44658	26558143	26563143
NM_001178035	chr6	-	118781934	119031238	CEP85L	249304	119028738	119033738
NM_032816	chr19	-	33369903	33462935	CEP89	93032	33460435	33465435
NM_001316990	chr17	+	62502853	62534069	CEP95	31216	62500353	62505353
NM_024548	chr3	+	101443436	101489406	CEP97	45970	101440936	101445936
NR_138485	chr1	+	111682004	111727726	CEPT1	45722	111679504	111684504
NM_005454	chr9	-	14719731	14722715	CER1	2984	14720215	14725215
NM_001286760	chr9	+	131181438	131199630	CERCAM	18192	131178938	131183938
NM_022766	chr22	-	47080306	47134152	CERK	53846	47131652	47136652
NR_027690	chr2	-	182401400	182521834	CERKL	120434	182519334	182524334
NR_102751	chr15	+	52472222	52498076	CERNA1	25854	52469722	52474722
NR_134505	chr10	-	85926983	85931832	CERNA2	4849	85929332	85934332
NM_021267	chr19	-	18979354	19006953	CERS1	27599	19004453	19009453
NM_022075	chr1	-	150937648	150947479	CERS2	9831	150944979	150949979
NM_001290343	chr15	-	100940599	101084925	CERS3	144326	101082425	101087425
NR_120374	chr15	+	100913143	100978119	CERS3-AS1	64976	100910643	100915643
NM_024552	chr19	+	8274216	8327304	CERS4	53088	8271716	8276716
NR_104035	chr12	-	50523088	50561316	CERS5	38228	50558816	50563816
NM_203463	chr2	+	169312758	169631644	CERS6	318886	169310258	169315258
NR_045787	chr2	-	169628460	169642939	CERS6-AS1	14479	169640439	169645439
NM_001266	chr16	-	55836763	55867075	CES1	30312	55864575	55869575
NR_003276	chr16	+	55794510	55808826	CES1P1	14316	55792010	55797010
NR_033740	chr16	+	55758836	55784123	CES1P2	25287	55756336	55761336
NM_003869	chr16	+	66968346	66978994	CES2	10648	66965846	66970846
NM_024922	chr16	+	66995131	67009052	CES3	13921	66992631	66997631
NM_173815	chr16	+	67022491	67043659	CES4A	21168	67019991	67024991
NM_001190158	chr16	-	55880065	55989943	CES5A	109878	55987443	55992443
NR_037839	chr22	-	23701792	23724313	CES5AP1	22521	23721813	23726813
NM_004344	chrX	-	151995870	151999301	CETN2	3431	151996801	152001801
NM_004365	chr5	-	89689151	89705603	CETN3	16452	89703103	89708103
NM_001286085	chr16	+	56995834	57017756	CETP	21922	56993334	56998334
NM_182628	chr3	+	126113781	126155398	CFAP100	41617	126111281	126116281
NM_001013625	chr1	-	161334520	161337673	CFAP126	3153	161335173	161340173
NR_145961	chr9	+	130469270	130476303	CFAP157	7033	130466770	130471770
NM_173528	chr15	+	81426587	81441516	CFAP161	14929	81424087	81429087
NR_136632	chr16	-	58147491	58163329	CFAP20	15838	58160829	58165829
NM_001031743	chr6	+	88117689	88174191	CFAP206	56502	88115189	88120189
NR_073132	chr2	+	120302007	120414237	CFAP221	112230	120299507	120304507
NM_001282761	chr2	+	55746730	55772216	CFAP36	25486	55744230	55749230
NM_025145	chr10	-	105889645	105992135	CFAP43	102490	105989635	105994635
NM_001164496	chr3	-	113005776	113160361	CFAP44	154585	113157861	113162861
NR_046728	chr3	+	113122844	113152839	CFAP44-AS1	29995	113120344	113125344
NM_012337	chr1	-	159842153	159869906	CFAP45	27753	159867406	159872406
NM_001200049	chr10	-	134621895	134756089	CFAP46	134194	134753589	134758589
NM_001304548	chrX	+	35937850	36403434	CFAP47	465584	35935350	35940350
NM_145054	chr17	+	9479943	9546776	CFAP52	66833	9477443	9482443
NM_145020	chr18	-	47753563	47792892	CFAP53	39329	47790392	47795392
NM_001306084	chr12	+	96883348	97269333	CFAP54	385985	96880848	96885848
NM_001195831	chr1	+	43638000	43720029	CFAP57	82029	43635500	43640500
NM_001008723	chr10	+	106113521	106214848	CFAP58	101327	106111021	106116021
NM_015585	chr20	+	20033157	20341346	CFAP61	308189	20030657	20035657
NM_194302	chr2	-	219867567	219906273	CFAP65	38706	219903773	219908773
NM_001039706	chr7	+	89874487	89940377	CFAP69	65890	89871987	89876987
NM_145170	chr10	-	75013515	75118617	CFAP70	105102	75116117	75121117
NM_001144872	chr12	+	113587662	113597081	CFAP73	9419	113585162	113590162
NM_001304360	chr1	-	1853389	1935276	CFAP74	81887	1932776	1937776
NM_001282957	chr9	+	135285582	135448706	CFAP77	163124	135283082	135288082
NM_020827	chr4	-	186080815	186125182	CFAP97	44367	186122682	186127682
NM_001193282	chr4	+	2420671	2464690	CFAP99	44019	2418171	2423171
NM_001710	chr6	+	31913720	31919861	CFB	6141	31911220	31916220
NM_001270421	chr2	-	131349737	131357148	CFC1	7411	131354648	131359648
NM_001079530	chr2	+	131278666	131285565	CFC1B	6899	131276166	131281166
NM_001928	chr19	+	859658	863569	CFD	3911	857158	862158
NM_006324	chr16	-	75327607	75467387	CFDP1	139780	75464887	75469887
NM_000186	chr1	+	196621007	196716634	CFH	95627	196618507	196623507
NM_002113	chr1	+	196788860	196801319	CFHR1	12459	196786360	196791360
NM_001312672	chr1	+	196912897	196928356	CFHR2	15459	196910397	196915397
NM_021023	chr1	+	196743929	196763203	CFHR3	19274	196741429	196746429
NM_001201551	chr1	+	196857143	196887843	CFHR4	30700	196854643	196859643
NM_030787	chr1	+	196946666	196978803	CFHR5	32137	196944166	196949166
NM_001318057	chr4	-	110661847	110723381	CFI	61534	110720881	110725881
NM_005507	chr11	-	65622284	65625804	CFL1	3520	65623304	65628304
NR_028492	chr10	+	89578069	89605369	CFL1P1	27300	89575569	89580569
NR_028131	chr14	-	35179587	35184029	CFL2	4442	35181529	35186529
NM_003879	chr2	+	201980826	202037411	CFLAR	56585	201978326	201983326
NR_040030	chr2	-	202005011	202022515	CFLAR-AS1	17504	202020015	202025015
NM_002621	chrX	-	47483611	47489704	CFP	6093	47487204	47492204
NM_000492	chr7	+	117120016	117308718	CFTR	188702	117117516	117122516
NM_001252383	chr6	-	87795215	87804865	CGA	9650	87802365	87807365
NM_001195308	chr3	-	88101099	88199016	CGGBP1	97917	88196516	88201516
NM_020770	chr1	+	151483861	151511167	CGN	27306	151481361	151486361
NM_032866	chr15	+	57668702	57842925	CGNL1	174223	57666202	57671202
NM_001166240	chr2	-	27322220	27341995	CGREF1	19775	27339495	27344495
NM_006568	chr14	+	54976586	55005334	CGRRF1	28748	54974086	54979086
NR_103768	chrX	-	153652722	153656825	CH17-340M24.3	4103	153654325	153659325
NM_001142776	chr15	+	41245346	41248717	CHAC1	3371	41242846	41247846
NM_001346127	chr2	+	53994919	54002333	CHAC2	7414	53992419	53997419
NM_001267	chr17	-	48541852	48546227	CHAD	4375	48543727	48548727
NM_138481	chr22	-	41625513	41636935	CHADL	11422	41634435	41639435
NM_005483	chr19	+	4402659	4443394	CHAF1A	40735	4400159	4405159
NM_005441	chr21	+	37757688	37789125	CHAF1B	31437	37755188	37760188
NM_001164144	chr13	+	115079809	115092803	CHAMP1	12994	115077309	115082309
NM_020984	chr10	+	50817140	50873150	CHAT	56010	50814640	50819640
NM_016139	chr7	-	56169254	56174323	CHCHD2	5069	56171823	56176823
NM_001317177	chr7	-	132469622	132766918	CHCHD3	297296	132764418	132769418
NM_144636	chr3	-	14153576	14166371	CHCHD4	12795	14163871	14168871
NM_032309	chr2	+	113342013	113346617	CHCHD5	4604	113339513	113344513
NM_032343	chr3	+	126423062	126679263	CHCHD6	256201	126420562	126425562
NM_001317858	chr8	+	57124196	57131357	CHCHD7	7161	57121696	57126696
NM_001270	chr5	-	98190907	98262238	CHD1	71331	98259738	98264738
NM_001348451	chr1	+	146644772	146767447	CHD1L	122675	146642272	146647272
NM_001271	chr15	+	93443550	93571237	CHD2	127687	93441050	93446050
NM_001005271	chr17	+	7788122	7816075	CHD3	27953	7785622	7790622
NM_001273	chr12	-	6679247	6716599	CHD4	37352	6714099	6719099
NM_015557	chr1	-	6161846	6240194	CHD5	78348	6237694	6242694
NM_032221	chr20	-	40030742	40247133	CHD6	216391	40244633	40249633
NM_017780	chr8	+	61591323	61780586	CHD7	189263	61588823	61593823
NM_020920	chr14	-	21853352	21905457	CHD8	52105	21902957	21907957
NM_025134	chr16	+	53088904	53361414	CHD9	272510	53086404	53091404
NM_018397	chr3	-	53850323	53880420	CHDH	30097	53877920	53882920
NM_001114121	chr11	+	125495030	125546150	CHEK1	51120	125492530	125497530
NM_001257387	chr22	-	29083730	29137822	CHEK2	54092	29135322	29140322
NR_038836	chr15	+	20487996	20496811	CHEK2P2	8815	20485496	20490496
NM_006387	chr19	-	16628699	16653263	CHERP	24564	16650763	16655763
NM_001161346	chr12	-	133416937	133464204	CHFR	47267	133461704	133466704
NM_001301690	chr14	+	93389444	93401641	CHGA	12197	93386944	93391944
NM_001819	chr20	+	5891973	5906005	CHGB	14032	5889473	5894473
NM_001276	chr1	-	203148058	203155922	CHI3L1	7864	203153422	203158422
NM_004000	chr1	+	111770280	111786062	CHI3L2	15782	111767780	111772780
NM_001258005	chr1	+	111833473	111863188	CHIA	29715	111830973	111835973
NR_003928	chr1	+	111823145	111828730	CHIAP2	5585	111820645	111825645
NM_001300884	chrX	+	72782983	72906944	CHIC1	123961	72780483	72785483
NM_012110	chr4	-	54875957	54930815	CHIC2	54858	54928315	54933315
NM_001142675	chr11	-	867858	915058	CHID1	47200	912558	917558
NR_045784	chr1	-	203185206	203198860	CHIT1	13654	203196360	203201360
NM_001277	chr11	-	67820325	67888858	CHKA	68533	67886358	67891358
NM_005198	chr22	-	51017386	51021428	CHKB	4042	51018928	51023928
NR_110536	chr22	+	51021454	51033710	CHKB-AS1	12256	51018954	51023954
NR_027928	chr22	-	51007289	51021428	CHKB-CPT1B	14139	51018928	51023928
NM_006614	chr3	+	238278	451097	CHL1	212819	235778	240778
NR_110739	chr3	-	405055	427478	CHL1-AS1	22423	424978	429978
NM_000390	chrX	-	85116184	85302569	CHM	186385	85300069	85305069
NM_001821	chr1	-	241792166	241799232	CHML	7066	241796732	241801732
NM_002768	chr16	-	89710838	89724193	CHMP1A	13355	89721693	89726693
NM_020412	chr18	+	11851388	11854448	CHMP1B	3060	11848888	11853888
NR_110646	chrX	-	79483987	79590817	CHMP1B2P	106830	79588317	79593317
NM_014453	chr19	-	59062932	59066491	CHMP2A	3559	59063991	59068991
NM_001244644	chr3	+	87276412	87304698	CHMP2B	28286	87273912	87278912
NM_016079	chr2	-	86730552	86790620	CHMP3	60068	86788120	86793120
NM_014169	chr14	-	24678786	24683036	CHMP4A	4250	24680536	24685536
NM_176812	chr20	+	32399109	32442173	CHMP4B	43064	32396609	32401609
NM_152284	chr8	+	82644687	82671748	CHMP4C	27061	82642187	82647187
NM_016410	chr9	+	33264876	33282067	CHMP5	17191	33262376	33267376
NM_024591	chr17	+	78965640	78973933	CHMP6	8293	78963140	78968140
NM_152272	chr8	+	23101149	23119513	CHMP7	18364	23098649	23103649
NM_001025201	chr2	-	175664041	175870107	CHN1	206066	175867607	175872607
NM_001293069	chr7	+	29186162	29553951	CHN2	367789	29183662	29188662
NM_001204178	chr21	+	19289656	19639687	CHODL	350031	19287156	19292156
NR_024354	chr21	-	19207988	19257925	CHODL-AS1	49937	19255425	19260425
NM_012124	chr11	-	89933596	89956532	CHORDC1	22936	89954032	89959032
NM_007236	chr15	+	41523436	41574083	CHP1	50647	41520936	41525936
NM_022097	chr16	+	23765947	23770272	CHP2	4325	23763447	23768447
NM_024536	chr2	-	220403668	220408487	CHPF	4819	220405987	220410987
NM_001284295	chr7	+	150929574	150935913	CHPF2	6339	150927074	150932074
NM_020244	chr12	+	102091416	102122846	CHPT1	31430	102088916	102093916
NM_017444	chr8	+	141521396	141527252	CHRAC1	5856	141518896	141523896
NR_130747	chr3	+	184097860	184107623	CHRD	9763	184095360	184100360
NM_001143983	chrX	-	109917083	110039286	CHRDL1	122203	110036786	110041786
NM_015424	chr11	-	74407472	74442430	CHRDL2	34958	74439930	74444930
NM_148911	chr15	-	30653442	30685864	CHRFAM7A	32422	30683364	30688364
NM_000738	chr11	-	62676150	62689012	CHRM1	12862	62686512	62691512
NM_001006627	chr7	+	136553398	136701771	CHRM2	148373	136550898	136555898
NM_001347716	chr1	+	239550229	240078749	CHRM3	528520	239547729	239552729
NR_103776	chr1	-	239870425	239882419	CHRM3-AS2	11994	239879919	239884919
NM_001320917	chr15	+	34260514	34357295	CHRM5	96781	34258014	34263014
NM_001039523	chr2	-	175612322	175629200	CHRNA1	16878	175626700	175631700
NM_020402	chr11	-	3686816	3692614	CHRNA10	5798	3690114	3695114
NM_001282455	chr8	-	27317277	27336813	CHRNA2	19536	27334313	27339313
NR_046313	chr15	-	78885394	78913637	CHRNA3	28243	78911137	78916137
NM_001256573	chr20	-	61974661	61992748	CHRNA4	18087	61990248	61995248
NM_001307945	chr15	+	78857861	78887611	CHRNA5	29750	78855361	78860361
NM_001199279	chr8	-	42607779	42623929	CHRNA6	16150	42621429	42626429
NM_001190455	chr15	+	32322685	32462384	CHRNA7	139699	32320185	32325185
NM_017581	chr4	+	40337345	40357234	CHRNA9	19889	40334845	40339845
NM_000747	chr17	+	7348405	7360932	CHRNB1	12527	7345905	7350905
NM_000748	chr1	+	154540256	154552353	CHRNB2	12097	154537756	154542756
NM_001347717	chr8	+	42552518	42592550	CHRNB3	40032	42550018	42555018
NM_000750	chr15	-	78916635	78933587	CHRNB4	16952	78931087	78936087
NM_000751	chr2	+	233390869	233401375	CHRND	10506	233388369	233393369
NM_000080	chr17	-	4801063	4806369	CHRNE	5306	4803869	4808869
NM_005199	chr2	+	233404436	233411038	CHRNG	6602	233401936	233406936
NM_003654	chr11	-	45669238	45687206	CHST1	17968	45684706	45689706
NM_004854	chr2	-	101008321	101034130	CHST10	25809	101031630	101036630
NM_001173982	chr12	+	104850691	105155792	CHST11	305101	104848191	104853191
NM_018641	chr7	+	2443194	2474216	CHST12	31022	2440694	2445694
NM_152889	chr3	+	126243130	126262134	CHST13	19004	126240630	126245630
NM_001270764	chr10	-	125767181	125853123	CHST15	85942	125850623	125855623
NM_004267	chr3	+	142838617	142842856	CHST2	4239	142836117	142841117
NM_004273	chr10	+	73724119	73773322	CHST3	49203	73721619	73726619
NM_005769	chr16	+	71560022	71572493	CHST4	12471	71557522	71562522
NM_024533	chr16	-	75562427	75569068	CHST5	6641	75566568	75571568
NM_021615	chr16	-	75507021	75528926	CHST6	21905	75526426	75531426
NM_019886	chrX	+	46433121	46457931	CHST7	24810	46430621	46435621
NM_001127895	chr19	+	34112860	34264414	CHST8	151554	34110360	34115360
NM_001256316	chr18	-	24495594	24765302	CHST9	269708	24762802	24767802
NM_014918	chr15	-	101715927	101792137	CHSY1	76210	101789637	101794637
NM_175856	chr5	+	129240522	129522327	CHSY3	281805	129238022	129243022
NM_022092	chr16	+	838621	848074	CHTF18	9453	836121	841121
NM_001039690	chr16	-	69151911	69166493	CHTF8	14582	69163993	69168993
NM_001244664	chr1	+	153606457	153618782	CHTOP	12325	153603957	153608957
NM_001278	chr10	-	101948054	101989367	CHUK	41313	101986867	101991867
NM_145165	chr14	+	65381078	65402084	CHURC1	21006	65378578	65383578
NM_001202559	chr14	+	65381078	65529373	CHURC1-FNTB	148295	65378578	65383578
NM_004804	chr2	+	96931883	96939900	CIAO1	8017	96929383	96934383
NM_001308347	chr16	-	57462080	57481440	CIAPIN1	19360	57478940	57483940
NM_001300839	chr1	+	150254942	150259504	CIART	4562	150252442	150257442
NR_102428	chr15	-	90773476	90808991	CIB1	35515	90806491	90811491
NM_001301224	chr15	-	78396947	78423877	CIB2	26930	78421377	78426377
NM_054113	chr19	-	16272178	16284336	CIB3	12158	16281836	16286836
NM_001029881	chr2	-	26804069	26864236	CIB4	60167	26861736	26866736
NM_001304815	chr19	+	42772688	42799948	CIC	27260	42770188	42775188
NM_001279	chr18	+	12254317	12277594	CIDEA	23277	12251817	12256817
NM_001318807	chr14	-	24774398	24780583	CIDEB	6185	24778083	24783083
NM_001199551	chr3	-	9908393	9921938	CIDEC	13545	9919438	9924438
NR_002786	chr3	-	10059236	10067820	CIDECP	8584	10065320	10070320
NM_001286402	chr16	+	10971054	11018840	CIITA	47786	10968554	10973554
NM_003613	chr15	-	65488336	65503840	CILP	15504	65501340	65506340
NM_153221	chr19	+	19649073	19657468	CILP2	8395	19646573	19651573
NM_032630	chr14	-	102814618	102829253	CINP	14635	102826753	102831753
NM_020890	chr3	-	108268717	108308491	CIP2A	39774	108305991	108310991
NM_033426	chr14	+	77564577	77583630	CIPC	19053	77562077	77567077
NM_004882	chr2	-	175212877	175260443	CIR1	47566	175257943	175262943
NM_001300815	chr19	+	1269264	1274808	CIRBP	5544	1266764	1271764
NR_027271	chr19	-	1267469	1270259	CIRBP-AS1	2790	1267759	1272759
NM_018464	chr10	+	60028861	60049019	CISD1	20158	60026361	60031361
NM_001008388	chr4	+	103790134	103813963	CISD2	23829	103787634	103792634
NM_001136498	chr17	+	36886509	36891858	CISD3	5349	36884009	36889009
NM_013324	chr3	-	50643884	50649262	CISH	5378	50646762	50651762
NR_104332	chr12	-	54144230	54150818	CISTR	6588	54148318	54153318
NM_007174	chr12	-	120123594	120315095	CIT	191501	120312595	120317595
NM_001144886	chrX	-	71521487	71527037	CITED1	5550	71524537	71529537
NM_001131015	chr9	-	130928343	130966662	CIZ1	38319	130964162	130969162
NM_018204	chr13	+	53029494	53050766	CKAP2	21272	53026994	53031994
NM_001304361	chr2	-	113493926	113522254	CKAP2L	28328	113519754	113524754
NM_006825	chr12	-	106631658	106641713	CKAP4	10055	106639213	106644213
NM_014756	chr11	-	46765083	46867859	CKAP5	102776	46865359	46870359
NM_001823	chr14	-	103985994	103989196	CKB	3202	103986696	103991696
NM_181640	chr16	+	66586465	66600190	CKLF	13725	66583965	66588965
NM_001204098	chr16	+	66586465	66613038	CKLF-CMTM1	26573	66583965	66588965
NM_001824	chr19	-	45809670	45826235	CKM	16565	45823735	45828735
NM_001321927	chr15	+	43984983	43991420	CKMT1A	6437	43982483	43987483
NM_020990	chr15	+	43885054	43891604	CKMT1B	6550	43882554	43887554
NM_001099736	chr5	+	80529138	80562217	CKMT2	33079	80526638	80531638
NR_034122	chr5	-	80533383	80597388	CKMT2-AS1	64005	80594888	80599888
NR_024163	chr1	+	154947117	154951725	CKS1B	4608	154944617	154949617
NM_001827	chr9	+	91926109	91931618	CKS2	5509	91923609	91928609
NM_001207051	chr2	-	122095351	122407052	CLASP1	311701	122404552	122409552
NM_015097	chr3	-	33537738	33759705	CLASP2	221967	33757205	33762205
NM_007056	chr19	+	45542297	45574214	CLASRP	31917	45539797	45544797
NM_174891	chr14	+	105452615	105461855	CLBA1	9240	105450115	105455115
NM_001828	chr19	-	40221892	40228669	CLC	6777	40226169	40231169
NM_001285	chr1	+	86934525	86965974	CLCA1	31449	86932025	86937025
NM_006536	chr1	+	86889565	86922240	CLCA2	32675	86887065	86892065
NR_024604	chr1	+	87099958	87121059	CLCA3P	21101	87097458	87102458
NR_024602	chr1	+	87012758	87046432	CLCA4	33674	87010258	87015258
NM_015127	chr1	-	109472129	109506121	CLCC1	33992	109503621	109508621
NM_001166212	chr11	-	67131638	67141648	CLCF1	10010	67139148	67144148
NM_000083	chr7	+	143013218	143049097	CLCN1	35879	143010718	143015718
NM_004366	chr3	-	184063972	184079439	CLCN2	15467	184076939	184081939
NM_001829	chr4	+	170541671	170644338	CLCN3	102667	170539171	170544171
NM_001256944	chrX	+	10124984	10205699	CLCN4	80715	10122484	10127484
NM_001127899	chrX	+	49687224	49863892	CLCN5	176668	49684724	49689724
NM_001286	chr1	+	11866152	11903201	CLCN6	37049	11863652	11868652
NM_001287	chr16	-	1494933	1525085	CLCN7	30152	1522585	1527585
NM_001042704	chr1	+	16348485	16360545	CLCNKA	12060	16345985	16350985
NM_000085	chr1	+	16370230	16383821	CLCNKB	13591	16367730	16372730
NM_021101	chr3	-	190023489	190040235	CLDN1	16746	190037735	190042735
NM_001160100	chr13	+	96085852	96232010	CLDN10	146158	96083352	96088352
NR_046533	chr13	-	96131697	96186164	CLDN10-AS1	54467	96183664	96188664
NM_005602	chr3	+	170136652	170152479	CLDN11	15827	170134152	170139152
NM_001185073	chr7	+	90032647	90045268	CLDN12	12621	90030147	90035147
NM_001146077	chr21	-	37832919	37948867	CLDN14	115948	37946367	37951367
NM_001185080	chr7	-	100875372	100882101	CLDN15	6729	100879601	100884601
NM_006580	chr3	+	190105660	190129932	CLDN16	24272	190103160	190108160
NM_001002026	chr3	+	137717657	137752494	CLDN18	34837	137715157	137720157
NM_148960	chr1	-	43198763	43205925	CLDN19	7162	43203425	43208425
NM_001171092	chrX	+	106143393	106174091	CLDN2	30698	106140893	106145893
NM_001001346	chr6	+	155585146	155597682	CLDN20	12536	155582646	155587646
NM_001111319	chr4	-	184239219	184241927	CLDN22	2708	184239427	184244427
NM_021195	chr16	-	3064712	3068188	CLDN6	3476	3065688	3070688
NM_001185022	chr17	-	7163221	7166512	CLDN7	3291	7164012	7169012
NM_019895	chr3	-	98234316	98241910	CLDND1	7594	98239410	98244410
NM_182906	chr17	-	6977855	6983626	CLEC10A	5771	6981126	6986126
NM_001207010	chr12	+	10103914	10138194	CLEC12A	34280	10101414	10106414
NR_135047	chr12	-	10100735	10105936	CLEC12A-AS1	5201	10103436	10108436
NM_001129998	chr12	+	10163225	10171399	CLEC12B	8174	10160725	10165725
NM_015226	chr16	+	11038344	11276046	CLEC16A	237702	11035844	11040844
NR_109784	chr19	+	14693895	14721956	CLEC17A	28061	14691395	14696395
NM_001136214	chr16	+	69984607	69998250	CLEC18A	13643	69982107	69987107
NM_001011880	chr16	-	74442528	74455368	CLEC18B	12840	74452868	74457868
NM_173619	chr16	+	70208075	70220798	CLEC18C	12723	70205575	70210575
NM_001256720	chr16	+	19297104	19322269	CLEC19A	25165	19294604	19299604
NM_001297748	chr12	-	10222152	10251664	CLEC1A	29512	10249164	10254164
NM_016509	chr12	-	10145661	10151899	CLEC1B	6238	10149399	10154399
NM_207375	chr12	-	10051271	10084980	CLEC2A	33709	10082480	10087480
NM_005127	chr12	-	10004967	10022458	CLEC2B	17491	10019958	10024958
NM_001197319	chr12	+	9822303	9852151	CLEC2D	29848	9819803	9824803
NM_001080511	chr7	+	139208673	139229737	CLEC2L	21064	139206173	139211173
NM_005752	chr16	+	78056442	78066001	CLEC3A	9559	78053942	78058942
NM_003278	chr3	+	45067758	45077563	CLEC3B	9805	45065258	45070258
NM_194448	chr12	+	8276227	8291203	CLEC4A	14976	8273727	8278727
NM_130441	chr12	-	7882010	7902069	CLEC4C	20059	7899569	7904569
NM_080387	chr12	+	8666135	8674960	CLEC4D	8825	8663635	8668635
NM_014358	chr12	-	8685900	8693558	CLEC4E	7658	8691058	8696058
NM_001321308	chr2	-	71035775	71047732	CLEC4F	11957	71045232	71050232
NM_001244856	chr19	-	7793842	7797057	CLEC4G	3215	7794557	7799557
NR_002931	chr19	+	7852369	7855898	CLEC4GP1	3529	7849869	7854869
NM_001144907	chr19	+	7828034	7834491	CLEC4M	6457	7825534	7830534
NM_001301167	chr7	-	141627156	141646807	CLEC5A	19651	141644307	141649307
NM_001317999	chr12	+	8608590	8630926	CLEC6A	22336	8606090	8611090
NR_125336	chr12	-	10269375	10282868	CLEC7A	13493	10280368	10285368
NM_207345	chr12	+	10183275	10218629	CLEC9A	35354	10180775	10185775
NM_001267701	chr12	-	9868455	9885895	CLECL1	17440	9883395	9888395
NM_004362	chr4	-	141309606	141348815	CLGN	39209	141346315	141351315
NM_001135598	chr2	-	55399686	55459699	CLHC1	60013	55457199	55462199
NM_001287593	chr6_qbl_hap6	-	2991987	2998733	CLIC1	6746	2996233	3001233
NM_001289	chrX	-	154505495	154563990	CLIC2	58495	154561490	154566490
NM_013943	chr1	+	25071759	25170815	CLIC4	99056	25069259	25074259
NM_001114086	chr6	-	45866189	46048085	CLIC5	181896	46045585	46050585
NM_001317009	chr21	+	36041461	36090525	CLIC6	49064	36038961	36043961
NM_014666	chr5	-	157212750	157286183	CLINT1	73433	157283683	157288683
NM_002956	chr12	-	122755980	122907116	CLIP1	151136	122904616	122909616
NR_045382	chr12	+	122880088	122884491	CLIP1-AS1	4403	122877588	122882588
NM_032421	chr7	+	73703804	73820273	CLIP2	116469	73701304	73706304
NM_015526	chr19	-	36505561	36523797	CLIP3	18236	36521297	36526297
NM_001287528	chr2	+	29320541	29397581	CLIP4	77040	29318041	29323041
NR_027856	chr2	-	201717731	201729467	CLK1	11736	201726967	201731967
NM_003993	chr1	-	155232658	155243320	CLK2	10662	155240820	155245820
NM_003992	chr15	+	74900712	74922542	CLK3	21830	74898212	74903212
NM_020666	chr5	-	178029664	178054054	CLK4	24390	178051554	178056554
NR_027933	chr12	+	92815306	92824778	CLLU1	9472	92812806	92817806
NR_144319	chr12	-	92813878	92826775	CLLU1OS	12897	92824275	92829275
NR_109873	chr5	+	151056505	151067468	CLMAT3	10963	151054005	151059005
NM_024734	chr14	-	95648275	95786245	CLMN	137970	95783745	95788745
NM_024769	chr11	-	122942713	123066013	CLMP	123300	123063513	123068513
NM_001286109	chr16	-	28477973	28503403	CLN3	25430	28500903	28505903
NM_006493	chr13	+	77566058	77576652	CLN5	10594	77563558	77568558
NM_017882	chr15	-	68499329	68522080	CLN6	22751	68519580	68524580
NM_018941	chr8	+	1711869	1734736	CLN8	22867	1709369	1714369
NM_052964	chr4	-	10488028	10686489	CLNK	198461	10683989	10688989
NM_001311201	chr11	-	77327195	77348851	CLNS1A	21656	77346351	77351351
NM_004898	chr4	-	56294067	56413076	CLOCK	119009	56410576	56415576
NM_006831	chr11	+	57425215	57429337	CLP1	4122	57422715	57427715
NM_001258394	chr11	-	72003469	72145728	CLPB	142259	72143228	72148228
NM_006012	chr19	+	6361462	6368915	CLPP	7453	6358962	6363962
NM_001348773	chr6	+	35748793	35761763	CLPSL1	12970	35746293	35751293
NR_104469	chr6	+	35744370	35747329	CLPSL2	2959	35741870	35746870
NM_001282176	chr19	+	45457841	45496604	CLPTM1	38763	45455341	45460341
NM_030782	chr5	-	1317858	1345185	CLPTM1L	27327	1342685	1347685
NR_133680	chr15	-	65440557	65477758	CLPX	37201	65475258	65480258
NM_001195794	chr3	-	150644353	150690786	CLRN1	46433	150688286	150693286
NR_024066	chr3	+	150690464	150798513	CLRN1-AS1	108049	150687964	150692964
NM_001079827	chr4	+	17516787	17528727	CLRN2	11940	17514287	17519287
NM_152311	chr10	-	129676104	129691211	CLRN3	15107	129688711	129693711
NM_001330490	chr1	-	36185818	36235551	CLSPN	49733	36233051	36238051
NM_001302883	chr1	-	9789078	9884584	CLSTN1	95506	9882084	9887084
NM_022131	chr3	+	139654026	140286919	CLSTN2	632893	139651526	139656526
NR_108084	chr3	-	140224459	140227631	CLSTN2-AS1	3172	140225131	140230131
NM_014718	chr12	+	7282966	7311530	CLSTN3	28564	7280466	7285466
NM_001311203	chr9	+	36190852	36212059	CLTA	21207	36188352	36193352
NR_045724	chr5	-	175819455	175843570	CLTB	24115	175841070	175846070
NM_001288653	chr17	+	57697049	57774317	CLTC	77268	57694549	57699549
NM_001835	chr22	-	19166986	19279239	CLTCL1	112253	19276739	19281739
NM_001831	chr8	-	27454433	27472328	CLU	17895	27469828	27474828
NM_001330454	chr16	+	3550930	3589051	CLUAP1	38121	3548430	3553430
NM_015229	chr17	-	2592679	2614927	CLUH	22248	2612427	2617427
NR_024034	chr16	+	31711933	31718745	CLUHP3	6812	31709433	31714433
NM_001289036	chr18	+	596997	650293	CLUL1	53296	594497	599497
NM_173519	chr8	+	62200524	62414204	CLVS1	213680	62198024	62203024
NM_001010852	chr6	+	123317115	123394064	CLVS2	76949	123314615	123319615
NR_104592	chr13	+	100258917	100561713	CLYBL	302796	100256417	100261417
NR_120383	chr13	-	100377923	100381255	CLYBL-AS1	3332	100378755	100383755
NM_001308083	chr14	-	24974560	24977471	CMA1	2911	24974971	24979971
NR_002174	chr6	-	25081294	25138051	CMAHP	56757	25135551	25140551
NM_018686	chr12	+	22199107	22218606	CMAS	19499	22196607	22201607
NM_138809	chr5	-	10277706	10308168	CMBL	30462	10305668	10310668
NM_182523	chr3	+	28283123	28361263	CMC1	78140	28280623	28285623
NM_001351967	chr16	-	81009691	81040524	CMC2	30833	81038024	81043024
NM_001018024	chrX	-	154289899	154299547	CMC4	9648	154297047	154302047
NM_198390	chr16	+	81478774	81745367	CMIP	266593	81476274	81481274
NM_001142343	chr12	-	108681820	108733094	CMKLR1	51274	108730594	108735594
NR_046394	chr1	+	47799468	47844511	CMPK1	45043	47796968	47801968
NM_001256478	chr2	-	6980683	7005950	CMPK2	25267	7003450	7008450
NM_032359	chr3	+	99536677	99897476	CMSS1	360799	99534177	99539177
NM_181269	chr16	+	66600293	66613038	CMTM1	12745	66597793	66602793
NM_001199317	chr16	+	66613350	66622177	CMTM2	8827	66610850	66615850
NR_037613	chr16	+	66637934	66647795	CMTM3	9861	66635434	66640434
NM_181521	chr16	-	66648652	66730610	CMTM4	81958	66728110	66733110
NM_001288745	chr14	+	23846016	23848981	CMTM5	2965	23843516	23848516
NM_017801	chr3	-	32522803	32544403	CMTM6	21600	32541903	32546903
NM_181472	chr3	+	32433162	32497020	CMTM7	63858	32430662	32435662
NM_001320308	chr3	+	32280170	32411817	CMTM8	131647	32277670	32282670
NM_015050	chr6	+	37400906	37449284	CMTR1	48378	37398406	37403406
NM_001324377	chr16	-	71316202	71323618	CMTR2	7416	71321118	71326118
NM_153610	chr5	+	78985658	79096049	CMYA5	110391	78983158	78988158
NM_173538	chr8	+	87878675	88394955	CNBD1	516280	87876175	87881175
NM_001207076	chr20	+	34556502	34618622	CNBD2	62120	34554002	34559002
NM_003418	chr3	-	128886657	128902810	CNBP	16153	128900310	128905310
NM_032649	chr18	+	72201691	72252261	CNDP1	50570	72199191	72204191
NM_018235	chr18	+	72163499	72190689	CNDP2	27190	72160999	72165999
NM_153261	chr16	+	50059116	50070999	CNEP1R1	11883	50056616	50061616
NM_032488	chr19	-	42891170	42894444	CNFN	3274	42891944	42896944
NM_000087	chr4	-	47937993	48014961	CNGA1	76968	48012461	48017461
NM_005140	chrX	+	150903217	150914036	CNGA2	10819	150900717	150905717
NM_001298	chr2	+	98962617	99015064	CNGA3	52447	98960117	98965117
NM_001037329	chr11	+	6260321	6265707	CNGA4	5386	6257821	6262821
NM_001297	chr16	-	57916243	58005020	CNGB1	88777	58002520	58007520
NM_019098	chr8	-	87586162	87755903	CNGB3	169741	87753403	87758403
NM_005776	chr14	-	54893646	54908148	CNIH1	14502	54905648	54910648
NM_182553	chr11	+	66045671	66051685	CNIH2	6014	66043171	66048171
NR_136288	chr1	+	224622341	224928251	CNIH3	305910	224619841	224624841
NM_001277200	chr1	+	224544512	224567153	CNIH4	22641	224542012	224547012
NM_001297648	chr1	+	26503980	26516376	CNKSR1	12396	26501480	26506480
NM_014927	chrX	+	21392415	21672813	CNKSR2	280398	21389915	21394915
NM_173515	chr6	-	154726432	154831793	CNKSR3	105361	154829293	154834293
NM_007015	chr13	-	53277399	53313947	CNMD	36548	53311447	53316447
NM_001308342	chr19	+	11649531	11661138	CNN1	11607	11647031	11652031
NM_001303499	chr19	+	1026273	1039067	CNN2	12794	1023773	1028773
NM_001839	chr1	-	95362504	95392779	CNN3	30275	95390279	95395279
NM_020348	chr10	+	101088855	101154087	CNNM1	65232	101086355	101091355
NM_017649	chr10	+	104678074	104838344	CNNM2	160270	104675574	104680574
NM_017623	chr2	+	97481990	97501121	CNNM3	19131	97479490	97484490
NM_020184	chr2	+	97426638	97477628	CNNM4	50990	97424138	97429138
NM_001265612	chr16	-	58553849	58663790	CNOT1	109941	58661290	58666290
NR_046352	chr3	+	32726636	32815367	CNOT10	88731	32724136	32729136
NM_017546	chr2	+	101869344	101886778	CNOT11	17434	101866844	101871844
NM_014515	chr12	+	70636773	70748773	CNOT2	112000	70634273	70639273
NM_014516	chr19	+	54641435	54659446	CNOT3	18011	54638935	54643935
NM_013316	chr7	-	135046546	135194875	CNOT4	148329	135192375	135197375
NM_001303241	chr5	+	179921398	180005405	CNOT6	84007	179918898	179923898
NM_001286790	chr4	-	78634540	78740544	CNOT6L	106004	78738044	78743044
NM_001322093	chr8	-	17086737	17104418	CNOT7	17681	17101918	17106918
NM_001301083	chr5	+	154237808	154256352	CNOT8	18544	154235308	154240308
NM_001271634	chr2	+	219433302	219461158	CNOT9	27856	219430802	219435802
NM_033133	chr17	+	40118758	40129754	CNP	10996	40116258	40121258
NM_001321390	chr2	-	220036618	220042896	CNPPD1	6278	220040396	220045396
NM_001103176	chr7	-	155293952	155326539	CNPY1	32587	155324039	155329039
NM_014255	chr12	-	56703625	56710132	CNPY2	6507	56707632	56712632
NR_134881	chr6	+	42895739	42907025	CNPY3	11286	42893239	42898239
NM_001318856	chr6	+	42896867	42931618	CNPY3-GNMT	34751	42894367	42899367
NM_152755	chr7	+	99717264	99723128	CNPY4	5864	99714764	99719764
NM_001160258	chr6	-	88849584	88875767	CNR1	26183	88873267	88878267
NM_001841	chr1	-	24200459	24239817	CNR2	39358	24237317	24242317
NM_001111101	chr2	-	68511302	68547183	CNRIP1	35881	68544683	68549683
NM_152609	chr1	+	246729638	246831884	CNST	102246	246727138	246732138
NM_173478	chr17	+	40950853	40963605	CNTD1	12752	40948353	40953353
NM_024877	chr19	-	40728114	40732597	CNTD2	4483	40730097	40735097
NM_000614	chr11	+	58390145	58393205	CNTF	3060	58387645	58392645
NM_001207011	chr9	-	34551429	34590138	CNTFR	38709	34587638	34592638
NR_024369	chr9	+	34568009	34583070	CNTFR-AS1	15061	34565509	34570509
NM_017738	chr9	+	17134988	17503921	CNTLN	368933	17132488	17137488
NM_001843	chr12	+	41086243	41466213	CNTN1	379970	41083743	41088743
NM_001346083	chr1	+	205012064	205047400	CNTN2	35336	205009564	205014564
NM_020872	chr3	-	74311719	74570291	CNTN3	258572	74567791	74572791
NM_001350095	chr3	+	2140486	3099645	CNTN4	959159	2137986	2142986
NR_046554	chr3	-	3081344	3102829	CNTN4-AS1	21485	3100329	3105329
NR_046555	chr3	-	2152092	2185925	CNTN4-AS2	33833	2183425	2188425
NM_014361	chr11	+	98891705	100229616	CNTN5	1337911	98889205	98894205
NM_001349352	chr3	+	1134341	1445292	CNTN6	310951	1131841	1136841
NM_003632	chr17	+	40834631	40852011	CNTNAP1	17380	40832131	40837131
NM_014141	chr7	+	145813452	148118088	CNTNAP2	2304636	145810952	145815952
NM_033655	chr9	-	39072763	39288300	CNTNAP3	215537	39285800	39290800
NM_001201380	chr9	+	43684884	43922473	CNTNAP3B	237589	43682384	43687384
NR_111893	chr9	+	43685195	43924057	CNTNAP3P2	238862	43682695	43687695
NM_001322179	chr16	+	76311114	76594647	CNTNAP4	283533	76308614	76313614
NM_130773	chr2	+	124782863	125672954	CNTNAP5	890091	124780363	124785363
NM_007018	chr9	+	123850573	123939886	CNTRL	89313	123848073	123853073
NM_001353203	chr17	+	7835398	7853237	CNTROB	17839	7832898	7837898
NR_135580	chr7	-	43648054	43769140	COA1	121086	43766640	43771640
NM_016565	chr11	-	73583712	73587890	COA4	4178	73585390	73590390
NM_001008215	chr2	-	99215785	99224981	COA5	9196	99222481	99227481
NM_001206641	chr1	+	234509182	234519795	COA6	10613	234506682	234511682
NM_023077	chr1	-	53152013	53164038	COA7	12025	53161538	53166538
NM_025233	chr17	+	40714091	40718299	COASY	4208	40711591	40716591
NM_001346443	chr7	-	51083908	51384558	COBL	300650	51382058	51387058
NM_001278460	chr2	-	165536694	165698678	COBLL1	161984	165696178	165701178
NM_001135058	chr14	+	31343740	31359822	COCH	16082	31341240	31346240
NM_018714	chr17	+	71189172	71204645	COG1	15473	71186672	71191672
NM_001145036	chr1	+	230778201	230829731	COG2	51530	230775701	230780701
NM_031431	chr13	+	46039029	46110833	COG3	71804	46036529	46041529
NM_015386	chr16	-	70514471	70557457	COG4	42986	70554957	70559957
NM_181733	chr7	-	106842188	107204959	COG5	362771	107202459	107207459
NM_001145079	chr13	+	40229763	40365802	COG6	136039	40227263	40232263
NM_153603	chr16	-	23399813	23464512	COG7	64699	23462012	23467012
NM_032382	chr16	-	69362523	69373526	COG8	11003	69371026	69376026
NM_004645	chr17	-	55015560	55038411	COIL	22851	55035911	55040911
NM_000493	chr6	-	116440084	116447296	COL10A1	7212	116444796	116449796
NM_080630	chr1	-	103342022	103574052	COL11A1	232030	103571552	103576552
NM_080681	chr6	-	33130468	33160245	COL11A2	29777	33157745	33162745
NM_080645	chr6	-	75794041	75915623	COL12A1	121582	75913123	75918123
NM_080805	chr10	+	71561643	71718904	COL13A1	157261	71559143	71564143
NM_021110	chr8	+	121137346	121385814	COL14A1	248468	121134846	121139846
NM_001855	chr9	+	101705994	101833074	COL15A1	127080	101703494	101708494
NM_001856	chr1	-	32117847	32169768	COL16A1	51921	32167268	32172268
NM_000494	chr10	-	105791045	105845638	COL17A1	54593	105843138	105848138
NM_130445	chr21	+	46825051	46933634	COL18A1	108583	46822551	46827551
NR_027498	chr21	-	46839630	46844985	COL18A1-AS1	5355	46842485	46847485
NR_052004	chr21	-	46827300	46829980	COL18A1-AS2	2680	46827480	46832480
NM_001858	chr6	+	70576447	70922157	COL19A1	345710	70573947	70578947
NM_000088	chr17	-	48261456	48279000	COL1A1	17544	48276500	48281500
NM_000089	chr7	+	94023872	94060544	COL1A2	36672	94021372	94026372
NR_147206	chr7	-	93996523	94021504	COL1A2-AS1	24981	94019004	94024004
NM_020882	chr20	+	61924537	61962285	COL20A1	37748	61922037	61927037
NM_001318752	chr6	-	55921387	56258926	COL21A1	337539	56256426	56261426
NM_152888	chr8	-	139600477	139926249	COL22A1	325772	139923749	139928749
NM_173465	chr5	-	177664616	178017556	COL23A1	352940	178015056	178020056
NR_146340	chr1	-	86194915	86622719	COL24A1	427804	86620219	86625219
NM_198721	chr4	-	109731876	110223799	COL25A1	491923	110221299	110226299
NM_001278563	chr7	+	101006100	101202304	COL26A1	196204	101003600	101008600
NM_032888	chr9	+	116917824	117074796	COL27A1	156972	116915324	116920324
NM_001037763	chr7	-	7398243	7575460	COL28A1	177217	7572960	7577960
NM_033150	chr12	-	48366747	48398285	COL2A1	31538	48395785	48400785
NM_000090	chr2	+	189839098	189877472	COL3A1	38374	189836598	189841598
NM_001845	chr13	-	110801304	110959504	COL4A1	158200	110957004	110962004
NM_001846	chr13	+	110959613	111165556	COL4A2	205943	110957113	110962113
NR_046583	chr13	-	111154922	111160526	COL4A2-AS1	5604	111158026	111163026
NM_001267044	chr13	-	111108743	111115634	COL4A2-AS2	6891	111113134	111118134
NM_000091	chr2	+	228029280	228179508	COL4A3	150228	228026780	228031780
NM_001130105	chr5	-	74666927	74807806	COL4A3BP	140879	74805306	74810306
NM_000092	chr2	-	227867426	228029275	COL4A4	161849	228026775	228031775
NM_033380	chrX	+	107683073	107940775	COL4A5	257702	107680573	107685573
NM_001847	chrX	-	107398836	107682727	COL4A6	283891	107680227	107685227
NM_001278074	chr9	+	137533650	137736688	COL5A1	203038	137531150	137536150
NR_138049	chr9	-	137541230	137544689	COL5A1-AS1	3459	137542189	137547189
NM_000393	chr2	-	189896640	190044605	COL5A2	147965	190042105	190047105
NM_015719	chr19	-	10070236	10121147	COL5A3	50911	10118647	10123647
NM_001848	chr21	+	47401662	47424963	COL6A1	23301	47399162	47404162
NM_001849	chr21	+	47518032	47552763	COL6A2	34731	47515532	47520532
NM_004369	chr2	-	238232654	238322850	COL6A3	90196	238320350	238325350
NR_027927	chr3	-	15206868	15247466	COL6A4P1	40598	15244966	15249966
NR_027898	chr3	+	129931662	129992649	COL6A4P2	60987	129929162	129934162
NM_153264	chr3	+	130064358	130203690	COL6A5	139332	130061858	130066858
NM_001102608	chr3	+	130279177	130396981	COL6A6	117804	130276677	130281677
NM_000094	chr3	-	48601505	48632593	COL7A1	31088	48630093	48635093
NM_020351	chr3	+	99357439	99515577	COL8A1	158138	99354939	99359939
NM_001294347	chr1	-	36560836	36590685	COL8A2	29849	36588185	36593185
NM_001851	chr6	-	70925742	71012786	COL9A1	87044	71010286	71015286
NM_001852	chr1	-	40766162	40782939	COL9A2	16777	40780439	40785439
NM_001853	chr20	+	61448413	61472511	COL9A3	24098	61445913	61450913
NM_001302644	chr11	-	111164113	111175773	COLCA1	11660	111173273	111178273
NM_001271458	chr11	+	111169270	111179460	COLCA2	10190	111166770	111171770
NM_001324095	chr8	+	119964405	120120694	COLEC10	156289	119961905	119966905
NR_045659	chr2	+	3642421	3692234	COLEC11	49813	3639921	3644921
NM_130386	chr18	-	319354	500729	COLEC12	181375	498229	503229
NM_024656	chr19	+	17666402	17693971	COLGALT1	27569	17663902	17668902
NM_001303420	chr1	-	183898795	184006904	COLGALT2	108109	184004404	184009404
NM_005677	chr3	-	15491639	15563258	COLQ	71619	15560758	15565758
NM_001321782	chr2	+	62115857	62363205	COMMD1	247348	62113357	62118357
NM_016144	chr5	+	115420672	115628987	COMMD10	208315	115418172	115423172
NM_016094	chr3	-	149456256	149470286	COMMD2	14030	149467786	149472786
NM_012071	chr10	+	22605311	22609246	COMMD3	3935	22602811	22607811
NM_001204062	chr10	+	22605311	22620414	COMMD3-BMI1	15103	22602811	22607811
NR_104312	chr15	+	75628336	75634268	COMMD4	5932	75625836	75630836
NM_001081003	chr8	-	146075550	146078963	COMMD5	3413	146076463	146081463
NM_001287394	chr13	-	76099354	76123575	COMMD6	24221	76121075	76126075
NM_053041	chr20	-	31290492	31331814	COMMD7	41322	31329314	31334314
NM_001329668	chr4	-	47452805	47465747	COMMD8	12942	47463247	47468247
NM_001307937	chr11	-	36293841	36310999	COMMD9	17158	36308499	36313499
NM_000095	chr19	-	18893582	18902114	COMP	8532	18899614	18904614
NM_000754	chr22	+	19929262	19957498	COMT	28236	19926762	19931762
NM_004371	chr1	-	160258376	160313354	COPA	54978	160310854	160315854
NM_001144061	chr11	-	14479048	14521441	COPB1	42393	14518941	14523941
NM_004766	chr3	-	139076432	139108522	COPB2	32090	139106022	139111022
NM_001330469	chr19	-	19010319	19030212	COPE	19893	19027712	19032712
NM_016128	chr3	+	128968452	128996616	COPG1	28164	128965952	128970952
NM_012133	chr7	-	130146079	130353598	COPG2	207519	130351098	130356098
NM_018405	chr17	-	30178883	30186326	COPRS	7443	30183826	30188826
NM_004236	chr15	-	49417470	49447854	COPS2	30384	49445354	49450354
NM_001316354	chr17	-	17149937	17184617	COPS3	34680	17182117	17187117
NM_016129	chr4	+	83956238	83996971	COPS4	40733	83953738	83958738
NM_006837	chr8	-	67955314	67974562	COPS5	19248	67972062	67977062
NM_006833	chr7	+	99686582	99689822	COPS6	3240	99684082	99689082
NM_016319	chr12	+	6833149	6841041	COPS7A	7892	6830649	6835649
NM_001282949	chr2	+	232646380	232673963	COPS7B	27583	232643880	232648880
NM_006710	chr2	+	237994083	238007489	COPS8	13406	237991583	237996583
NM_138336	chr2	-	241065979	241075764	COPS9	9785	241073264	241078264
NR_073424	chr12	+	54718873	54745635	COPZ1	26762	54716373	54721373
NM_016429	chr17	-	46103532	46115168	COPZ2	11636	46112668	46117668
NM_144576	chr12	+	56660641	56664750	COQ10A	4109	56658141	56663141
NM_001320818	chr2	+	198318146	198340033	COQ10B	21887	198315646	198320646
NM_015697	chr4	-	84184976	84206067	COQ2	21091	84203567	84208567
NM_017421	chr6	-	99817347	99842082	COQ3	24735	99839582	99844582
NM_016035	chr9	+	131084786	131096351	COQ4	11565	131082286	131087286
NM_032314	chr12	-	120941081	120966964	COQ5	25883	120964464	120969464
NM_182480	chr14	+	74416636	74429813	COQ6	13177	74414136	74419136
NM_016138	chr16	+	19078916	19091417	COQ7	12501	19076416	19081416
NM_020247	chr1	+	227127937	227175246	COQ8A	47309	227125437	227130437
NM_024876	chr19	-	41197433	41222790	COQ8B	25357	41220290	41225290
NM_020312	chr16	+	57481336	57495187	COQ9	13851	57478836	57483836
NM_001278585	chr4	-	47596014	47840123	CORIN	244109	47837623	47842623
NM_007074	chr16	+	30194730	30200397	CORO1A	5667	30192230	30197230
NM_001018070	chr11	-	67205517	67211292	CORO1B	5775	67208792	67213792
NM_014325	chr12	-	109038884	109125326	CORO1C	86442	109122826	109127826
NM_052820	chr9	-	100883256	100954956	CORO2A	71700	100952456	100957456
NM_001324014	chr15	+	68810711	69020144	CORO2B	209433	68808211	68813211
NM_032854	chr17	-	27941773	27948441	CORO6	6668	27945941	27950941
NM_001201473	chr16	-	4404542	4466962	CORO7	62420	4464462	4469462
NM_001201479	chr16	-	4390251	4466962	CORO7-PAM16	76711	4464462	4469462
NM_021149	chr16	-	84599203	84651702	COTL1	52499	84649202	84654202
NM_001303	chr17	+	13972718	14111996	COX10	139278	13970218	13975218
NR_049718	chr17	-	13932608	13972775	COX10-AS1	40167	13970275	13975275
NR_027942	chr17	-	53029258	53046146	COX11	16888	53043646	53048646
NM_001257133	chr12	+	50505763	50514240	COX14	8477	50503263	50508263
NM_001320974	chr10	-	101454549	101492423	COX15	37874	101489923	101494923
NM_016468	chr14	-	70791797	70826448	COX16	34651	70823948	70828948
NM_005694	chr3	-	119388371	119396243	COX17	7872	119393743	119398743
NM_173827	chr4	-	73920412	73935476	COX18	15064	73932976	73937976
NM_001031617	chr7	-	1004485	1015235	COX19	10750	1012735	1017735
NM_001312871	chr1	+	244998607	245008365	COX20	9758	244996107	245001107
NM_001318802	chr16	+	85833172	85840609	COX4I1	7437	85830672	85835672
NM_032609	chr20	+	30225690	30232800	COX4I2	7110	30223190	30228190
NM_004255	chr15	-	75212616	75230495	COX5A	17879	75227995	75232995
NM_004373	chr12	+	120875892	120878545	COX6A1	2653	120873392	120878392
NM_001863	chr19	+	36139124	36149686	COX6B1	10562	36136624	36141624
NM_144613	chr19	-	55861069	55866182	COX6B2	5113	55863682	55868682
NM_004374	chr8	-	100890222	100906242	COX6C	16020	100903742	100908742
NR_029466	chr6	-	75947390	75953644	COX7A2	6254	75951144	75956144
NM_001319038	chr2	-	42562700	42588383	COX7A2L	25683	42585883	42590883
NM_001866	chrX	+	77154960	77160881	COX7B	5921	77152460	77157460
NM_130902	chr4	-	46736846	46911252	COX7B2	174406	46908752	46913752
NM_001867	chr5	+	85913783	85916583	COX7C	2800	85911283	85916283
NR_046371	chr3	-	148880196	148939832	CP	59636	148937332	148942332
NM_001868	chr7	+	130020211	130027949	CPA1	7738	130017711	130022711
NM_001869	chr7	+	129906702	129929637	CPA2	22935	129904202	129909202
NM_001870	chr3	+	148583042	148614878	CPA3	31836	148580542	148585542
NM_016352	chr7	+	129932973	129964020	CPA4	31047	129930473	129935473
NM_080385	chr7	+	129984629	130008571	CPA5	23942	129982129	129987129
NM_020361	chr8	-	68334404	68658620	CPA6	324216	68656120	68661120
NM_015692	chr19	-	17003757	17137625	CPAMD8	133868	17135125	17140125
NM_001871	chr3	+	148545587	148577972	CPB1	32385	148543087	148548087
NM_001278541	chr13	-	46627321	46679211	CPB2	51890	46676711	46681711
NR_046227	chr13	+	46626982	46675482	CPB2-AS1	48500	46624482	46629482
NM_001304	chr17	+	28705941	28796675	CPD	90734	28703441	28708441
NM_001873	chr4	+	166300093	166419699	CPE	119606	166297593	166302593
NM_030594	chr15	-	83211950	83316767	CPEB1	104817	83314267	83319267
NR_046096	chr15	+	83316520	83361572	CPEB1-AS1	45052	83314020	83319020
NM_001177383	chr4	+	15004297	15071777	CPEB2	67480	15001797	15006797
NR_038857	chr4	-	14911584	15003669	CPEB2-AS1	92085	15001169	15006169
NM_014912	chr10	-	93808396	94050875	CPEB3	242479	94048375	94053375
NM_001308189	chr5	+	173315330	173387994	CPEB4	72664	173312830	173317830
NM_024913	chr7	+	120628750	120937498	CPED1	308748	120626250	120631250
NM_006651	chr4	-	778744	819945	CPLX1	41201	817445	822445
NM_006650	chr5	+	175223609	175311023	CPLX2	87414	175221109	175226109
NM_001030005	chr15	+	75118950	75124136	CPLX3	5186	75116450	75121450
NM_181654	chr18	-	56962635	56985881	CPLX4	23246	56983381	56988381
NM_001874	chr12	-	69244955	69357020	CPM	112065	69354520	69359520
NM_001308	chr10	-	101802064	101841642	CPN1	39578	101839142	101844142
NM_001291988	chr3	-	194060493	194072057	CPN2	11564	194069557	194074557
NM_152928	chr20	-	34213952	34252878	CPNE1	38926	34250378	34255378
NM_152727	chr16	+	57126454	57181878	CPNE2	55424	57123954	57128954
NM_003909	chr8	+	87526655	87573726	CPNE3	47071	87524155	87529155
NM_153429	chr3	-	131252403	131758450	CPNE4	506047	131755950	131760950
NM_020939	chr6	-	36708554	36807220	CPNE5	98666	36804720	36809720
NM_001280558	chr14	+	24540045	24547309	CPNE6	7264	24537545	24542545
NM_014427	chr16	+	89642175	89663654	CPNE7	21479	89639675	89644675
NM_153634	chr12	-	39046001	39299420	CPNE8	253419	39296920	39301920
NM_153635	chr3	+	9745509	9771592	CPNE9	26083	9743009	9748009
NM_173077	chr2	+	207804277	207834198	CPO	29921	207801777	207806777
NM_000097	chr3	-	98298289	98312455	CPOX	14166	98309955	98314955
NM_018340	chr16	-	12753655	12897744	CPPED1	144089	12895244	12900244
NM_016134	chr8	+	97657454	98155731	CPQ	498277	97654954	97659954
NM_001122633	chr2	+	211342405	211543831	CPS1	201426	211339905	211344905
NM_013291	chr8	-	145618445	145634733	CPSF1	16288	145632233	145637233
NM_001322270	chr14	+	92588297	92630543	CPSF2	42246	92585797	92590797
NM_001321835	chr2	+	9563665	9613239	CPSF3	49574	9561165	9566165
NM_001318161	chr7	+	99036562	99055000	CPSF4	18438	99034062	99039062
NM_001129885	chr17	-	71244587	71258019	CPSF4L	13432	71255519	71260519
NM_001300947	chr12	+	69633316	69668138	CPSF6	34822	69630816	69635816
NM_001136040	chr11	-	61170119	61197464	CPSF7	27345	61194964	61199964
NM_001031847	chr11	-	68522087	68609399	CPT1A	87312	68606899	68611899
NM_001145135	chr22	-	51007289	51017096	CPT1B	9807	51014596	51019596
NM_001136052	chr19	+	50194364	50216988	CPT1C	22624	50191864	50196864
NM_000098	chr1	+	53662100	53679869	CPT2	17769	53659600	53664600
NM_001029885	chr1	+	1260142	1264276	CPTP	4134	1257642	1262642
NM_001348054	chr7	-	29034846	29235067	CPVL	200221	29232567	29237567
NM_001184771	chrX	+	88002225	88009785	CPXCR1	7560	87999725	88004725
NM_001184699	chr20	-	2774714	2781292	CPXM1	6578	2778792	2783792
NM_198148	chr10	-	125505151	125651500	CPXM2	146349	125649e3	125654e3
NM_001014447	chr4	+	8594386	8621488	CPZ	27102	8591886	8596886
NM_000651	chr1	+	207669472	207815110	CR1	145638	207666972	207671972
NM_175710	chr1	+	207818457	207897036	CR1L	78579	207815957	207820957
NM_001877	chr1	+	207627644	207663240	CR2	35596	207625144	207630144
NM_004378	chr15	+	78632665	78640572	CRABP1	7907	78630165	78635165
NM_001199723	chr1	-	156669399	156675608	CRABP2	6209	156673108	156678108
NM_001144958	chr12	-	3724493	3862366	CRACR2A	137873	3859866	3864866
NM_001286606	chr11	+	828259	831991	CRACR2B	3732	825759	830759
NM_001320100	chr12	+	94071146	94288616	CRADD	217470	94068646	94073646
NM_020825	chr16	+	1664640	1727909	CRAMP1	63269	1662140	1667140
NM_000755	chr9	-	131857072	131873077	CRAT	16005	131870577	131875577
NR_110106	chr15	+	92006568	92038080	CRAT37	31512	92004068	92009068
NM_001257965	chr1	+	197170591	197447585	CRB1	276994	197168091	197173091
NM_173689	chr9	+	126118445	126141034	CRB2	22589	126115945	126120945
NM_174882	chr19	+	6463787	6467230	CRB3	3443	6461287	6466287
NM_016302	chr3	-	3191316	3221401	CRBN	30085	3218901	3223901
NR_024548	chr7	+	65579804	65619553	CRCP	39749	65577304	65582304
NM_134442	chr2	+	208394615	208470713	CREB1	76098	208392115	208397115
NM_006368	chr9	+	35732316	35737005	CREB3	4689	35729816	35734816
NM_052854	chr11	+	46299188	46342972	CREB3L1	43784	46296688	46301688
NM_194071	chr7	-	137559724	137686847	CREB3L2	127123	137684347	137689347
NM_032607	chr19	+	4153597	4173051	CREB3L3	19454	4151097	4156097
NR_045658	chr1	+	153940314	153946840	CREB3L4	6526	153937814	153942814
NM_182899	chr7	+	28338939	28865511	CREB5	526572	28336439	28341439
NM_004380	chr16	-	3775055	3930121	CREBBP	155066	3927621	3932621
NM_001310	chr12	+	12764766	12798042	CREBL2	33276	12762266	12767266
NM_153607	chr5	+	172483354	172566291	CREBRF	82937	172480854	172485854
NR_028026	chr11	-	85368607	85376182	CREBZF	7575	85373682	85378682
NM_003851	chr1	-	167510250	167523056	CREG1	12806	167520556	167525556
NM_153836	chr2	-	101964815	102003965	CREG2	39150	102001465	102006465
NM_015513	chr3	+	9975523	9987097	CRELD1	11574	9973023	9978023
NM_001135101	chr22	+	50312277	50321188	CRELD2	8911	50309777	50314777
NM_001267562	chr10	+	35415768	35501886	CREM	86118	35413268	35418268
NM_001882	chr5	+	76248679	76265299	CRHBP	16620	76246179	76251179
NM_004382	chr17_ctg5_hap1	-	954314	1005883	CRHR1	51569	1003383	1008383
NM_001202475	chr7	-	30691558	30739719	CRHR2	48161	30737219	30742219
NM_016441	chr2	+	36583369	36778278	CRIM1	194909	36580869	36585869
NM_001270837	chr14	+	105939274	105946507	CRIP2	7233	105936774	105941774
NM_206922	chr6	-	43273210	43276530	CRIP3	3320	43274030	43279030
NM_175918	chr4	+	1385339	1389782	CRIPAK	4443	1382839	1387839
NM_014171	chr2	+	46844310	46857315	CRIPT	13005	46841810	46846810
NM_001205220	chr6	-	49801978	49844809	CRISP1	42831	49842309	49847309
NM_001142417	chr6	-	49660070	49681303	CRISP2	21233	49678803	49683803
NM_001190986	chr6	-	49695090	49712168	CRISP3	17078	49709668	49714668
NM_031461	chr8	+	75896707	75946793	CRISPLD1	50086	75894207	75899207
NM_031476	chr16	+	84853586	84943116	CRISPLD2	89530	84851086	84856086
NM_016823	chr17	-	1324646	1359561	CRK	34915	1357061	1362061
NM_005207	chr22	+	21271713	21308037	CRKL	36324	21269213	21274213
NM_004750	chr19	-	18704034	18717660	CRLF1	13626	18715160	18720160
NM_022148	chrX	-	1314893	1331616	CRLF2	16723	1329116	1334116
NM_015986	chr17	-	29109701	29151778	CRLF3	42077	29149278	29154278
NM_001323562	chr20	+	5986583	6020697	CRLS1	34114	5984083	5989083
NM_001014809	chr4	-	5822490	5894810	CRMP1	72320	5892310	5897310
NR_034105	chr16	-	54952776	54963101	CRNDE	10325	54960601	54965601
NM_001278625	chr20	-	20015004	20036690	CRNKL1	21686	20034190	20039190
NM_016190	chr1	-	152381718	152386750	CRNN	5032	152384250	152389250
NM_014675	chr1	+	17248444	17299474	CROCC	51030	17245944	17250944
NM_001351305	chr2	+	241845930	241932728	CROCC2	86798	241843430	241848430
NR_026752	chr1	-	16944750	16957401	CROCCP2	12651	16954901	16959901
NR_023386	chr1	-	16793930	16819196	CROCCP3	25266	16816696	16821696
NM_021151	chr7	+	86974950	87029112	CROT	54162	86972450	86977450
NM_018058	chr10	-	99624756	99790585	CRTAC1	165829	99788085	99793085
NM_019604	chr11	+	122709205	122743347	CRTAM	34142	122706705	122711705
NM_006371	chr3	+	33155449	33189265	CRTAP	33816	33152949	33157949
NM_015321	chr19	+	18794424	18893143	CRTC1	98719	18791924	18796924
NM_181715	chr1	-	153920147	153931132	CRTC2	10985	153928632	153933632
NM_022769	chr15	+	91073117	91188577	CRTC3	115460	91070617	91075617
NR_120372	chr15	-	91163240	91260371	CRTC3-AS1	97131	91257871	91262871
NM_000554	chr19	+	48325096	48346586	CRX	21490	48322596	48327596
NM_004075	chr12	-	107385142	107487635	CRY1	102493	107485135	107490135
NM_001127457	chr11	+	45868668	45904799	CRY2	36131	45866168	45871168
NM_000394	chr21	+	44589117	44592920	CRYAA	3803	44586617	44591617
NM_001885	chr11	-	111779343	111783937	CRYAB	4594	111781437	111786437
NM_005208	chr17	+	27573874	27581502	CRYBA1	7628	27571374	27576374
NM_057094	chr2	-	219854911	219858127	CRYBA2	3216	219855627	219860627
NM_001886	chr22	+	27017927	27026636	CRYBA4	8709	27015427	27020427
NM_001887	chr22	-	26995361	27013991	CRYBB1	18630	27011491	27016491
NM_000496	chr22	+	25615611	25627836	CRYBB2	12225	25613111	25618111
NR_033734	chr22	+	25844053	25857645	CRYBB2P1	13592	25841553	25846553
NM_004076	chr22	+	25595816	25603326	CRYBB3	7510	25593316	25598316
NM_001624	chr6	+	106959729	107018324	CRYBG1	58595	106957229	106962229
NM_001039775	chr1	-	26648349	26680621	CRYBG2	32272	26678121	26683121
NM_153605	chr3	+	97540883	97663830	CRYBG3	122947	97538383	97543383
NM_014617	chr2	-	209025463	209028297	CRYGA	2834	209025797	209030797
NM_005210	chr2	-	209007296	209010877	CRYGB	3581	209008377	209013377
NM_006891	chr2	-	208986330	208989313	CRYGD	2983	208986813	208991813
NR_131779	chr7	-	151125917	151137899	CRYGN	11982	151135399	151140399
NM_017541	chr3	-	186256227	186262240	CRYGS	6013	186259740	186264740
NM_015974	chr13	-	20977805	21100012	CRYL1	122207	21097512	21102512
NM_001888	chr16	-	21269838	21314457	CRYM	44619	21311957	21316957
NR_026675	chr16	+	21312169	21329912	CRYM-AS1	17743	21309669	21314669
NM_001889	chr1	-	75171171	75199092	CRYZ	27921	75196592	75201592
NM_145858	chr21	-	34961647	35014160	CRYZL1	52513	35011660	35016660
NM_004077	chr12	-	56665482	56694175	CS	28693	56691675	56696675
NM_001244705	chr12	-	53551446	53574693	CSAD	23247	53572193	53577193
NM_001102576	chrX	+	151903226	151909518	CSAG1	6292	151900726	151905726
NR_130638	chrX	-	151876742	151883038	CSAG3	6296	151880538	151885538
NR_073432	chrX	-	151895977	151903136	CSAG4	7159	151900636	151905636
NM_014460	chr22	+	41957013	41972670	CSDC2	15657	41954513	41959513
NM_001130523	chr1	-	115259533	115300671	CSDE1	41138	115298171	115303171
NM_001256135	chr20	+	47662782	47713497	CSE1L	50715	47660282	47665282
NR_110625	chr20	-	47656999	47662593	CSE1L-AS1	5594	47660093	47665093
NM_000757	chr1	+	110453232	110473616	CSF1	20384	110450732	110455732
NM_005211	chr5	-	149432853	149492935	CSF1R	60082	149490435	149495435
NM_001161529	chrX	+	1387692	1428828	CSF2RA	41136	1385192	1390192
NM_000395	chr22	+	37309674	37336479	CSF2RB	26805	37307174	37312174
NM_000760	chr1	-	36931643	36948915	CSF3R	17272	36946415	36951415
NR_024040	chr8	-	19261671	19540261	CSGALNACT1	278590	19537761	19542761
NR_135077	chr10	+	43633892	43680754	CSGALNACT2	46862	43631392	43636392
NM_004383	chr15	+	75074424	75095539	CSK	21115	75071924	75076924
NM_033225	chr8	-	2792874	4852328	CSMD1	2059454	4849828	4854828
NM_052896	chr1	-	33979598	34631443	CSMD2	651845	34628943	34633943
NR_038372	chr1	+	34334556	34351059	CSMD2-AS1	16503	34332056	34337056
NM_198123	chr8	-	113235158	114449242	CSMD3	1214084	114446742	114451742
NM_001890	chr4	+	70796798	70812288	CSN1S1	15490	70794298	70799298
NR_003720	chr4	+	70933102	70950988	CSN1S2AP	17886	70930602	70935602
NR_033311	chr4	+	70999320	71012421	CSN1S2BP	13101	70996820	71001820
NM_001302770	chr4	-	70820973	70826729	CSN2	5756	70824229	70829229
NM_005212	chr4	+	71108332	71117145	CSN3	8813	71105832	71110832
NM_001892	chr5	-	148875456	148931115	CSNK1A1	55659	148928615	148933615
NR_027320	chr15	-	37091300	37110707	CSNK1A1P1	19407	37108207	37113207
NR_110578	chr17	-	80200536	80231618	CSNK1D	31082	80229118	80234118
NM_001894	chr22	-	38686696	38714089	CSNK1E	27393	38711589	38716589
NM_022048	chr15	-	64457715	64648458	CSNK1G1	190743	64645958	64650958
NM_001319	chr19	+	1941160	1981336	CSNK1G2	40176	1938660	1943660
NM_001270573	chr5	+	122847792	122952738	CSNK1G3	104946	122845292	122850292
NM_001895	chr20	-	463337	524482	CSNK2A1	61145	521982	526982
NM_001896	chr16	-	58191811	58231782	CSNK2A2	39971	58229282	58234282
NM_001320	chr6_dbb_hap3	+	2919235	2923427	CSNK2B	4192	2916735	2921735
NM_001897	chr15	-	75966662	76005189	CSPG4	38527	76002689	76007689
NR_001554	chrY	-	26329580	26333378	CSPG4P1Y	3798	26330878	26335878
NM_001206942	chr3	-	47603727	47621730	CSPG5	18003	47619230	47624230
NM_024790	chr8	+	67976602	68108849	CSPP1	132247	67974102	67979102
NM_001320560	chr3	-	39183341	39196093	CSRNP1	12752	39193593	39198593
NM_030809	chr12	-	51454987	51477454	CSRNP2	22467	51474954	51479954
NM_001172173	chr2	+	166326156	166545917	CSRNP3	219761	166323656	166328656
NM_004078	chr1	-	201452657	201476387	CSRP1	23730	201473887	201478887
NM_001321	chr12	-	77252494	77272820	CSRP2	20326	77270320	77275320
NM_003476	chr11	-	19203576	19232118	CSRP3	28542	19229618	19234618
NM_001898	chr20	-	23728189	23731574	CST1	3385	23729074	23734074
NR_001279	chr20	+	23499782	23522655	CST13P	22873	23497282	23502282
NM_001322	chr20	-	23804403	23807312	CST2	2909	23804812	23809812
NM_001288614	chr20	-	23608533	23618685	CST3	10152	23616185	23621185
NM_001899	chr20	-	23666276	23669662	CST4	3386	23667162	23672162
NM_001900	chr20	-	23856571	23860380	CST5	3809	23857880	23862880
NM_003650	chr20	+	24929865	24940564	CST7	10699	24927365	24932365
NM_005492	chr20	+	23471737	23476655	CST8	4918	23469237	23474237
NM_001008693	chr20	-	23583046	23586610	CST9	3564	23584110	23589110
NM_080610	chr20	-	23545369	23549386	CST9L	4017	23546886	23551886
NM_005213	chr3	+	122044010	122060815	CSTA	16805	122041510	122046510
NM_000100	chr21	-	45193545	45196256	CSTB	2711	45193756	45198756
NM_001033521	chr20	+	54967426	54979582	CSTF1	12156	54964926	54969926
NM_001306206	chrX	+	100075351	100096509	CSTF2	21158	100072851	100077851
NM_015235	chr10	-	53455245	53459355	CSTF2T	4110	53456855	53461855
NM_001326	chr11	-	33106129	33183037	CSTF3	76908	33180537	33185537
NR_034027	chr11	+	33183202	33213142	CSTF3-AS1	29940	33180702	33185702
NM_138283	chr20	+	23420321	23425567	CSTL1	5246	23417821	23422821
NM_001017417	chrX	+	134847184	134891539	CT45A1	44355	134844684	134849684
NM_001291529	chrX	-	134945650	134975579	CT45A10	29929	134973079	134978079
NM_152582	chrX	+	134866213	134874249	CT45A2	8036	134863713	134868713
NM_001017435	chrX	+	134883487	134891519	CT45A3	8032	134880987	134885987
NM_001172288	chrX	+	134866213	134874561	CT45A5	8348	134863713	134868713
NM_001017438	chrX	+	134866213	134874248	CT45A6	8035	134863713	134868713
NM_001291543	chrX	+	134847385	134856984	CT45A7	9599	134844885	134849885
NM_001291535	chrX	+	134866213	134874249	CT45A8	8036	134863713	134868713
NM_001291540	chrX	+	134866213	134874608	CT45A9	8395	134863713	134868713
NM_001080146	chrX	-	120011344	120066151	CT47A1	54807	120063651	120068651
NM_001080137	chrX	-	120011344	120066151	CT47A10	54807	120063651	120068651
NM_173571	chrX	-	120011344	120066151	CT47A11	54807	120063651	120068651
NM_001242922	chrX	-	120011344	120066151	CT47A12	54807	120063651	120068651
NM_001080145	chrX	-	120011344	120066151	CT47A2	54807	120063651	120068651
NM_001080144	chrX	-	120011344	120066151	CT47A3	54807	120063651	120068651
NM_001080143	chrX	-	120011344	120066151	CT47A4	54807	120063651	120068651
NM_001080142	chrX	-	120011344	120066151	CT47A5	54807	120063651	120068651
NM_001080141	chrX	-	120077415	120080733	CT47A6	3318	120078233	120083233
NM_001080140	chrX	-	120087136	120090454	CT47A7	3318	120087954	120092954
NM_001080139	chrX	-	120011344	120066151	CT47A8	54807	120063651	120068651
NM_001080138	chrX	-	120011344	120066151	CT47A9	54807	120063651	120068651
NM_001145718	chrX	-	120006451	120009779	CT47B1	3328	120007279	120012279
NM_001031705	chrX	-	134290460	134305751	CT55	15291	134303251	134308251
NM_001102658	chr15	-	71402582	71407839	CT62	5257	71405339	71410339
NM_172241	chr18	-	19993563	19997878	CTAGE1	4315	19995378	20000378
NR_003268	chr13	+	50464544	50467516	CTAGE10P	2972	50462044	50467044
NR_027466	chr13	-	75811888	75814517	CTAGE11P	2629	75812017	75817017
NM_001008747	chr7	+	143268893	143271480	CTAGE15	2587	143266393	143271393
NM_198495	chr7	+	143880547	143883173	CTAGE4	2626	143878047	143883047
NM_178561	chr7	-	143452181	143454843	CTAGE6	2662	143452343	143457343
NR_044994	chr10	+	131904272	131907101	CTAGE7P	2829	131901772	131906772
NM_001278507	chr7	-	143963766	143966877	CTAGE8	3111	143964377	143969377
NM_001145659	chr6	-	132029580	132032157	CTAGE9	2577	132029657	132034657
NR_109894	chr5	-	167656587	167659377	CTB-178M22.2	2790	167656877	167661877
NM_001328	chr4	-	1205227	1242908	CTBP1	37681	1240408	1245408
NR_104331	chr4	+	1203907	1212379	CTBP1-AS	8472	1201407	1206407
NR_033339	chr4	+	1243227	1246795	CTBP1-AS2	3568	1240727	1245727
NM_001083914	chr10	-	126676417	126849630	CTBP2	173213	126847130	126852130
NM_004388	chr1	-	85018803	85040163	CTBS	21360	85037663	85042663
NR_109909	chr5	+	180673540	180684587	CTC-338M12.4	11047	180671040	180676040
NM_025099	chr17	-	8128138	8151413	CTC1	23275	8148913	8153913
NM_001191022	chr16	+	67596309	67673088	CTCF	76779	67593809	67598809
NM_001269043	chr20	-	56071020	56100183	CTCFL	29163	56097683	56102683
NR_109912	chr5	+	1887444	1900604	CTD-2194D22.4	13160	1884944	1889944
NR_109930	chr5	-	79362171	79379488	CTD-2201I18.1	17317	79376988	79381988
NR_109899	chr5	+	169816496	169849848	CTD-2270F17.1	33352	169813996	169818996
NR_109915	chr5	-	5132197	5140167	CTD-2297D10.2	7970	5137667	5142667
NR_109945	chr5	-	15602297	15615111	CTD-2350J17.1	12814	15612611	15617611
NR_109911	chr5	-	1173210	1178720	CTD-3080P12.3	5510	1176220	1181220
NM_015343	chr17	-	7146905	7155259	CTDNEP1	8354	7152759	7157759
NM_001318511	chr18	+	77439800	77514510	CTDP1	74710	77437300	77442300
NM_001206878	chr2	+	219263060	219270664	CTDSP1	7604	219260560	219265560
NM_005730	chr12	-	58213709	58240747	CTDSP2	27038	58238247	58243247
NM_005808	chr3	+	37903668	38025960	CTDSPL	122292	37901168	37906168
NM_016396	chr15	+	44719578	44819429	CTDSPL2	99851	44717078	44722078
NM_001142544	chr16	+	30907927	30914881	CTF1	6954	30905427	30910427
NM_001901	chr6	-	132269316	132272518	CTGF	3202	132270018	132275018
NM_001190463	chr1	+	70876900	70905534	CTH	28634	70874400	70879400
NM_138455	chr8	+	104383742	104395232	CTHRC1	11490	104381242	104386242
NM_001142397	chr18	+	46065426	46389586	CTIF	324160	46062926	46067926
NM_005214	chr2	+	204732510	204738683	CTLA4	6173	204730010	204735010
NM_001323982	chr5	+	138089074	138270723	CTNNA1	181649	138086574	138091574
NM_004389	chr2	+	79740059	80875988	CTNNA2	1135929	79737559	79742559
NM_013266	chr10	-	67672275	69455949	CTNNA3	1783674	69453449	69458449
NM_001286974	chr9	-	111704848	111775874	CTNNAL1	71026	111773374	111778374
NM_001330729	chr3	+	41240914	41281944	CTNNB1	41030	41238414	41243414
NM_020248	chr1	-	9908333	9970316	CTNNBIP1	61983	9967816	9972816
NM_001281495	chr20	+	36322356	36500531	CTNNBL1	178175	36319856	36324856
NM_001331	chr11	+	57529233	57586652	CTNND1	57419	57526733	57531733
NR_109988	chr5	-	10971953	11904155	CTNND2	932202	11901655	11906655
NM_004937	chr17	+	3539761	3566397	CTNS	26636	3537261	3542261
NR_125440	chr1	+	41444970	41478237	CTPS1	33267	41442470	41447470
NM_019857	chrX	-	16606121	16731102	CTPS2	124981	16728602	16733602
NM_014633	chr11	+	10772533	10801302	CTR9	28769	10770033	10775033
NM_001329190	chr16	+	75252883	75258825	CTRB1	5942	75250383	75255383
NM_001025200	chr16	-	75237993	75241072	CTRB2	3079	75238572	75243572
NM_007272	chr1	+	15764937	15773153	CTRC	8216	15762437	15767437
NR_133656	chr20	+	44518782	44527458	CTSA	8676	44516282	44521282
NM_147780	chr8	-	11700033	11725659	CTSB	25626	11723159	11728159
NM_001814	chr11	-	88026759	88070955	CTSC	44196	88068455	88073455
NM_001909	chr11	-	1773981	1785222	CTSD	11241	1782722	1787722
NM_001910	chr1	+	206317458	206332104	CTSE	14646	206314958	206319958
NM_003793	chr11	-	66330934	66336047	CTSF	5113	66333547	66338547
NM_001911	chr14	-	25042723	25045466	CTSG	2743	25042966	25047966
NM_001319137	chr15	-	79214091	79237440	CTSH	23349	79234940	79239940
NM_000396	chr1	-	150768683	150780917	CTSK	12234	150778417	150783417
NM_145918	chr9	+	90340973	90346384	CTSL	5411	90338473	90343473
NR_027917	chr9	+	90387829	90401799	CTSL3P	13970	90385329	90390329
NR_033407	chr10	+	48155942	48158691	CTSLP2	2749	48153442	48158442
NR_033405	chr9	+	90459659	90462339	CTSLP8	2680	90457159	90462159
NM_001334	chr4	-	156845269	156875048	CTSO	29779	156872548	156877548
NM_001199739	chr1	-	150702671	150738433	CTSS	35762	150735933	150740933
NM_001201575	chr9	-	99791958	99801925	CTSV	9967	99799425	99804425
NM_001335	chr11	+	65647283	65651212	CTSW	3929	65644783	65649783
NM_001336	chr20	-	57570241	57582309	CTSZ	12068	57579809	57584809
NM_001184740	chr11	+	70244611	70282690	CTTN	38079	70242111	70247111
NM_033427	chr7	-	117350705	117513561	CTTNBP2	162856	117511061	117516061
NM_018704	chr1	+	112938799	113003786	CTTNBP2NL	64987	112936299	112941299
NM_145232	chr19	-	51600862	51611647	CTU1	10785	51609147	51614147
NM_001318513	chr16	+	88772870	88781786	CTU2	8916	88770370	88775370
NM_001145668	chr15	+	48483866	48495951	CTXN2	12085	48481366	48486366
NM_001048252	chr5	+	126984712	126994322	CTXN3	9610	126982212	126987212
NM_001352888	chr15	-	80487820	80544603	CTXND1	56783	80542103	80547103
NM_001081	chr10	-	16865964	17171816	CUBN	305852	17169316	17174316
NM_001271875	chr17	-	55938603	56032684	CUEDC1	94081	56030184	56035184
NM_024040	chr10	-	104183001	104192423	CUEDC2	9422	104189923	104194923
NM_003592	chr7	+	148395932	148498202	CUL1	102270	148393432	148398432
NM_001198777	chr10	-	35297478	35379570	CUL2	82092	35377070	35382070
NM_003590	chr2	-	225334866	225450114	CUL3	115248	225447614	225452614
NM_001278513	chr13	+	113862506	113919392	CUL4A	56886	113860006	113865006
NM_003588	chrX	-	119658445	119709684	CUL4B	51239	119707184	119712184
NM_003478	chr11	+	107879458	107978503	CUL5	99045	107876958	107881958
NM_014780	chr6	-	43005354	43021683	CUL7	16329	43019183	43024183
NM_015089	chr6	+	43149921	43192325	CUL9	42404	43147421	43152421
NM_015960	chr10	+	101491957	101515894	CUTC	23937	101489457	101494457
NM_001202545	chr7	+	101459183	101927250	CUX1	468067	101456683	101461683
NM_015267	chr12	+	111471827	111788358	CUX2	316531	111469327	111474327
NR_037912	chr10	-	124591670	124605691	CUZD1	14021	124603191	124608191
NM_016403	chr11	-	94695786	94706776	CWC15	10990	94704276	94709276
NM_020943	chr2	-	180809603	180871780	CWC22	62177	180869280	180874280
NM_017748	chr17	-	36956686	36981603	CWC25	24917	36979103	36984103
NM_005869	chr5	+	64064744	64314590	CWC27	249846	64062244	64067244
NM_001303407	chr10	-	101992052	102027438	CWF19L1	35386	102024938	102029938
NM_152434	chr11	-	107197071	107328572	CWF19L2	131501	107326072	107331072
NM_025087	chr4	+	48988264	49064095	CWH43	75831	48985764	48990764
NM_002996	chr16	+	57406372	57418960	CX3CL1	12588	57403872	57408872
NM_001171174	chr3	-	39304984	39323226	CX3CR1	18242	39320726	39325726
NM_001207066	chr21	+	18885223	18965897	CXADR	80674	18882723	18887723
NR_024076	chr18	-	14477953	14498705	CXADRP3	20752	14496205	14501205
NM_005409	chr4	-	76954839	76957350	CXCL11	2511	76954850	76959850
NM_001277990	chr10	-	44865600	44880545	CXCL12	14945	44878045	44883045
NM_006419	chr4	+	78432906	78532988	CXCL13	100082	78430406	78435406
NM_004887	chr5	-	134906370	134914969	CXCL14	8599	134912469	134917469
NM_022059	chr17	-	4636823	4643223	CXCL16	6400	4640723	4645723
NR_133910	chr19	-	42932689	42947200	CXCL17	14511	42944700	42949700
NM_002994	chr4	-	74861358	74864446	CXCL5	3088	74861946	74866946
NM_000584	chr4	+	74606222	74609433	CXCL8	3211	74603722	74608722
NM_002416	chr4	-	76922494	76928676	CXCL9	6182	76926176	76931176
NM_000634	chr2	-	219027567	219031716	CXCR1	4149	219029216	219034216
NM_001168298	chr2	+	218990012	219001976	CXCR2	11964	218987512	218992512
NM_001142797	chrX	-	70835765	70838367	CXCR3	2602	70835867	70840867
NM_003467	chr2	-	136871918	136875725	CXCR4	3807	136873225	136878225
NM_001716	chr11	+	118754474	118766980	CXCR5	12506	118751974	118756974
NM_006564	chr3	+	45984972	45989845	CXCR6	4873	45982472	45987472
NM_001101654	chr18	-	47808712	47814692	CXXC1	5980	47812192	47817192
NR_033924	chrX	+	47566589	47596027	CXXC1P1	29438	47564089	47569089
NM_025212	chr4	-	105389462	105416058	CXXC4	26596	105413558	105418558
NR_125926	chr4	+	105412121	105618749	CXXC4-AS1	206628	105409621	105414621
NM_001317201	chr5	+	139026883	139063470	CXXC5	36587	139024383	139029383
NM_025159	chrX	-	30576940	30596033	CXorf21	19093	30593533	30598533
NM_176819	chrX	-	45007617	45060146	CXorf36	52529	45057646	45062646
NM_001330455	chrX	-	40486172	40506935	CXorf38	20763	40504435	40509435
NM_001324276	chrX	+	148622518	148636882	CXorf40A	14364	148620018	148625018
NM_001013845	chrX	-	149100414	149106716	CXorf40B	6302	149104216	149109216
NM_001145140	chrX	+	70983139	70987051	CXorf49	3912	70980639	70985639
NM_001145139	chrX	-	70934223	70938135	CXorf49B	3912	70935635	70940635
NM_001170570	chrX	-	118672111	118699397	CXorf56	27286	118696897	118701897
NM_001184782	chrX	+	105855159	105922673	CXorf57	67514	105852659	105857659
NM_001169574	chrX	+	23926122	23957624	CXorf58	31502	23923622	23928622
NR_033212	chrX	-	70323738	70326638	CXorf65	2900	70324138	70329138
NM_001013403	chrX	-	139037883	139047677	CXorf66	9794	139045177	139050177
NM_001915	chr17	-	61509664	61523722	CYB561	14058	61521222	61526222
NM_001161454	chr11	-	61116219	61129755	CYB561A3	13536	61127255	61132255
NM_001134402	chr1	+	110036657	110043063	CYB561D1	6406	110034157	110039157
NR_111912	chr3	+	50388125	50405628	CYB561D2	17503	50385625	50390625
NM_001190807	chr18	-	71920526	71959251	CYB5A	38725	71956751	71961751
NM_030579	chr16	+	69458497	69500167	CYB5B	41670	69455997	69460997
NM_144607	chr17	+	7761044	7765601	CYB5D1	4557	7758544	7763544
NM_001254756	chr17	+	4046461	4060995	CYB5D2	14534	4043961	4048961
NM_016243	chr1	-	202931000	202936404	CYB5R1	5404	202933904	202938904
NM_001302826	chr11	-	7686325	7695474	CYB5R2	9149	7692974	7697974
NM_000398	chr22	-	43013845	43045405	CYB5R3	31560	43042905	43047905
NM_016230	chr6	+	84569369	84670146	CYB5R4	100777	84566869	84571869
NM_001353353	chr1	-	54637823	54665774	CYB5RL	27951	54663274	54668274
NM_000101	chr16	-	88709696	88717492	CYBA	7796	88714992	88719992
NM_000397	chrX	+	37639269	37672714	CYBB	33445	37636769	37641769
NM_001256909	chr2	+	172378756	172414643	CYBRD1	35887	172376256	172381256
NM_018947	chr7	-	25158269	25164980	CYCS	6711	25162480	25167480
NM_001324119	chr15	+	22892169	23006015	CYFIP1	113846	22889669	22894669
NM_001291721	chr5	+	156693089	156822606	CYFIP2	129517	156690589	156695589
NM_134268	chr17	-	74523429	74533987	CYGB	10558	74531487	74536487
NM_138496	chr8	-	145675314	145690418	CYHR1	15104	145687918	145692918
NM_001271680	chrX	+	83116133	83141708	CYLC1	25575	83113633	83118633
NM_001340	chr9	+	105757592	105780770	CYLC2	23178	105755092	105760092
NM_015247	chr16	+	50775960	50835846	CYLD	59886	50773460	50778460
NR_003599	chr1	+	111023387	111033891	CYMP	10504	111020887	111025887
NR_108042	chr1	-	111030301	111032880	CYMP-AS1	2579	111030380	111035380
NM_000781	chr15	-	74630102	74660081	CYP11A1	29979	74657581	74662581
NM_000497	chr8	-	143953772	143961236	CYP11B1	7464	143958736	143963736
NM_000498	chr8	-	143991974	143999259	CYP11B2	7285	143996759	144001759
NM_000102	chr10	-	104590287	104597290	CYP17A1	7003	104594790	104599790
NM_031226	chr15	-	51500253	51630795	CYP19A1	130542	51628295	51633295
NM_001319216	chr15	-	75011882	75017951	CYP1A1	6069	75015451	75020451
NM_000761	chr15	+	75041183	75048941	CYP1A2	7758	75038683	75043683
NM_000104	chr2	-	38294745	38303323	CYP1B1	8578	38300823	38305823
NR_027252	chr2	+	38358246	38408993	CYP1B1-AS1	50747	38355746	38360746
NM_177538	chr2	+	204103163	204170563	CYP20A1	67400	204100663	204105663
NR_040090	chr6_cox_hap2	+	3476797	3480072	CYP21A1P	3275	3474297	3479297
NM_000500	chr6_ssto_hap7	+	3306068	3342155	CYP21A2	36087	3303568	3308568
NM_001128915	chr20	-	52769987	52790516	CYP24A1	20529	52788016	52793016
NM_057157	chr10	+	94833231	94837641	CYP26A1	4410	94830731	94835731
NM_001277742	chr2	-	72356366	72374991	CYP26B1	18625	72372491	72377491
NM_183374	chr10	+	94821020	94828454	CYP26C1	7434	94818520	94823520
NM_000784	chr2	+	219646471	219680016	CYP27A1	33545	219643971	219648971
NM_000785	chr12	-	58156116	58160976	CYP27B1	4860	58158476	58163476
NM_001001665	chr2	-	127941411	127963343	CYP27C1	21932	127960843	127965843
NM_000766	chr19	+	41594355	41602100	CYP2A13	7745	41591855	41596855
NM_000762	chr19	-	41349442	41356352	CYP2A6	6910	41353852	41358852
NM_000764	chr19	-	41381343	41388657	CYP2A7	7314	41386157	41391157
NM_000767	chr19	+	41497203	41524301	CYP2B6	27098	41494703	41499703
NR_001278	chr19	+	41430169	41456565	CYP2B7P	26396	41427669	41432669
NM_000772	chr10	+	96443250	96495947	CYP2C18	52697	96440750	96445750
NM_000769	chr10	+	96522437	96612962	CYP2C19	90525	96519937	96524937
NM_000770	chr10	-	96796528	96829254	CYP2C8	32726	96826754	96831754
NM_000771	chr10	+	96698414	96749148	CYP2C9	50734	96695914	96700914
NM_000106	chr22	-	42522500	42526883	CYP2D6	4383	42524383	42529383
NM_001348386	chr22	-	42535602	42540576	CYP2D7	4974	42538076	42543076
NM_000773	chr10	+	135340866	135352620	CYP2E1	11754	135338366	135343366
NR_135528	chr19	+	41620336	41634288	CYP2F1	13952	41617836	41622836
NR_040249	chr19	+	41396730	41406413	CYP2G1P	9683	41394230	41399230
NR_134982	chr1	-	60358979	60392470	CYP2J2	33491	60389970	60394970
NM_024514	chr11	-	14899555	14913751	CYP2R1	14196	14911251	14916251
NM_030622	chr19	+	41699111	41713444	CYP2S1	14333	41696611	41701611
NR_144551	chr19	-	41314347	41317005	CYP2T1P	2658	41314505	41319505
NM_183075	chr4	+	108852716	108874613	CYP2U1	21897	108850216	108855216
NM_017781	chr7	+	1022834	1029276	CYP2W1	6442	1020334	1025334
NM_001278739	chr6	-	46517316	46620567	CYP39A1	103251	46618067	46623067
NM_017460	chr7	-	99354582	99381811	CYP3A4	27229	99379311	99384311
NM_057096	chr7	+	99425635	99463727	CYP3A43	38092	99423135	99428135
NM_000777	chr7	-	99245811	99277649	CYP3A5	31838	99275149	99280149
NM_000765	chr7	-	99302659	99332823	CYP3A7	30164	99330323	99335323
NM_001256497	chr7	-	99282301	99332823	CYP3A7-CYP3A51P	50522	99330323	99335323
NM_006668	chr14	+	100150754	100193638	CYP46A1	42884	100148254	100153254
NM_000778	chr1	-	47394845	47407156	CYP4A11	12311	47404656	47409656
NM_001010969	chr1	+	47603096	47614526	CYP4A22	11430	47600596	47605596
NM_001319162	chr1	+	47264669	47285021	CYP4B1	20352	47262169	47267169
NM_001128932	chr19	-	16023179	16045676	CYP4F11	22497	16043176	16048176
NR_117085	chr19	+	15783827	15807984	CYP4F12	24157	15781327	15786327
NM_001082	chr19	-	15988833	16008930	CYP4F2	20097	16006430	16011430
NM_173483	chr19	+	15619335	15663128	CYP4F22	43793	15616835	15621835
NR_033864	chr19	-	15870143	15890798	CYP4F24P	20655	15888298	15893298
NR_026755	chr21	-	15215453	15220685	CYP4F29P	5232	15218185	15223185
NM_001199209	chr19	+	15751706	15771570	CYP4F3	19864	15749206	15754206
NR_023391	chr2	+	131437622	131443435	CYP4F30P	5813	131435122	131440122
NR_026756	chr18	+	14337421	14342523	CYP4F35P	5102	14334921	14339921
NR_103761	chr2	-	131193234	131199254	CYP4F62P	6020	131196754	131201754
NM_007253	chr19	+	15726028	15740447	CYP4F8	14419	15723528	15728528
NM_207352	chr4	+	187112673	187134617	CYP4V2	21944	187110173	187115173
NM_001320289	chr1	+	47427035	47516426	CYP4X1	89391	47424535	47429535
NM_178134	chr1	+	47533159	47583992	CYP4Z1	50833	47530659	47535659
NR_002788	chr1	-	47308766	47366147	CYP4Z2P	57381	47363647	47368647
NM_001146152	chr7	-	91741462	91764059	CYP51A1	22597	91761559	91766559
NR_122109	chr7	+	91763876	91810039	CYP51A1-AS1	46163	91761376	91766376
NM_000780	chr8	-	59402736	59412720	CYP7A1	9984	59410220	59415220
NM_001324112	chr8	-	65499149	65711348	CYP7B1	212199	65708848	65713848
NM_004391	chr3	-	42913683	42917633	CYP8B1	3950	42915133	42920133
NM_001554	chr1	+	86046443	86049648	CYR61	3205	86043943	86048943
NM_001037160	chr2	-	10196925	10220538	CYS1	23613	10218038	10223038
NM_001282186	chrX	-	77526968	77583188	CYSLTR1	56220	77580688	77585688
NM_001308465	chr13	+	49227846	49285361	CYSLTR2	57515	49225346	49230346
NM_032412	chr5	+	139554652	139623374	CYSTM1	68722	139552152	139557152
NM_017456	chr17	-	76670128	76778424	CYTH1	108296	76775924	76780924
NM_017457	chr19	+	48972464	48985571	CYTH2	13107	48969964	48974964
NM_004227	chr7	-	6201411	6312242	CYTH3	110831	6309742	6314742
NM_001318024	chr22	+	37678423	37711389	CYTH4	32966	37675923	37680923
NM_004288	chr2	-	158271130	158300604	CYTIP	29474	158298104	158303104
NM_018659	chr4	-	5016313	5021197	CYTL1	4884	5018697	5023697
NR_024206	chr2	+	87754945	87821037	CYTOR	66092	87752445	87757445
NM_001320768	chr21	-	27838527	27945723	CYYR1	107196	27943223	27948223
NR_135515	chr21	+	27778261	27941571	CYYR1-AS1	163310	27775761	27780761
NR_147989	chr7	-	97481428	97601670	CZ1P-ASNS	120242	97599170	97604170
NR_040254	chr21	-	24733425	24757156	D21S2088E	23731	24754656	24759656
NM_152783	chr2	+	242673993	242708231	D2HGDH	34238	242671493	242676493
NM_001270520	chr14	+	59655380	59838123	DAAM1	182743	59652880	59657880
NM_001201427	chr6	+	39760158	39872653	DAAM2	112495	39757658	39762658
NM_021080	chr1	-	57463578	58716211	DAB1	1252633	58713711	58718711
NR_104363	chr1	+	58326214	58328786	DAB1-AS1	2572	58323714	58328714
NM_001244871	chr5	-	39371775	39425335	DAB2	53560	39422835	39427835
NM_032552	chr9	+	124329380	124547809	DAB2IP	218429	124326880	124331880
NM_080759	chr13	-	72012097	72441330	DACH1	429233	72438830	72443830
NM_053281	chrX	+	85403454	86087605	DACH2	684151	85400954	85405954
NR_046093	chr14	+	59100785	59115038	DACT1	14253	59098285	59103285
NM_001286351	chr6	-	168693509	168720434	DACT2	26925	168717934	168722934
NM_145056	chr19	-	47150868	47164395	DACT3	13527	47161895	47166895
NR_040042	chr19	+	47163620	47180713	DACT3-AS1	17093	47161120	47166120
NM_001344	chr14	-	23033806	23058143	DAD1	24337	23055643	23060643
NM_001177643	chr3	+	49506135	49573051	DAG1	66916	49503635	49508635
NM_006133	chr11	+	61447904	61514474	DAGLA	66570	61445404	61450404
NM_139179	chr7	-	6448746	6487643	DAGLB	38897	6485143	6490143
NM_018114	chr3	-	49052920	49058504	DALRD3	5584	49056004	49061004
NR_145129	chr4	+	53578560	53586864	DANCR	8304	53576060	53581060
NM_152654	chr19	+	13080431	13085567	DAND5	5136	13077931	13082931
NR_147172	chrX	+	114957296	115021860	DANT1	64564	114954796	114959796
NR_132337	chrX	-	114956728	115085444	DANT2	128716	115082944	115087944
NM_001917	chr12	+	109273856	109294710	DAO	20854	109271356	109276356
NM_001161814	chr13	+	106118215	106143383	DAOA	25168	106115715	106120715
NR_040247	chr13	-	106111405	106158030	DAOA-AS1	46625	106155530	106160530
NM_004394	chr5	-	10679341	10761387	DAP	82046	10758887	10763887
NM_001199850	chr1	+	155658881	155708800	DAP3	49919	155656381	155661381
NM_001288731	chr9	+	90112142	90323549	DAPK1	211407	90109642	90114642
NM_014326	chr15	-	64199234	64338521	DAPK2	139287	64336021	64341021
NM_001348	chr19	-	3958450	3971121	DAPK3	12671	3968621	3973621
NM_001017920	chr2	+	159651828	159672496	DAPL1	20668	159649328	159654328
NM_014395	chr4	+	100737980	100791346	DAPP1	53366	100735480	100740480
NM_001293312	chr2	-	136663450	136743254	DARS	79804	136740754	136745754
NR_110199	chr2	+	136742745	136765112	DARS-AS1	22367	136740245	136745245
NM_018122	chr1	+	173793796	173827682	DARS2	33886	173791296	173796296
NM_178821	chr2	+	228736091	228789059	DAW1	52968	228733591	228738591
NM_001254717	chr6_cox_hap2	-	4730148	4734611	DAXX	4463	4732111	4737111
NM_004081	chrY	-	25275501	25345239	DAZ1	69738	25342739	25347739
NM_001005785	chrY	+	26979989	27053187	DAZ2	73198	26977489	26982489
NM_020364	chrY	+	26979966	27053187	DAZ3	73221	26977466	26982466
NM_020420	chrY	+	26979966	27053187	DAZ4	73221	26977466	26982466
NM_170711	chr19	+	1407567	1435686	DAZAP1	28119	1405067	1410067
NM_001136269	chr12	+	51632507	51640501	DAZAP2	7994	51630007	51635007
NM_001351	chr3	-	16628300	16647006	DAZL	18706	16644506	16649506
NR_121644	chr4	+	190985656	190989019	DBET	3363	190983156	190988156
NM_006716	chr7	+	87505543	87538856	DBF4	33313	87503043	87508043
NR_148207	chr17	+	42785975	42829636	DBF4B	43661	42783475	42788475
NM_000787	chr9	+	136501484	136524466	DBH	22982	136498984	136503984
NR_102735	chr9	-	136519708	136522530	DBH-AS1	2822	136520030	136525030
NM_001178043	chr2	+	120124499	120130127	DBI	5628	120121999	120126999
NR_024120	chr17	+	655572	658576	DBIL5P	3004	653072	658072
NM_004395	chr5	-	176883613	176900694	DBN1	17081	176898194	176903194
NM_001288709	chr16	-	90071272	90086539	DBNDD1	15267	90084039	90089039
NM_001197139	chr20	+	44034632	44039250	DBNDD2	4618	44032132	44037132
NM_001284313	chr7	+	44084238	44101316	DBNL	17078	44081738	44086738
NM_001352	chr19	-	49133816	49140807	DBP	6991	49138307	49143307
NM_016216	chr3	-	137879829	137893791	DBR1	13962	137891291	137896291
NM_001918	chr1	-	100652477	100715409	DBT	62932	100712909	100717909
NM_001029865	chr11	-	20177759	20181870	DBX1	4111	20179370	20184370
NM_001004329	chr12	-	45408538	45444882	DBX2	36344	45442382	45447382
NM_014703	chr3	-	51433297	51534018	DCAF1	100721	51531518	51536518
NM_001286810	chr9	+	37800550	37867665	DCAF10	67115	37798050	37803050
NM_001163484	chr14	+	24583905	24594451	DCAF11	10546	24581405	24586405
NM_015397	chr9	-	34086380	34126771	DCAF12	40391	34124271	34129271
NM_178470	chrX	-	125683365	125686842	DCAF12L1	3477	125684342	125689342
NM_001013628	chrX	-	125297481	125300080	DCAF12L2	2599	125297580	125302580
NM_015420	chr8	+	104426941	104455680	DCAF13	28739	104424441	104429441
NM_138353	chr19	+	14063285	14072261	DCAF15	8976	14060785	14065785
NR_144299	chr4	-	17795070	17812381	DCAF16	17311	17809881	17814881
NM_001164821	chr2	+	172290760	172341562	DCAF17	50802	172288260	172293260
NM_001352448	chr14	+	73393039	73428775	DCAF4	35736	73390539	73395539
NM_001029955	chr4	+	41983712	41988484	DCAF4L1	4772	41981212	41986212
NM_152418	chr8	-	88882970	88886296	DCAF4L2	3326	88883796	88888796
NM_001284206	chr14	-	69517636	69619914	DCAF5	102278	69617414	69622414
NM_001349774	chr1	+	167905476	168045081	DCAF6	139605	167902976	167907976
NM_005828	chr17	+	61627795	61671642	DCAF7	43847	61625295	61630295
NM_015726	chr1	-	160185504	160232350	DCAF8	46846	160229850	160234850
NM_001017930	chrX	-	27996109	27999566	DCAF8L1	3457	27997066	28002066
NM_001321326	chr17	-	43100705	43138497	DCAKD	37792	43135997	43140997
NM_130848	chr5	-	134779903	134783038	DCANP1	3135	134780538	134785538
NM_173674	chr6	+	117803766	117891020	DCBLD1	87254	117801266	117806266
NM_080927	chr3	-	98514813	98620533	DCBLD2	105720	98618033	98623033
NM_005215	chr18	+	49866541	51062273	DCC	1195732	49864041	49869041
NM_053283	chr12	-	55038374	55042277	DCD	3903	55039777	55044777
NM_001350255	chr11	-	30886490	31391357	DCDC1	504867	31388857	31393857
NM_001195610	chr6	-	24171982	24383520	DCDC2	211538	24381020	24386020
NM_001099434	chr1	+	32674694	32681797	DCDC2B	7103	32672194	32677194
NM_001287444	chr2	+	3751181	3895000	DCDC2C	143819	3748681	3753681
NM_003737	chr11	-	6642554	6677080	DCHS1	34526	6674580	6679580
NM_001142552	chr4	-	155243805	155412877	DCHS2	169072	155410377	155415377
NM_000788	chr4	+	71859264	71896629	DCK	37365	71856764	71861764
NM_001330072	chr13	-	36342788	36706157	DCLK1	363369	36703657	36708657
NR_036614	chr4	+	150999425	151178608	DCLK2	179183	150996925	151001925
NM_033403	chr3	-	36753912	36781352	DCLK3	27440	36778852	36783852
NM_001271816	chr10	-	115594482	115614163	DCLRE1A	19681	115611663	115616663
NM_001319947	chr1	+	114447240	114456708	DCLRE1B	9468	114444740	114449740
NM_001350965	chr10	-	14939562	14996431	DCLRE1C	56869	14993931	14998931
NR_144469	chr10	-	15057070	15077424	DCLRE1CP1	20354	15074924	15079924
NM_001920	chr12	-	91537053	91576901	DCN	39848	91574401	91579401
NM_001290205	chr3	-	53317444	53381654	DCP1A	64210	53379154	53384154
NR_135060	chr12	-	2050756	2113701	DCP1B	62945	2111201	2116201
NM_001242377	chr5	+	112312406	112357892	DCP2	45486	112309906	112314906
NM_001350236	chr11	+	126173646	126219900	DCPS	46254	126171146	126176146
NM_152494	chr1	+	155006281	155023406	DCST1	17125	155003781	155008781
NR_040773	chr1	-	155017667	155036467	DCST1-AS1	18800	155033967	155038967
NM_144622	chr1	-	154991002	155006257	DCST2	15255	155003757	155008757
NM_001257317	chr8	+	105352023	105368917	DCSTAMP	16894	105349523	105354523
NM_001322185	chr13	-	95089557	95201667	DCT	112110	95199167	95204167
NM_001921	chr4	-	183811243	183838630	DCTD	27387	183836130	183841130
NM_001190836	chr2	-	74588280	74619214	DCTN1	30934	74616714	74621714
NR_024463	chr2	+	74612844	74621008	DCTN1-AS1	8164	74610344	74615344
NM_006400	chr12	-	57923832	57941114	DCTN2	17282	57938614	57943614
NM_024348	chr9	-	34613541	34620520	DCTN3	6979	34618020	34623020
NM_001135643	chr5	-	150088308	150138657	DCTN4	50349	150136157	150141157
NR_037573	chr16	+	23652686	23685068	DCTN5	32382	23650186	23655186
NM_006571	chr8	+	30013812	30041155	DCTN6	27343	30011312	30016312
NM_024096	chr16	-	30435018	30441373	DCTPP1	6355	30438873	30443873
NM_001308101	chr3	-	182655945	182703741	DCUN1D1	47796	182701241	182706241
NM_001014283	chr13	-	114110133	114145023	DCUN1D2	34890	114142523	114147523
NM_173475	chr16	-	20866246	20911680	DCUN1D3	45434	20909180	20914180
NM_015115	chr4	+	52709165	52783003	DCUN1D4	73838	52706665	52711665
NM_001318741	chr11	-	102921412	102962944	DCUN1D5	41532	102960444	102965444
NM_178152	chrX	-	110537006	110655460	DCX	118454	110652960	110657960
NM_024050	chr19	+	17420336	17434106	DDA1	13770	17417836	17422836
NM_001134445	chr1	-	85784167	86044046	DDAH1	259879	86041546	86046546
NM_001303007	chr6	-	31694813	31698042	DDAH2	3229	31695542	31700542
NM_001923	chr11	-	61066918	61100684	DDB1	33766	61098184	61103184
NM_000107	chr11	+	47236492	47260769	DDB2	24277	47233992	47238992
NM_001082971	chr7	-	50526133	50633154	DDC	107021	50630654	50635654
NR_033845	chr7	+	50599456	50611161	DDC-AS1	11705	50596956	50601956
NM_001160147	chr14	-	53503457	53620046	DDHD1	116589	53617546	53622546
NM_015214	chr8	+	38089008	38120287	DDHD2	31279	38086508	38091508
NM_001001711	chr11	+	103907307	103909922	DDI1	2615	103904807	103909807
NM_032341	chr1	+	15943952	15987552	DDI2	43600	15941452	15946452
NM_145018	chr11	+	82612736	82645699	DDIAS	32963	82610236	82615236
NM_001195056	chr12	-	57910370	57914300	DDIT3	3930	57911800	57916800
NM_145244	chr4	-	101107026	101111655	DDIT4L	4629	101109155	101114155
NM_015086	chr12	-	49388932	49393088	DDN	4156	49390588	49395588
NR_147179	chr12	+	49392129	49413023	DDN-AS1	20894	49389629	49394629
NM_003649	chr6	-	110713382	110736753	DDO	23371	110734253	110739253
NM_005216	chr1	-	20978259	20988037	DDOST	9778	20985537	20990537
NM_001297652	chr6_dbb_hap3	+	2144492	2162051	DDR1	17559	2141992	2146992
NM_001014796	chr1	+	162602227	162750247	DDR2	148020	162599727	162604727
NM_023935	chr20	-	3170995	3185343	DDRGK1	14348	3182843	3187843
NM_001355	chr22	-	24313553	24322019	DDT	8466	24319519	24324519
NM_001084393	chr22	+	24309025	24314748	DDTL	5723	24306525	24311525
NM_004939	chr2	+	15731744	15771235	DDX1	39491	15729244	15734244
NM_004398	chr11	+	108535751	108811657	DDX10	275906	108533251	108538251
NM_001257144	chr12	+	31226778	31257725	DDX11	30947	31224278	31229278
NR_038927	chr12	-	31173696	31226781	DDX11-AS1	53085	31224281	31229281
NR_046018	chr1	+	11873	14409	DDX11L1	2536	9373	14373
NR_045117	chr16	+	61554	64090	DDX11L10	2536	59054	64054
NR_110561	chrX	-	155255322	155257848	DDX11L16	2526	155255348	155260348
NR_024004	chr2	-	114356604	114361294	DDX11L2	4690	114358794	114363794
NR_051986	chr9	+	11986	14525	DDX11L5	2539	9486	14486
NR_034090	chr15	-	102516760	102519296	DDX11L9	2536	102516796	102521796
NR_033399	chr12	-	9570286	9600768	DDX12P	30482	9598268	9603268
NM_001098504	chr22	-	38879442	38902345	DDX17	22903	38899845	38904845
NM_006773	chr2	+	118572254	118589953	DDX18	17699	118569754	118574754
NM_001320527	chr16	+	70380731	70407286	DDX19A	26555	70378231	70383231
NM_001257174	chr16	+	70323669	70367735	DDX19B	44066	70321169	70326169
NM_007204	chr1	+	112298189	112310199	DDX20	12010	112295689	112300689
NM_004728	chr10	+	70715878	70744825	DDX21	28947	70713378	70718378
NM_004818	chr12	-	49223538	49245957	DDX23	22419	49243457	49248457
NM_020414	chr14	-	94517267	94547558	DDX24	30291	94545058	94550058
NM_001330438	chr11	+	125773270	125793298	DDX25	20028	125770770	125775770
NM_001348187	chr20	+	47835831	47860614	DDX27	24783	47833331	47838331
NM_018380	chr16	-	68055176	68057770	DDX28	2594	68055270	68060270
NM_001322341	chr9	-	135468383	135545788	DDX31	77405	135543288	135548288
NM_005804	chr19	-	14519609	14530195	DDX39A	10586	14527695	14532695
NM_080598	chr6	-	31497995	31510252	DDX39B	12257	31507752	31512752
NR_126093	chrX	+	41192560	41223725	DDX3X	31165	41190060	41195060
NM_001122665	chrY	+	15015909	15032390	DDX3Y	16481	15013409	15018409
NM_024415	chr5	+	55033844	55112974	DDX4	79130	55031344	55036344
NM_016222	chr5	-	176938577	176944327	DDX41	5750	176941827	176946827
NM_203499	chr17	+	61851548	61896677	DDX42	45129	61849048	61854048
NM_018665	chr6	+	74104284	74127289	DDX43	23005	74101784	74106784
NM_014829	chr5	+	134094423	134166826	DDX46	72403	134091923	134096923
NM_016355	chr12	+	12966279	12982915	DDX47	16636	12963779	12968779
NR_033677	chr19	+	19030483	19039442	DDX49	8959	19027983	19032983
NM_001320595	chr17	-	62494371	62503156	DDX5	8785	62500656	62505656
NM_024045	chr10	+	70661033	70706603	DDX50	45570	70658533	70663533
NM_175066	chr12	-	132621139	132628880	DDX51	7741	132626380	132631380
NM_007010	chr17	-	35969789	36003493	DDX52	33704	36000993	36005993
NM_024072	chr12	-	113594977	113623284	DDX54	28307	113620784	113625784
NR_135104	chr12	+	124086623	124105490	DDX55	18867	124084123	124089123
NM_001257189	chr7	-	44605015	44614137	DDX56	9122	44611637	44616637
NM_014314	chr9	-	32455299	32526322	DDX58	71023	32523822	32528822
NM_001320181	chr1	-	200609934	200639126	DDX59	29192	200636626	200641626
NM_004397	chr11	-	118618472	118661972	DDX6	43500	118659472	118664472
NM_017631	chr4	-	169137441	169239958	DDX60	102517	169237458	169242458
NM_001345927	chr4	-	169277885	169401665	DDX60L	123780	169399165	169404165
NM_001293634	chr11	-	644219	695754	DEAF1	51535	693254	698254
NM_017418	chr9	+	117904096	118164923	DEC1	260827	117901596	117906596
NM_001330575	chr8	+	91013579	91065861	DECR1	52282	91011079	91016079
NM_020664	chr16	+	451857	462487	DECR2	10630	449357	454357
NM_032998	chr1	-	161090768	161102478	DEDD	11710	161099978	161104978
NM_001270614	chr19	-	42702744	42724304	DEDD2	21560	42721804	42726804
NM_022047	chr6	+	35265594	35289548	DEF6	23954	35263094	35268094
NM_001242818	chr16	+	90015138	90034468	DEF8	19330	90012638	90017638
NM_001925	chr8	-	6793341	6795860	DEFA4	2519	6793360	6798360
NM_005218	chr8	-	6728096	6735529	DEFB1	7433	6733029	6738029
NM_080389	chr8	-	7327829	7332604	DEFB104A	4775	7330104	7335104
NM_001040702	chr8	-	7327829	7332604	DEFB104B	4775	7330104	7335104
NM_152251	chr8	-	7340025	7343909	DEFB106A	3884	7341409	7346409
NM_001040704	chr8	-	7340025	7343909	DEFB106B	3884	7341409	7346409
NM_001037668	chr8	+	7353367	7366833	DEFB107A	13466	7350867	7355867
NM_001040705	chr8	+	7353367	7366833	DEFB107B	13466	7350867	7355867
NM_001002035	chr11	+	71544245	71548608	DEFB108B	4363	71541745	71546745
NR_024044	chr8	-	12250792	12257874	DEFB109A	7082	12255374	12260374
NR_003668	chr8	-	7847936	7855043	DEFB109B	7107	7852543	7857543
NM_001037728	chr6	-	49976850	49989694	DEFB110	12844	49987194	49992194
NM_001037498	chr6	-	50011287	50016364	DEFB112	5077	50013864	50018864
NM_001037499	chr6	-	49928004	49931818	DEFB114	3814	49929318	49934318
NM_001037731	chr20	-	29891014	29896388	DEFB116	5374	29893888	29898888
NM_054112	chr20	+	29956420	29961705	DEFB118	5285	29953920	29958920
NR_126440	chr20	-	29964965	29978452	DEFB119	13487	29975952	29980952
NM_001171832	chr20	-	29992647	30000641	DEFB121	7994	29998141	30003141
NR_045677	chr20	-	30009241	30016983	DEFB122	7742	30014483	30019483
NM_153324	chr20	+	30028321	30038060	DEFB123	9739	30025821	30030821
NM_001037500	chr20	-	30053308	30060816	DEFB124	7508	30058316	30063316
NM_153325	chr20	+	68312	77214	DEFB125	8902	65812	70812
NM_030931	chr20	+	123193	126392	DEFB126	3199	120693	125693
NM_080831	chr20	+	207898	210527	DEFB129	2629	205398	210398
NM_001037804	chr8	-	11921897	11929256	DEFB130A	7359	11926756	11931756
NM_001195257	chr8	-	11921897	11929256	DEFB130B	7359	11926756	11931756
NM_001040448	chr4	+	9446259	9452240	DEFB131A	5981	9443759	9448759
NM_001242853	chr11	+	71589498	71595607	DEFB131B	6109	71586998	71591998
NM_207469	chr20	+	238376	241736	DEFB132	3360	235876	240876
NM_001166478	chr6	-	49913813	49917157	DEFB133	3344	49914657	49919657
NM_001302695	chr8	-	11850685	11858261	DEFB134	7576	11855761	11860761
NR_036686	chr8	-	6844699	6847243	DEFT1P	2544	6844743	6849743
NR_036687	chr8	-	6844699	6847243	DEFT1P2	2544	6844743	6849743
NM_003676	chr1	+	224370909	224381142	DEGS1	10233	224368409	224373409
NM_206918	chr14	-	100612752	100626012	DEGS2	13260	100623512	100628512
NM_003472	chr6	-	18224399	18264799	DEK	40400	18262299	18267299
NM_020946	chr9	-	126141932	126692417	DENND1A	550485	126689917	126694917
NM_001195215	chr1	-	197473878	197744623	DENND1B	270745	197742123	197747123
NM_024898	chr19	-	6467214	6481819	DENND1C	14605	6479319	6484319
NM_001318052	chr7	-	140218218	140340576	DENND2A	122358	140338076	140343076
NM_198459	chr1	-	115127195	115212732	DENND2C	85537	115210232	115215232
NM_001271833	chr1	-	111728590	111747160	DENND2D	18570	111744660	111749660
NR_148197	chr8	+	142138710	142205903	DENND3	67193	142136210	142141210
NM_001144823	chr15	-	65951460	66084631	DENND4A	133171	66082131	66087131
NM_014856	chr1	-	153901976	153919154	DENND4B	17178	153916654	153921654
NM_001330640	chr9	+	19230487	19374266	DENND4C	143779	19227987	19232987
NM_001348748	chr11	-	9160374	9286873	DENND5A	126499	9284373	9289373
NM_144973	chr12	-	31535156	31743952	DENND5B	208796	31741452	31746452
NR_046909	chr12	+	31742856	31768285	DENND5B-AS1	25429	31740356	31745356
NM_152678	chr3	-	57611180	57678816	DENND6A	67636	57676316	57681316
NM_001001794	chr22	-	50750391	50765489	DENND6B	15098	50762989	50767989
NM_003677	chr12	+	123237367	123255611	DENR	18244	123234867	123239867
NM_017779	chr1	-	68939834	68962904	DEPDC1	23070	68960404	68965404
NR_110671	chr1	+	68962358	69004310	DEPDC1-AS1	41952	68959858	68964858
NM_001145208	chr5	-	59892738	59995993	DEPDC1B	103255	59993493	59998493
NR_135073	chr12	-	100597446	100660857	DEPDC4	63411	100658357	100663357
NM_001242897	chr22	+	32149936	32303020	DEPDC5	153084	32147436	32152436
NM_001077242	chr11	+	33037409	33055128	DEPDC7	17719	33034909	33039909
NM_022783	chr8	+	120885894	121063157	DEPTOR	177263	120883394	120888394
NM_015954	chr12	+	16064105	16190315	DERA	126210	16061605	16066605
NM_001330601	chr8	-	124025403	124054663	DERL1	29260	124052163	124057163
NR_130906	chr17	-	5374570	5389550	DERL2	14980	5387050	5392050
NM_198440	chr22	-	24176689	24181199	DERL3	4510	24178699	24183699
NM_001927	chr2	+	220283098	220291461	DES	8363	220280598	220285598
NM_015704	chr22	-	41994031	42017061	DESI1	23030	42014561	42019561
NR_123735	chr1	+	244816349	244872336	DESI2	55987	244813849	244818849
NR_135742	chr15	-	89045154	89089934	DET1	44780	89087434	89092434
NM_181645	chr11	+	93063882	93171636	DEUP1	107754	93061382	93066382
NM_014015	chr16	-	11022747	11036257	DEXI	13510	11033757	11038757
NM_004401	chr1	-	10520602	10532613	DFFA	12011	10530113	10535113
NM_001320136	chr1	+	3773830	3801993	DFFB	28163	3771330	3776330
NM_004403	chr7	-	24737973	24797639	DFNA5	59666	24795139	24800139
NM_012079	chr8	-	145538245	145550582	DGAT1	12337	145548082	145553082
NM_001253891	chr11	+	75479777	75512581	DGAT2	32804	75477277	75482277
NM_198512	chrX	+	69397332	69425553	DGAT2L6	28221	69394832	69399832
NM_001173533	chr22	-	19023794	19109967	DGCR2	86173	19107467	19112467
NR_110533	chr22	+	18958010	19018755	DGCR5	60745	18955510	18960510
NM_005675	chr22	+	18893735	18899601	DGCR6	5866	18891235	18896235
NM_033257	chr22	-	20301760	20307628	DGCR6L	5868	20305128	20310128
NM_022720	chr22	+	20067754	20099400	DGCR8	31646	20065254	20070254
NM_001345	chr12	+	56324945	56347807	DGKA	22862	56322445	56327445
NM_001350707	chr7	-	14184673	15014402	DGKB	829729	15011902	15016902
NM_152879	chr2	+	234263152	234380743	DGKD	117591	234260652	234265652
NM_003647	chr17	+	54911459	54946036	DGKE	34577	54908959	54913959
NM_001346	chr3	-	185864989	186080023	DGKG	215034	186077523	186082523
NM_001204504	chr13	+	42614171	42817033	DGKH	202862	42611671	42616671
NM_001321708	chr7	-	137072395	137531610	DGKI	459215	137529110	137534110
NM_001013742	chrX	-	50108405	50213737	DGKK	105332	50211237	50216237
NM_001347	chr4	-	952671	967348	DGKQ	14677	964848	969848
NM_201532	chr11	+	46354454	46402104	DGKZ	47650	46351954	46356954
NM_001318863	chr2	+	74153952	74186088	DGUOK	32136	74151452	74156452
NR_104030	chr2	-	74185094	74208566	DGUOK-AS1	23472	74206066	74211066
NM_014762	chr1	-	55315299	55352921	DHCR24	37622	55350421	55355421
NM_001163817	chr11	-	71145456	71159477	DHCR7	14021	71156977	71161977
NM_024887	chr1	+	26758772	26797795	DHDDS	39023	26756272	26761272
NM_014475	chr19	+	49436938	49448226	DHDH	11288	49434438	49439438
NM_000791	chr5	-	79922044	79950800	DHFR	28756	79948300	79953300
NM_001195643	chr3	-	93776765	93782067	DHFR2	5302	93779567	93784567
NM_021044	chr12	-	49480438	49488602	DHH	8164	49486102	49491102
NM_001361	chr16	+	72042642	72059316	DHODH	16674	72040142	72045142
NM_001930	chr19	-	12786530	12792701	DHPS	6171	12790201	12795201
NM_001136050	chr14	-	24759803	24769039	DHRS1	9236	24766539	24771539
NM_024308	chr17	+	34948225	34957233	DHRS11	9008	34945725	34950725
NM_001270424	chr13	-	52342128	52378298	DHRS12	36170	52375798	52380798
NM_144683	chr17	-	27224798	27230089	DHRS13	5291	27227589	27232589
NM_001318835	chr14	+	24099323	24111647	DHRS2	12324	24096823	24101823
NM_004753	chr1	-	12627938	12677737	DHRS3	49799	12675237	12680237
NM_021004	chr14	+	24422943	24438488	DHRS4	15545	24420443	24425443
NR_023922	chr14	-	24407939	24424321	DHRS4-AS1	16382	24421821	24426821
NR_102688	chr14	+	24476217	24520586	DHRS4L1	44369	24473717	24478717
NM_001193637	chr14	+	24439082	24475617	DHRS4L2	36535	24436582	24441582
NM_001322280	chr14	-	60610837	60636582	DHRS7	25745	60634082	60639082
NM_015510	chr17	+	21030240	21095285	DHRS7B	65045	21027740	21032740
NM_001220493	chr17	-	9674750	9694614	DHRS7C	19864	9692114	9697114
NM_001289763	chr2	+	169923544	169952677	DHRS9	29133	169921044	169926044
NM_145177	chrX	-	2137554	2419015	DHRSX	281461	2416515	2421515
NM_018706	chr10	+	12110915	12165227	DHTKD1	54312	12108415	12113415
NM_001358	chr4	-	24529087	24586184	DHX15	57097	24583684	24588684
NM_001164239	chr6_ssto_hap7	-	1953167	1973134	DHX16	19967	1970634	1975634
NM_019030	chr5	-	54551882	54603550	DHX29	51668	54601050	54606050
NM_001330990	chr3	+	47844398	47891686	DHX30	47288	47841898	47846898
NM_018180	chr10	-	127524908	127569884	DHX32	44976	127567384	127572384
NM_001199699	chr17	-	5344231	5372380	DHX33	28149	5369880	5374880
NM_014681	chr19	+	47852537	47885961	DHX34	33424	47850037	47855037
NM_021931	chr20	+	37590980	37668366	DHX35	77386	37588480	37593480
NM_020865	chr3	-	153993456	154042286	DHX36	48830	154039786	154044786
NM_032656	chr12	-	125431369	125473667	DHX37	42298	125471167	125476167
NM_014003	chr16	+	72127614	72146811	DHX38	19197	72125114	72130114
NM_024612	chr17	+	57642885	57685713	DHX40	42828	57640385	57645385
NM_001329963	chr2	-	39024875	39103075	DHX57	78200	39100575	39105575
NM_024119	chr17	-	40253421	40264751	DHX58	11330	40262251	40267251
NM_001322219	chr17	+	41561232	41622155	DHX8	60923	41558732	41563732
NM_001357	chr1	+	182808438	182857117	DHX9	48679	182805938	182810938
NM_019887	chr12	-	122692208	122712081	DIABLO	19873	122709581	122714581
NM_005219	chr5	-	140894587	140998622	DIAPH1	104035	140996122	141001122
NM_006729	chrX	+	95939661	96855597	DIAPH2	915936	95937161	95942161
NR_125391	chrX	-	96783362	96819534	DIAPH2-AS1	36172	96817034	96822034
NM_001258368	chr13	-	60239720	60738119	DIAPH3	498399	60735619	60740619
NR_046539	chr13	+	60586851	60618490	DIAPH3-AS1	31639	60584351	60589351
NR_046540	chr13	+	60718831	60727639	DIAPH3-AS2	8808	60716331	60721331
NM_030621	chr14	-	95552564	95624347	DICER1	71783	95621847	95626847
NR_015415	chr14	+	95624024	95646270	DICER1-AS1	22246	95621524	95626524
NM_033081	chr20	-	61509089	61569304	DIDO1	60215	61566804	61571804
NM_014388	chr1	+	210001311	210030910	DIEXF	29599	209998811	210003811
NR_144432	chr14	+	95236978	95239944	DIGIT	2966	95234478	95239478
NM_014473	chr5	-	61683779	61699787	DIMT1	16008	61697287	61702287
NM_000792	chr1	+	54359859	54376759	DIO1	16900	54357359	54362359
NM_000793	chr14	-	80663867	80697397	DIO2	33530	80694897	80699897
NR_038355	chr14	+	80677761	80921810	DIO2-AS1	244049	80675261	80680261
NR_002770	chr14	-	102018559	102022013	DIO3OS	3454	102019513	102024513
NM_015151	chr21	+	47878861	47989926	DIP2A	111065	47876361	47881361
NR_046400	chr21	+	47882383	47889218	DIP2A-IT1	6835	47879883	47884883
NM_173602	chr12	+	50898767	51142450	DIP2B	243683	50896267	50901267
NM_014974	chr10	-	320129	735608	DIP2C	415479	733108	738108
NM_145173	chr19	-	2714564	2721390	DIRAS1	6826	2718890	2723890
NM_017594	chr9	-	93372113	93405387	DIRAS2	33274	93402887	93407887
NM_004675	chr1	-	68511644	68517314	DIRAS3	5670	68514814	68519814
NM_052952	chr2	-	189598464	189654831	DIRC1	56367	189652331	189657331
NM_032839	chr3	+	122513900	122599986	DIRC2	86086	122511400	122516400
NR_026597	chr2	-	218148745	218621316	DIRC3	472571	218618816	218623816
NR_133642	chr2	+	218147455	218208927	DIRC3-AS1	61472	218144955	218149955
NM_001322348	chr13	-	73329539	73356266	DIS3	26727	73353766	73358766
NM_133375	chr15	+	66585594	66626236	DIS3L	40642	66583094	66588094
NM_001257281	chr2	+	232826292	233208678	DIS3L2	382386	232823792	232828792
NM_018662	chr1	+	231762560	232177019	DISC1	414459	231760060	231765060
NR_126441	chr1	+	232061579	232080951	DISC1-IT1	19372	232059079	232064079
NR_104190	chr11	+	89984399	90648220	DISC1FP1	663821	89981899	89986899
NR_002227	chr1	-	231950371	231954263	DISC2	3892	231951763	231956763
NM_032890	chr1	+	222988422	223179337	DISP1	190915	222985922	222990922
NM_033510	chr15	+	40650435	40663257	DISP2	12822	40647935	40652935
NM_020780	chr1	+	11539294	11597640	DISP3	58346	11536794	11541794
NM_001037954	chr11	+	111807926	111893374	DIXDC1	85448	111805426	111810426
NR_110022	chrX	+	153991016	154005964	DKC1	14948	153988516	153993516
NR_026964	chr9	-	139216997	139221779	DKFZP434A062	4782	139219279	139224279
NR_026882	chr11	-	61521500	61525136	DKFZP434K028	3636	61522636	61527636
NR_002186	chr7	+	30409665	30412410	DKFZP586I1420	2745	30407165	30412165
NR_033862	chr6	-	163759373	163768065	DKFZp451B082	8692	163765565	163770565
NM_012242	chr10	+	54074040	54077417	DKK1	3377	54071540	54076540
NM_014421	chr4	-	107842958	107957453	DKK2	114495	107954953	107959953
NM_001330220	chr11	-	11984542	12030917	DKK3	46375	12028417	12033417
NM_014420	chr8	-	42231585	42234674	DKK4	3089	42232174	42237174
NM_001197302	chr19	+	49866986	49878373	DKKL1	11387	49864486	49869486
NM_001931	chr11	+	111895537	111935002	DLAT	39465	111893037	111898037
NM_001348082	chr8	-	12940871	13462125	DLC1	521254	13459625	13464625
NM_001289751	chr7	+	107531551	107561643	DLD	30092	107529051	107534051
NM_007335	chr3	+	38080695	38164232	DLEC1	83537	38078195	38083195
NR_109974	chr13	+	50656304	51102779	DLEU1	446475	50653804	50658804
NR_125753	chr13	-	51095068	51101585	DLEU1-AS1	6517	51099085	51104085
NR_002612	chr13	-	50556687	50699677	DLEU2	142990	50697177	50702177
NM_198989	chr13	-	51285161	51418075	DLEU7	132914	51415575	51420575
NR_046551	chr13	+	51381990	51424041	DLEU7-AS1	42051	51379490	51384490
NM_001290983	chr3	-	196769430	197026143	DLG1	256713	197023643	197028643
NR_038289	chr3	+	197025117	197030621	DLG1-AS1	5504	197022617	197027617
NM_001351274	chr11	-	83166055	85339381	DLG2	2173326	85336881	85341881
NM_021120	chrX	+	69664704	69725339	DLG3	60635	69662204	69667204
NR_109801	chrX	-	69672805	69675844	DLG3-AS1	3039	69673344	69678344
NM_001365	chr17	-	7093209	7123369	DLG4	30160	7120869	7125869
NM_004747	chr10	-	79550548	79686348	DLG5	135800	79683848	79688848
NR_024585	chr10	+	79686569	79689583	DLG5-AS1	3014	79684069	79689069
NM_004746	chr18	-	3496029	4455266	DLGAP1	959237	4452766	4457766
NR_024101	chr18	+	3594111	3597377	DLGAP1-AS1	3266	3591611	3596611
NR_119377	chr18	+	3603734	3610087	DLGAP1-AS2	6353	3601234	3606234
NR_038895	chr18	+	3878179	3897069	DLGAP1-AS3	18890	3875679	3880679
NR_102696	chr18	+	3962352	4013943	DLGAP1-AS4	51591	3959852	3964852
NR_036489	chr18	+	4264601	4296000	DLGAP1-AS5	31399	4262101	4267101
NM_001346810	chr8	+	687718	1656642	DLGAP2	968924	685218	690218
NR_103863	chr8	-	1513675	1569830	DLGAP2-AS1	56155	1567330	1572330
NM_001080418	chr1	-	35331036	35395186	DLGAP3	64150	35392686	35397686
NM_014902	chr20	+	34894244	35157040	DLGAP4	262796	34891744	34896744
NR_109939	chr20	-	35136104	35201678	DLGAP4-AS1	65574	35199178	35204178
NM_014750	chr14	-	55614833	55658396	DLGAP5	43563	55655896	55660896
NM_003836	chr14	+	101193201	101204561	DLK1	11360	101190701	101195701
NM_001286655	chr6	-	43418089	43424370	DLK2	6281	43421870	43426870
NM_005618	chr6	-	170591293	170599697	DLL1	8404	170597197	170602197
NM_016941	chr19	+	39989556	39999121	DLL3	9565	39987056	39992056
NM_019074	chr15	+	41221530	41231258	DLL4	9728	41219030	41224030
NM_001933	chr14	+	75348593	75370450	DLST	21857	75346093	75351093
NR_130749	chr1	-	76207686	76210698	DLSTP1	3012	76208198	76213198
NM_178120	chr2	+	172950207	172954401	DLX1	4194	172947707	172952707
NM_004405	chr2	-	172964165	172967478	DLX2	3313	172964978	172969978
NR_126376	chr2	+	172967733	172974710	DLX2-AS1	6977	172965233	172970233
NM_005220	chr17	-	48067368	48072588	DLX3	5220	48070088	48075088
NM_138281	chr17	+	48046561	48052323	DLX4	5762	48044061	48049061
NM_005221	chr7	-	96649701	96654143	DLX5	4442	96651643	96656643
NM_005222	chr7	+	96635289	96640352	DLX6	5063	96632789	96637789
NR_015448	chr7	-	96597826	96643377	DLX6-AS1	45551	96640877	96645877
NR_147193	chr19	+	46271053	46275141	DM1-AS	4088	46268553	46273553
NM_001318059	chr9	-	7796490	7799806	DMAC1	3316	7797306	7802306
NR_135476	chr19	-	41937222	41945843	DMAC2	8621	41943343	41948343
NM_019100	chr1	+	44679124	44686351	DMAP1	7227	44676624	44681624
NM_001320644	chr10	+	124320180	124403252	DMBT1	83072	124317680	124322680
NR_003570	chr10	+	124516209	124557161	DMBT1P1	40952	124513709	124518709
NM_147192	chr1	+	46972667	46979886	DMBX1	7219	46970167	46975167
NM_007068	chr22	-	38914953	38966201	DMC1	51248	38963701	38968701
NM_000109	chrX	-	31137344	33357726	DMD	2220382	33355226	33360226
NM_013391	chr5	-	78293386	78365497	DMGDH	72111	78362997	78367997
NM_001126056	chr19	-	35988118	36004560	DMKN	16442	36002060	36007060
NM_004407	chr4	+	88571453	88585512	DMP1	14059	88568953	88573953
NM_001288764	chr19	-	46272966	46285815	DMPK	12849	46283315	46288315
NM_021951	chr9	+	841689	969090	DMRT1	127401	839189	844189
NM_006557	chr9	+	1050345	1057554	DMRT2	7209	1047845	1052845
NM_021240	chr9	+	976967	991732	DMRT3	14765	974467	979467
NM_022160	chr9	+	22446839	22452472	DMRTA1	5633	22444339	22449339
NM_032110	chr1	-	50883222	50889119	DMRTA2	5897	50886619	50891619
NM_033067	chr1	+	53925071	53933160	DMRTB1	8089	53922571	53927571
NM_033053	chrX	-	72091858	72095622	DMRTC1	3764	72093122	72098122
NM_001080851	chrX	-	72091858	72095622	DMRTC1B	3764	72093122	72098122
NM_001040283	chr19	+	42349085	42356397	DMRTC2	7312	42346585	42351585
NM_001142327	chr7	+	86781676	86825648	DMTF1	43972	86779176	86784176
NM_001323382	chr8	+	21906465	21940038	DMTN	33573	21903965	21908965
NM_004943	chr19	-	46286263	46296060	DMWD	9797	46293560	46298560
NM_001349240	chr5	+	118406749	118584824	DMXL1	178075	118404249	118409249
NM_001174117	chr15	-	51739920	51914967	DMXL2	175047	51912467	51917467
NR_102264	chr10	-	70173820	70231878	DNA2	58058	70229378	70234378
NM_178452	chr16	+	84178864	84211526	DNAAF1	32662	84176364	84181364
NM_018139	chr14	-	50091891	50101948	DNAAF2	10057	50099448	50104448
NM_001256716	chr19	-	55670028	55678090	DNAAF3	8062	55675590	55680590
NM_001033560	chr15	-	55709953	55800432	DNAAF4	90479	55797932	55802932
NR_037923	chr15	-	55647420	55790782	DNAAF4-CCPG1	143362	55788282	55793282
NM_017802	chr7	+	766337	826116	DNAAF5	59779	763837	768837
NM_015512	chr3	+	52350334	52434513	DNAH1	84179	52347834	52352834
NM_207437	chr12	+	124247041	124420267	DNAH10	173226	124244541	124249541
NM_001277115	chr7	+	21582832	21941186	DNAH11	358354	21580332	21585332
NM_001291661	chr3	-	57327726	57530071	DNAH12	202345	57527571	57532571
NM_001373	chr1	+	225117355	225586996	DNAH14	469641	225114855	225119855
NM_173628	chr17	-	76419777	76573476	DNAH17	153699	76570976	76575976
NR_102401	chr17	+	76480991	76499138	DNAH17-AS1	18147	76478491	76483491
NM_020877	chr17	+	7620671	7737062	DNAH2	116391	7618171	7623171
NM_017539	chr16	-	20944432	21170762	DNAH3	226330	21168262	21173262
NM_001369	chr5	-	13690436	13944589	DNAH5	254153	13942089	13947089
NM_001370	chr2	+	84743578	85046713	DNAH6	303135	84741078	84746078
NM_018897	chr2	-	196602426	196933536	DNAH7	331110	196931036	196936036
NM_001206927	chr6	+	38683116	38998574	DNAH8	315458	38680616	38685616
NM_001372	chr17	+	11501747	11873065	DNAH9	371318	11499247	11504247
NM_012144	chr9	+	34458749	34520987	DNAI1	62238	34456249	34461249
NM_001172810	chr17	+	72270348	72311023	DNAI2	40675	72267848	72272848
NM_001314039	chr9	+	33025200	33039906	DNAJA1	14706	33022700	33027700
NR_033424	chr1	+	102337567	102360299	DNAJA1P5	22732	102335067	102340067
NM_005880	chr16	-	46989273	47007625	DNAJA2	18352	47005125	47010125
NM_001286516	chr16	+	4475805	4506775	DNAJA3	30970	4473305	4478305
NM_018602	chr15	+	78556486	78574538	DNAJA4	18052	78553986	78558986
NM_001313964	chr19	-	14625575	14640134	DNAJB1	14559	14637634	14642634
NM_016306	chr3	+	186288464	186303589	DNAJB11	15125	186285964	186290964
NM_017626	chr10	-	74092587	74114907	DNAJB12	22320	74112407	74117407
NM_153614	chr11	+	73661363	73681332	DNAJB13	19969	73658863	73663863
NM_001278310	chr4	-	100817406	100867883	DNAJB14	50477	100865383	100870383
NM_006736	chr2	+	220144039	220151622	DNAJB2	7583	220141539	220146539
NM_001317100	chr1	+	78444841	78483648	DNAJB4	38807	78442341	78447341
NM_012266	chr9	+	34989637	34998430	DNAJB5	8793	34987137	34992137
NR_109756	chr9	-	34985408	34989376	DNAJB5-AS1	3968	34986876	34991876
NM_058246	chr7	+	157129710	157210133	DNAJB6	80423	157127210	157132210
NM_145174	chr22	-	41255553	41258130	DNAJB7	2577	41255630	41260630
NM_153330	chr3	-	128181274	128186091	DNAJB8	4817	128183591	128188591
NR_037890	chr3	+	128182436	128191160	DNAJB8-AS1	8724	128179936	128184936
NM_012328	chr7	+	108210188	108215294	DNAJB9	5106	108207688	108212688
NM_022365	chr10	-	22045476	22292650	DNAJC1	247174	22290150	22295150
NM_001271581	chr2	+	183580767	183644750	DNAJC10	63983	183578267	183583267
NM_018198	chr1	-	6694227	6761966	DNAJC11	67739	6759466	6764466
NM_021800	chr10	-	69556426	69597937	DNAJC12	41511	69595437	69600437
NM_001329126	chr3	+	132136503	132257876	DNAJC13	121373	132134003	132139003
NM_032364	chr12	-	56214743	56223420	DNAJC14	8677	56220920	56225920
NM_013238	chr13	+	43597361	43683306	DNAJC15	85945	43594861	43599861
NM_015291	chr1	+	15853307	15898228	DNAJC16	44921	15850807	15855807
NM_018163	chr15	-	41060066	41099676	DNAJC17	39610	41097176	41102176
NM_152686	chr5	-	138745891	138775214	DNAJC18	29323	138772714	138777714
NR_046073	chr3	-	180701497	180707562	DNAJC19	6065	180705062	180710062
NM_001129887	chr7	-	102952920	102985320	DNAJC2	32400	102982820	102987820
NM_001348420	chr5	+	34929697	34959069	DNAJC21	29372	34927197	34932197
NM_001304944	chr12	+	49740699	49747467	DNAJC22	6768	49738199	49743199
NM_181706	chr11	+	31391376	31454382	DNAJC24	63006	31388876	31393876
NR_037148	chr9	+	114393631	114416631	DNAJC25	23000	114391131	114396131
NM_004125	chr9	+	114393631	114432526	DNAJC25-GNG10	38895	114391131	114396131
NM_001198559	chr2	-	25166504	25194963	DNAJC27	28459	25192463	25197463
NR_034113	chr2	+	25194980	25262563	DNAJC27-AS1	67583	25192480	25197480
NM_001320746	chr21	-	34860361	34864030	DNAJC28	3669	34861530	34866530
NM_006260	chr13	+	96329392	96447243	DNAJC3	117851	96326892	96331892
NR_132117	chr13	-	96325091	96329179	DNAJC3-AS1	4088	96326679	96331679
NM_032317	chr7	-	73095247	73097781	DNAJC30	2534	73095281	73100281
NM_005528	chr11	+	63997752	64001753	DNAJC4	4001	63995252	64000252
NM_025219	chr20	+	62526454	62567384	DNAJC5	40930	62523954	62528954
NM_001349432	chr8	+	66927212	67013478	DNAJC5B	86266	66924712	66929712
NM_173650	chr2	+	27498288	27504298	DNAJC5G	6010	27495788	27500788
NM_014787	chr1	+	65730376	65881552	DNAJC6	151176	65727876	65732876
NM_003315	chr17	-	40128438	40169715	DNAJC7	41277	40167215	40172215
NM_014280	chr1	-	28526789	28559542	DNAJC8	32753	28557042	28562042
NM_015190	chr10	-	75001713	75007089	DNAJC9	5376	75004589	75009589
NR_038373	chr10	+	75007124	75036742	DNAJC9-AS1	29618	75004624	75009624
NM_031427	chr14	+	74111577	74170431	DNAL1	58854	74109077	74114077
NM_005740	chr22	-	39174512	39190161	DNAL4	15649	39187661	39192661
NM_003462	chr1	+	38022519	38032458	DNALI1	9939	38020019	38025019
NM_005223	chr16	+	3702939	3708096	DNASE1	5157	3700439	3705439
NM_001009932	chrX	-	153629576	153640428	DNASE1L1	10852	153637928	153642928
NM_001256560	chr3	-	58178352	58196730	DNASE1L3	18378	58194230	58199230
NM_001375	chr19	-	12986024	12992335	DNASE2	6311	12989835	12994835
NM_021233	chr1	+	84864214	84880691	DNASE2B	16477	84861714	84866714
NM_194249	chr5	-	140050380	140053171	DND1	2791	140050671	140055671
NM_139072	chr2	-	230222344	230579286	DNER	356942	230576786	230581786
NM_144666	chr11	+	6518525	6593254	DNHD1	74729	6516025	6521025
NM_001288737	chr9	+	130965633	131017527	DNM1	51894	130963133	130968133
NM_005690	chr12	+	32832133	32898584	DNM1L	66451	32829633	32834633
NR_024595	chr15	-	76020010	76032418	DNM1P35	12408	76029918	76034918
NR_033787	chr15	+	85045805	85050249	DNM1P41	4444	85043305	85048305
NR_003260	chr15	-	100330360	100347132	DNM1P46	16772	100344632	100349632
NR_145478	chr15	+	30686724	30689848	DNM1P50	3124	30684224	30689224
NM_001190716	chr19	+	10828728	10942586	DNM2	113858	10826228	10831228
NM_001350206	chr1	+	171810617	172387603	DNM3	576986	171808117	171813117
NR_038397	chr1	-	172106018	172113975	DNM3OS	7957	172111475	172116475
NM_015221	chr10	-	101635327	101769710	DNMBP	134383	101767210	101772210
NR_024130	chr10	+	101686965	101718755	DNMBP-AS1	31790	101684465	101689465
NM_001379	chr19	-	10244019	10305811	DNMT1	61792	10303311	10308311
NR_135490	chr2	-	25455829	25565459	DNMT3A	109630	25562959	25567959
NM_006892	chr20	+	31350190	31397162	DNMT3B	46972	31347690	31352690
NM_175867	chr21	-	45666221	45682099	DNMT3L	15878	45679599	45684599
NM_001319116	chr2	-	220236750	220264744	DNPEP	27994	220262244	220267244
NM_199184	chr6	-	43193366	43197211	DNPH1	3845	43194711	43199711
NM_004088	chr10	+	98064084	98098321	DNTT	34237	98061584	98066584
NM_052951	chr20	+	44420575	44440066	DNTTIP1	19491	44418075	44423075
NM_014597	chr1	-	94335013	94344762	DNTTIP2	9749	94342262	94347262
NM_001282062	chr16	-	30016834	30024917	DOC2A	8083	30022417	30027417
NM_003585	chr17	-	6010	31421	DOC2B	25411	28921	33921
NM_001290223	chr10	+	128593977	129250781	DOCK1	656804	128591477	128596477
NM_014689	chr2	-	225629806	225907330	DOCK10	277524	225904830	225909830
NM_144658	chrX	+	117629871	117820123	DOCK11	190252	117627371	117632371
NM_004946	chr5	+	169064250	169510386	DOCK2	446136	169061750	169066750
NM_004947	chr3	+	50712671	51421629	DOCK3	708958	50710171	50715171
NM_014705	chr7	-	111366163	111846462	DOCK4	480299	111843962	111848962
NR_103806	chr7	+	111448560	111461835	DOCK4-AS1	13275	111446060	111451060
NM_024940	chr8	+	25042237	25273232	DOCK5	230995	25039737	25044737
NM_020812	chr19	-	11309968	11373168	DOCK6	63200	11370668	11375668
NM_001272001	chr1	-	62920396	63154039	DOCK7	233643	63151539	63156539
NM_203447	chr9	+	214864	465259	DOCK8	250395	212364	217364
NM_015296	chr13	-	99445740	99738660	DOCK9	292920	99736160	99741160
NR_046663	chr13	+	99484337	99486883	DOCK9-AS1	2546	99481837	99486837
NM_001145165	chr19	-	3490818	3500938	DOHH	10120	3498438	3503438
NM_001197260	chr2	+	74776146	74784678	DOK1	8532	74773646	74778646
NM_003974	chr8	-	21766383	21771219	DOK2	4836	21768719	21773719
NM_001144875	chr5	-	176928905	176937427	DOK3	8522	176934927	176939927
NM_018110	chr16	-	57505869	57520385	DOK4	14516	57517885	57522885
NM_018431	chr20	+	53092010	53267710	DOK5	175700	53089510	53094510
NM_152721	chr18	+	67068283	67516322	DOK6	448039	67065783	67070783
NM_001301071	chr4	+	3465032	3503200	DOK7	38168	3462532	3467532
NM_020438	chr9	+	131843382	131852717	DOLPP1	9335	131840882	131845882
NM_017613	chr21	-	34949858	34961014	DONSON	11156	34958514	34963514
NM_001199942	chr6	+	83777384	83878190	DOPEY1	100806	83774884	83779884
NM_001320714	chr21	+	37529079	37666572	DOPEY2	137493	37526579	37531579
NM_032482	chr19	+	2164147	2232577	DOT1L	68430	2161647	2166647
NM_001382	chr11	-	118967212	118972785	DPAGT1	5573	118970285	118975285
NM_001329745	chr10	+	103348044	103369421	DPCD	21377	103345544	103350544
NM_080870	chr6	+	30908776	30921998	DPCR1	13222	30906276	30911276
NM_001128141	chr16	+	89679715	89704839	DPEP1	25124	89677215	89682215
NR_136706	chr16	-	68021292	68034489	DPEP2	13197	68031989	68036989
NM_022357	chr16	-	68009565	68014452	DPEP3	4887	68011952	68016952
NM_001135156	chr19	-	38701645	38720354	DPF1	18709	38717854	38722854
NM_001330308	chr11	+	65101224	65121731	DPF2	20507	65098724	65103724
NM_001280542	chr14	-	73086003	73360824	DPF3	274821	73358324	73363324
NM_001383	chr17	+	1933405	1946725	DPH1	13320	1930905	1935905
NM_001384	chr1	+	44435652	44439043	DPH2	3391	44433152	44438152
NM_206831	chr3	-	16298567	16306496	DPH3	7929	16303996	16308996
NM_015958	chr1	-	101455179	101491362	DPH5	36183	101488862	101493862
NM_080650	chr15	-	35663169	35838404	DPH6	175235	35835904	35840904
NR_038251	chr15	+	35838395	36151202	DPH6-AS1	312807	35835895	35840895
NM_138778	chr9	-	140448895	140473387	DPH7	24492	140470887	140475887
NM_001317036	chr20	-	49551391	49575101	DPM1	23710	49572601	49577601
NM_003863	chr9	-	130697373	130700763	DPM2	3390	130698263	130703263
NM_001321907	chr2	+	115199934	116603328	DPP10	1403394	115197434	115202434
NR_036580	chr2	-	115901624	115918920	DPP10-AS1	17296	115916420	115921420
NR_132105	chr2	-	115585917	115591125	DPP10-AS3	5208	115588625	115593625
NM_130443	chr11	+	66247483	66277130	DPP3	29647	66244983	66249983
NM_001935	chr2	-	162848754	162931052	DPP4	82298	162928552	162933552
NM_001039350	chr7	+	153584181	154686000	DPP6	1101819	153581681	153586681
NM_013379	chr9	-	140004991	140009195	DPP7	4204	140006695	140011695
NR_135485	chr15	-	65734800	65810051	DPP8	75251	65807551	65812551
NM_139159	chr19	-	4675243	4723855	DPP9	48612	4721355	4726355
NM_001242901	chr19	+	4679293	4685960	DPP9-AS1	6667	4676793	4681793
NM_138815	chr3	-	109012634	109035364	DPPA2	22730	109032864	109037864
NM_199286	chr12	+	7864049	7870152	DPPA3	6103	7861549	7866549
NM_018189	chr3	-	109044987	109056419	DPPA4	11432	109053919	109058919
NM_001012728	chr19	+	54135309	54140263	DPRX	4954	54132809	54137809
NM_001937	chr1	-	168664694	168698442	DPT	33748	168695942	168700942
NM_015283	chr7	-	34968492	35077653	DPY19L1	109161	35075153	35080153
NR_036680	chr7	-	32620552	32758780	DPY19L1P1	138228	32756280	32761280
NR_132360	chr7	+	32865913	32878356	DPY19L1P2	12443	32863413	32868413
NM_173812	chr12	-	63952692	64062354	DPY19L2	109662	64059854	64064854
NR_002833	chr7	-	35120898	35225774	DPY19L2P1	104876	35223274	35228274
NR_027768	chr7	-	102815461	102920913	DPY19L2P2	105452	102918413	102923413
NR_036482	chr7	+	29724769	29727859	DPY19L2P3	3090	29722269	29727269
NR_003551	chr7	+	89748713	89754914	DPY19L2P4	6201	89746213	89751213
NM_001172774	chr19	+	32896654	32976799	DPY19L3	80145	32894154	32899154
NM_181787	chr8	+	95732102	95806076	DPY19L4	73974	95729602	95734602
NM_001321210	chr2	-	32236717	32264904	DPY30	28187	32262404	32267404
NM_000110	chr1	-	97543299	98386615	DPYD	843316	98384115	98389115
NR_046590	chr1	+	97561478	97788511	DPYD-AS1	227033	97558978	97563978
NM_001385	chr8	-	105391651	105479277	DPYS	87626	105476777	105481777
NM_001197293	chr8	+	26371708	26515693	DPYSL2	143985	26369208	26374208
NM_001197294	chr5	-	146770370	146889619	DPYSL3	119249	146887119	146892119
NM_006426	chr10	+	134000413	134019280	DPYSL4	18867	133997913	134002913
NM_020134	chr2	+	27070968	27173219	DPYSL5	102251	27068468	27073468
NM_133637	chr2	-	74745257	74753408	DQX1	8151	74750908	74755908
NM_001938	chr1	+	93811477	93828148	DR1	16671	93808977	93813977
NR_026979	chr15	+	69854058	69863779	DRAIC	9721	69851558	69856558
NM_018370	chr12	+	102271104	102317401	DRAM1	46297	102268604	102273604
NM_001349892	chr1	-	111659791	111682838	DRAM2	23047	111680338	111685338
NM_198545	chr1	+	11751780	11780336	DRAXIN	28556	11749280	11754280
NM_145038	chr2	+	26624779	26679579	DRC1	54800	26622279	26627279
NM_001130090	chr17	+	17876126	17920189	DRC3	44063	17873626	17878626
NM_001289162	chr16	+	57728712	57765367	DRC7	36655	57726212	57731212
NM_000794	chr5	-	174867674	174871163	DRD1	3489	174868663	174873663
NM_016574	chr11	-	113280316	113346001	DRD2	65685	113343501	113348501
NM_001282563	chr3	-	113847498	113918254	DRD3	70756	113915754	113920754
NM_000797	chr11	+	637304	640705	DRD4	3401	634804	639804
NM_004147	chr22	+	31795538	31830172	DRG1	34634	31793038	31798038
NM_001330144	chr17	+	17991180	18011299	DRG2	20119	17988680	17993680
NM_001276451	chr10	-	50574160	50604062	DRGX	29902	50601562	50606562
NM_016449	chr22	-	23950638	23974508	DRICH1	23870	23972008	23977008
NM_013235	chr5	-	31400601	31532282	DROSHA	131681	31529782	31534782
NM_001171184	chrX	+	100474932	100519485	DRP2	44553	100472432	100477432
NM_024421	chr18	-	28709213	28742819	DSC1	33606	28740319	28745319
NM_024422	chr18	-	28645939	28682395	DSC2	36456	28679895	28684895
NM_024423	chr18	-	28569330	28622781	DSC3	53451	28620281	28625281
NM_001389	chr21	-	41382925	42219065	DSCAM	836140	42216565	42221565
NR_046774	chr21	-	41990432	42002693	DSCAM-IT1	12261	42000193	42005193
NM_020693	chr11	-	117298487	117667976	DSCAML1	369489	117665476	117670476
NR_110785	chr18	+	28681550	28742752	DSCAS	61202	28679050	28684050
NM_024094	chr8	-	120846180	120868170	DSCC1	21990	120865670	120870670
NM_001331018	chr21	-	38595720	38640409	DSCR3	44689	38637909	38642909
NR_147130	chr21	-	39426312	39493454	DSCR4	67142	39490954	39495954
NR_026838	chr21	+	39493544	39528605	DSCR8	35061	39491044	39496044
NR_026719	chr21	+	38580803	38594037	DSCR9	13234	38578303	38583303
NM_001322940	chr6	+	116575314	116759454	DSE	184140	116572814	116577814
NM_032160	chr18	-	65173818	65183967	DSEL	10149	65181467	65186467
NM_001942	chr18	+	28898051	28939209	DSG1	41158	28895551	28900551
NR_110788	chr18	-	28923330	29006951	DSG1-AS1	83621	29004451	29009451
NM_001943	chr18	+	29077966	29128970	DSG2	51004	29075466	29080466
NR_045216	chr18	-	29122108	29136874	DSG2-AS1	14766	29134374	29139374
NM_001944	chr18	+	29027731	29058665	DSG3	30934	29025231	29030231
NM_177986	chr18	+	28956739	28994871	DSG4	38132	28954239	28959239
NM_001145318	chr20	-	35380193	35402230	DSN1	22037	35399730	35404730
NM_001319034	chr6	+	7541807	7586950	DSP	45143	7539307	7544307
NM_014208	chr4	+	88529680	88538025	DSPP	8345	88527180	88532180
NM_001144769	chr6	-	56322784	56819426	DST	496642	56816926	56821926
NM_006870	chr20	+	17550598	17588652	DSTN	38054	17548098	17553098
NM_015375	chr1	-	205111630	205180727	DSTYK	69097	205178227	205183227
NM_080820	chr20	+	18568536	18744560	DTD1	176024	18566036	18571036
NM_080664	chr14	-	31915242	31926680	DTD2	11438	31924180	31929180
NM_001136536	chr4	+	36283236	36346407	DTHD1	63171	36280736	36285736
NM_001286229	chr1	+	212208894	212278348	DTL	69454	212206394	212211394
NM_032975	chr18	+	32073253	32471808	DTNA	398555	32070753	32075753
NM_001256304	chr2	-	25600111	25896543	DTNB	296432	25894043	25899043
NM_032122	chr6	-	15523031	15663289	DTNBP1	140258	15660789	15665789
NM_001144955	chr15	+	49913225	49937333	DTWD1	24108	49910725	49915725
NM_173666	chr5	-	118171768	118324300	DTWD2	152532	118321800	118326800
NM_004416	chr12	+	113495661	113535833	DTX1	40172	113493161	113498161
NM_020892	chr7	+	76090971	76135312	DTX2	44341	76088471	76093471
NR_023383	chr7	+	76610138	76653076	DTX2P1-UPK3BP1-PMS2P11	42938	76607638	76612638
NM_178502	chr12	+	57998404	58003587	DTX3	5183	57995904	58000904
NM_138287	chr3	+	122283184	122294049	DTX3L	10865	122280684	122285684
NM_001300727	chr11	+	58938902	58976060	DTX4	37158	58936402	58941402
NM_001165031	chr2	-	242615156	242626383	DTYMK	11227	242623883	242628883
NR_028302	chr3	+	106959538	107045811	DUBR	86273	106957038	106962038
NM_175940	chr15	+	45422191	45457776	DUOX1	35585	45419691	45424691
NM_014080	chr15	-	45384851	45406359	DUOX2	21508	45403859	45408859
NM_001276268	chr15	-	45409563	45422075	DUOXA1	12512	45419575	45424575
NM_207581	chr15	+	45406522	45410301	DUOXA2	3779	45404022	45409022
NM_001003892	chr10	-	76797541	76818341	DUPD1	20800	76815841	76820841
NM_022156	chr17	-	80015747	80023697	DUS1L	7950	80021197	80026197
NM_017803	chr16	+	68056846	68113226	DUS2	56380	68054346	68059346
NM_001161619	chr19	-	5785152	5791249	DUS3L	6097	5788749	5793749
NM_001270419	chr7	+	107204401	107218968	DUS4L	14567	107201901	107206901
NM_004417	chr5	-	172195092	172198203	DUSP1	3111	172195703	172200703
NR_111940	chr1	-	221874761	221915518	DUSP10	40757	221913018	221918018
NM_003584	chr2	-	73989324	74007284	DUSP11	17960	74004784	74009784
NM_007240	chr1	+	161719557	161726954	DUSP12	7397	161717057	161722057
NM_001320842	chr10	-	76854189	76868970	DUSP13	14781	76866470	76871470
NM_007026	chr17	+	35849950	35873588	DUSP14	23638	35847450	35852450
NM_001320479	chr20	-	30435439	30458467	DUSP15	23028	30455967	30460967
NM_030640	chr12	-	12626215	12715448	DUSP16	89233	12712948	12717948
NM_001304795	chr22	-	31048037	31063877	DUSP18	15840	31061377	31066377
NM_080876	chr2	+	183943286	183964722	DUSP19	21436	183940786	183945786
NM_020185	chr6	+	292056	351355	DUSP22	59299	289556	294556
NM_024025	chr8	-	33448847	33457624	DUSP26	8777	33455124	33460124
NM_001080426	chr1	+	167063326	167098366	DUSP27	35040	167060826	167065826
NM_001033575	chr2	+	241499470	241503431	DUSP28	3961	241496970	241501970
NM_004090	chr17	-	41843488	41856368	DUSP3	12880	41853868	41858868
NM_001394	chr8	-	29190578	29208267	DUSP4	17689	29205767	29210767
NM_004419	chr10	+	112257624	112271302	DUSP5	13678	112255124	112260124
NR_002834	chr1	+	228780656	228788159	DUSP5P1	7503	228778156	228783156
NM_001946	chr12	-	89741601	89746636	DUSP6	5035	89744136	89749136
NM_001947	chr3	-	52082936	52090461	DUSP7	7525	52087961	52092961
NM_004420	chr11	-	1575280	1593150	DUSP8	17870	1590650	1595650
NM_001395	chrX	+	152907896	152916781	DUSP9	8885	152905396	152910396
NM_001330286	chr15	+	48623291	48635565	DUT	12274	48620791	48625791
NR_137167	chrUn_gl000228	+	112604	124171	DUX4	11567	110104	115104
NM_001012729	chr19	-	57663093	57678856	DUXA	15763	57676356	57681356
NR_110526	chr14	+	19650031	19692916	DUXAP10	42885	19647531	19652531
NR_122113	chr22	-	16150528	16193009	DUXAP8	42481	16190509	16195509
NM_001351307	chr16	-	75727790	75735357	DUXB	7567	75732857	75737857
NM_004421	chr1	-	1270657	1284492	DVL1	13835	1281992	1286992
NM_004422	chr17	-	7128660	7137863	DVL2	9203	7135363	7140363
NM_004423	chr3	+	183873283	183891314	DVL3	18031	183870783	183875783
NM_001352129	chr3	-	155008020	155011489	DWORF	3469	155008989	155013989
NM_001269053	chr10	-	82095860	82116514	DYDC1	20654	82114014	82119014
NM_001270042	chr10	+	82104500	82127829	DYDC2	23329	82102e3	82107e3
NM_001353210	chr18	-	46567843	46987103	DYM	419260	46984603	46989603
NM_001307955	chr18	+	52254989	52266724	DYNAP	11735	52252489	52257489
NM_001376	chr14	+	102430864	102517135	DYNC1H1	86271	102428364	102433364
NM_001278422	chr7	+	95401817	95739634	DYNC1I1	337817	95399317	95404317
NM_001320882	chr2	+	172543918	172606668	DYNC1I2	62750	172541418	172546418
NM_001329135	chr3	-	32567462	32612416	DYNC1LI1	44954	32609916	32614916
NR_136658	chr16	-	66754795	66785731	DYNC1LI2	30936	66783231	66788231
NM_001377	chr11	+	102980159	103350591	DYNC2H1	370432	102977659	102982659
NM_001348913	chr2	+	44001177	44055458	DYNC2LI1	54281	43998677	44003677
NM_001037494	chr12	+	120907659	120936298	DYNLL1	28639	120905159	120910159
NM_080677	chr17	+	56160779	56167618	DYNLL2	6839	56158279	56163279
NM_001281727	chr20	+	33104188	33128762	DYNLRB1	24574	33101688	33106688
NM_001305017	chr16	+	80574630	80584706	DYNLRB2	10076	80572130	80577130
NM_006519	chr6	-	159057506	159065818	DYNLT1	8312	159063318	159068318
NM_006520	chrX	-	37698088	37706889	DYNLT3	8801	37704389	37709389
NM_001396	chr21	+	38737874	38887679	DYRK1A	149805	38735374	38740374
NM_006484	chr19	-	40315986	40324873	DYRK1B	8887	40322373	40327373
NM_003583	chr12	+	68042511	68056444	DYRK2	13933	68040011	68045011
NM_003582	chr1	+	206808880	206822542	DYRK3	13662	206806380	206811380
NM_003845	chr12	+	4699237	4723054	DYRK4	23817	4696737	4701737
NM_003494	chr2	+	71680752	71913893	DYSF	233141	71678252	71683252
NM_001093730	chr2	-	207516344	207583120	DYTN	66776	207580620	207585620
NM_001099407	chr20	-	18364010	18447829	DZANK1	83819	18445329	18450329
NM_198968	chr13	-	96230455	96296960	DZIP1	66505	96294460	96299460
NM_173543	chr3	-	137780826	137834451	DZIP1L	53625	137831951	137836951
NM_014648	chr3	+	108308336	108413693	DZIP3	105357	108305836	108310836
NM_005225	chr20	-	32263291	32274210	E2F1	10919	32271710	32276710
NM_004091	chr1	-	23832919	23857712	E2F2	24793	23855212	23860212
NM_001949	chr6	+	20402136	20493945	E2F3	91809	20399636	20404636
NM_001950	chr16	+	67226067	67232821	E2F4	6754	67223567	67228567
NM_001083588	chr8	+	86089618	86126753	E2F5	37135	86087118	86092118
NM_198256	chr2	-	11584500	11606303	E2F6	21803	11603803	11608803
NM_203394	chr12	-	77415025	77459360	E2F7	44335	77456860	77461860
NM_001256372	chr11	-	19245609	19263202	E2F8	17593	19260702	19265702
NM_004424	chr16	+	2273488	2285743	E4F1	12255	2270988	2275988
NM_033083	chr3	+	15469063	15484120	EAF1	15057	15466563	15471563
NM_001320041	chr3	+	121554026	121605373	EAF2	51347	121551526	121556526
NM_018453	chr14	-	34985134	35008943	EAPP	23809	35006443	35011443
NR_003501	chr16	-	23533333	23568696	EARS2	35363	23566196	23571196
NM_198120	chr8	+	110551928	110578225	EBAG9	26297	110549428	110554428
NM_001324108	chr5	-	158122922	158526770	EBF1	403848	158524270	158529270
NM_022659	chr8	-	25699245	25902640	EBF2	203395	25900140	25905140
NM_001005463	chr10	-	131633495	131762091	EBF3	128596	131759591	131764591
NM_001110514	chr20	+	2673523	2740754	EBF4	67231	2671023	2676023
NM_005755	chr19	+	4229539	4237524	EBI3	7985	4227039	4232039
NR_036592	chr9	+	37079892	37090398	EBLN3P	10506	37077392	37082392
NM_001159936	chr1	-	43629844	43638241	EBNA1BP2	8397	43635741	43640741
NM_006579	chrX	+	48380163	48387104	EBP	6941	48377663	48382663
NM_001278636	chr13	-	50234811	50265623	EBPL	30812	50263123	50268123
NM_007265	chr10	-	74894281	74927853	ECD	33572	74925353	74930353
NM_001113348	chr1	-	21543739	21672034	ECE1	128295	21669534	21674534
NM_014693	chr3	+	183967444	184010819	ECE2	43375	183964944	183969944
NM_004826	chr2	-	233344536	233352569	ECEL1	8033	233350069	233355069
NM_001398	chr19	-	39306061	39322497	ECH1	16436	39319997	39324997
NM_018479	chr6	-	127609856	127664754	ECHDC1	54898	127662254	127667254
NM_001319958	chr1	-	53361581	53387457	ECHDC2	25876	53384957	53389957
NM_024693	chr10	+	11784355	11806065	ECHDC3	21710	11781855	11786855
NM_004092	chr10	-	135175986	135186908	ECHS1	10922	135184408	135189408
NM_001178029	chr16	-	2289872	2301602	ECI1	11730	2299102	2304102
NM_206836	chr6	-	4115926	4135831	ECI2	19905	4133331	4138331
NM_001202858	chr1	+	150480486	150486265	ECM1	5779	150477986	150482986
NM_001197296	chr9	-	95255828	95298374	ECM2	42546	95295874	95300874
NM_001077693	chr5	-	138784242	138842328	ECSCR	58086	138839828	138844828
NM_016581	chr19	-	11616730	11639987	ECSIT	23257	11637487	11642487
NM_018098	chr3	+	172468474	172539264	ECT2	70790	172465974	172470974
NM_001195037	chr6	+	139117247	139225207	ECT2L	107960	139114747	139119747
NM_001399	chrX	+	68835910	69259321	EDA	423411	68833410	68838410
NM_001199687	chrX	-	65815481	65859140	EDA2R	43659	65856640	65861640
NM_022336	chr2	-	109510926	109605828	EDAR	94902	109603328	109608328
NM_145861	chr1	+	236557679	236648008	EDARADD	90329	236555179	236560179
NM_001142443	chr15	-	74922898	74988394	EDC3	65496	74985894	74990894
NM_014329	chr16	+	67906925	67918417	EDC4	11492	67904425	67909425
NM_022360	chr14	+	21236585	21239107	EDDM3B	2522	21234085	21239085
NM_014674	chr3	+	5229358	5261650	EDEM1	32292	5226858	5231858
NM_001145025	chr20	-	33703159	33735161	EDEM2	32002	33732661	33737661
NM_025191	chr1	-	184659624	184724041	EDEM3	64417	184721541	184726541
NM_001281299	chr9	-	139756565	139760788	EDF1	4223	139758288	139763288
NM_001278642	chr5	-	83236413	83680685	EDIL3	444272	83678185	83683185
NM_001955	chr6	+	12290528	12297427	EDN1	6899	12288028	12293028
NM_001302269	chr1	-	41944445	41950354	EDN2	5909	41947854	41952854
NM_001302456	chr20	+	57875481	57901047	EDN3	25566	57872981	57877981
NR_045958	chr4	+	148402068	148466106	EDNRA	64038	148399568	148404568
NM_000115	chr13	-	78469615	78549858	EDNRB	80243	78547358	78552358
NR_103853	chr13	+	78393071	78482563	EDNRB-AS1	89492	78390571	78395571
NR_110858	chr10	+	127408083	127452712	EDRF1	44629	127405583	127410583
NR_120633	chr10	-	127433295	127440629	EDRF1-AS1	7334	127438129	127443129
NM_003566	chr12	-	93166284	93323107	EEA1	156823	93320607	93325607
NM_003797	chr11	+	85955425	85989852	EED	34427	85952925	85957925
NM_001402	chr6	-	74225472	74230755	EEF1A1	5283	74228255	74233255
NM_001958	chr20	-	62119364	62130668	EEF1A2	11304	62128168	62133168
NR_134934	chr13	-	21303069	21348097	EEF1AKMT1	45028	21345597	21350597
NM_001304467	chr10	-	126446399	126480510	EEF1AKMT2	34111	126478010	126483010
NM_015433	chr12	+	58166382	58176324	EEF1AKMT3	9942	58163882	58168882
NM_021121	chr2	+	207024317	207027653	EEF1B2	3336	207021817	207026817
NM_001130056	chr8	-	144661891	144679845	EEF1D	17954	144677345	144682345
NR_027062	chr13	+	32420919	32533721	EEF1DP3	112802	32418419	32423419
NM_001135650	chr6	-	8073592	8102828	EEF1E1	29236	8100328	8105328
NR_037618	chr6	-	8013799	8102828	EEF1E1-BLOC1S5	89029	8100328	8105328
NM_001404	chr11	-	62327072	62341460	EEF1G	14388	62338960	62343960
NM_001961	chr19	-	3976053	3985461	EEF2	9408	3982961	3987961
NM_013302	chr16	+	22217591	22300066	EEF2K	82475	22215091	22220091
NM_001289029	chr16	-	5134300	5147821	EEF2KMT	13521	5145321	5150321
NM_021937	chr3	+	127872299	128127489	EEFSEC	255190	127869799	127874799
NM_030636	chr7	+	36192835	36341152	EEPD1	148317	36190335	36195335
NM_001142857	chr8	-	49627473	49647870	EFCAB1	20397	49645370	49650370
NR_027068	chr7	-	105205579	105221976	EFCAB10	16397	105219476	105224476
NM_145231	chr14	-	90261335	90421121	EFCAB11	159786	90418621	90423621
NM_207307	chr3	-	129120163	129147494	EFCAB12	27331	129144994	129149994
NM_152347	chr17	+	45401326	45518677	EFCAB13	117351	45398826	45403826
NM_014774	chr1	-	47140830	47184736	EFCAB14	43906	47182236	47187236
NR_038828	chr1	+	47139707	47157769	EFCAB14-AS1	18062	47137207	47142207
NM_001143943	chr1	+	245133630	245288530	EFCAB2	154900	245131130	245136130
NM_001144933	chr17	+	60447578	60493839	EFCAB3	46261	60445078	60450078
NM_198529	chr17	+	28268622	28435470	EFCAB5	166848	28266122	28271122
NM_198856	chr22	-	43924623	44208217	EFCAB6	283594	44205717	44210717
NR_046563	chr22	+	43912133	43932485	EFCAB6-AS1	20352	43909633	43914633
NM_032437	chr1	+	63988971	64038364	EFCAB7	49393	63986471	63991471
NM_001143967	chr20	+	31446728	31549415	EFCAB8	102687	31444228	31449228
NM_001171183	chr5	+	171621175	171630458	EFCAB9	9283	171618675	171623675
NM_024768	chr3	+	128720471	128759585	EFCC1	39114	128717971	128722971
NM_001039349	chr2	-	56093096	56151298	EFEMP1	58202	56148798	56153798
NM_016938	chr11	-	65633911	65640405	EFEMP2	6494	65637905	65642905
NM_001330688	chr3	-	19920965	19988517	EFHB	67552	19986017	19991017
NM_018100	chr6	+	52284993	52360583	EFHC1	75590	52282493	52287493
NM_025184	chrX	-	44007127	44202923	EFHC2	195796	44200423	44205423
NM_001243252	chr2	+	233470766	233547491	EFHD1	76725	233468266	233473266
NM_024329	chr1	+	15736390	15756839	EFHD2	20449	15733890	15738890
NR_136410	chr15	-	82422560	82555104	EFL1	132544	82552604	82557604
NM_004428	chr1	+	155100348	155107386	EFNA1	7038	155097848	155102848
NM_001405	chr19	+	1286152	1301429	EFNA2	15277	1283652	1288652
NM_004952	chr1	+	155051347	155060014	EFNA3	8667	155048847	155053847
NM_005227	chr1	+	155036212	155042029	EFNA4	5817	155033712	155038712
NM_001962	chr5	-	106712589	107006596	EFNA5	294007	107004096	107009096
NM_004429	chrX	+	68048839	68062006	EFNB1	13167	68046339	68051339
NM_004093	chr13	-	107142078	107187388	EFNB2	45310	107184888	107189888
NM_001406	chr17	+	7608519	7614693	EFNB3	6174	7606019	7611019
NM_001323554	chr8	+	132916334	133025886	EFR3A	109552	132913834	132918834
NM_014971	chr2	+	25264972	25382004	EFR3B	117032	25262472	25267472
NM_005864	chr14	-	23825608	23834842	EFS	9234	23832342	23837342
NR_036652	chr15	+	84748938	84795353	EFTUD1P1	46415	84746438	84751438
NM_004247	chr17	-	42927654	42976993	EFTUD2	49339	42974493	42979493
NM_001178131	chr4	+	110834039	110934235	EGF	100196	110831539	110836539
NR_021485	chr3	+	167967309	168548374	EGFEM1P	581065	167964809	167969809
NM_001167890	chrX	+	13587693	13651694	EGFL6	64001	13585193	13590193
NR_046367	chr9	+	139553307	139567130	EGFL7	13823	139550807	139555807
NR_037860	chr6_apd_hap1	+	3447121	3450803	EGFL8	3682	3444621	3449621
NM_001205301	chr5	+	38258510	38465582	EGFLAM	207072	38256010	38261010
NR_102750	chr5	-	38399915	38403573	EGFLAM-AS2	3658	38401073	38406073
NR_046219	chr5	-	38282370	38291088	EGFLAM-AS4	8718	38288588	38293588
NM_001346941	chr7	+	55086713	55275773	EGFR	189060	55084213	55089213
NR_047551	chr7	-	55247442	55256642	EGFR-AS1	9200	55254142	55259142
NM_022051	chr1	-	231499496	231560790	EGLN1	61294	231558290	231563290
NM_080732	chr19	+	41305047	41314346	EGLN2	9299	41302547	41307547
NM_022073	chr14	-	34393420	34420284	EGLN3	26864	34417784	34422784
NM_001964	chr5	+	137801180	137805004	EGR1	3824	137798680	137803680
NM_001136178	chr10	-	64571755	64578927	EGR2	7172	64576427	64581427
NM_004430	chr8	-	22545173	22550815	EGR3	5642	22548315	22553315
NM_001965	chr2	-	73518056	73520829	EGR4	2773	73518329	73523329
NM_001142615	chr2	+	62900985	63273621	EHBP1	372636	62898485	62903485
NM_001099409	chr11	+	65343508	65360121	EHBP1L1	16613	65341008	65346008
NM_001282445	chr11	-	64620198	64647185	EHD1	26987	64644685	64649685
NM_014601	chr19	+	48216600	48246391	EHD2	29791	48214100	48219100
NM_014600	chr2	+	31456879	31491260	EHD3	34381	31454379	31459379
NM_139265	chr15	-	42191638	42264755	EHD4	73117	42262255	42267255
NR_120332	chr15	+	42213614	42221484	EHD4-AS1	7870	42211114	42216114
NM_001206615	chr11	+	34642587	34684834	EHF	42247	34640087	34645087
NM_001166415	chr3	-	184908411	184971886	EHHADH	63475	184969386	184974386
NR_038990	chr3	+	184880688	184909743	EHHADH-AS1	29055	184878188	184883188
NM_024757	chr9	+	140513443	140730578	EHMT1	217135	140510943	140515943
NM_006709	chr6_apd_hap1	-	3162290	3180245	EHMT2	17955	3177745	3182745
NM_001290135	chr11	+	125439282	125454584	EI24	15302	125436782	125441782
NM_005801	chr17	+	39845126	39847898	EIF1	2772	39842626	39847626
NM_001242482	chr11	-	65764015	65769637	EIF1AD	5622	65767137	65772137
NM_001412	chrX	-	20142635	20159966	EIF1AX	17331	20157466	20162466
NM_001278612	chrY	+	22737596	22755040	EIF1AY	17444	22735096	22740096
NM_005875	chr3	+	40351172	40353915	EIF1B	2743	40348672	40353672
NR_033965	chr3	-	40214637	40351189	EIF1B-AS1	136552	40348689	40353689
NM_032025	chr3	+	150264464	150303803	EIF2A	39339	150261964	150266964
NM_014413	chr7	-	6061877	6098860	EIF2AK1	36983	6096360	6101360
NM_001135651	chr2	-	37332283	37384190	EIF2AK2	51907	37381690	37386690
NM_004836	chr2	-	88856257	88927094	EIF2AK3	70837	88924594	88929594
NM_001013703	chr15	+	40226324	40327797	EIF2AK4	101473	40223824	40228824
NM_001414	chr12	-	124105569	124118323	EIF2B1	12754	124115823	124120823
NM_014239	chr14	+	75469611	75476294	EIF2B2	6683	75467111	75472111
NM_020365	chr1	-	45316193	45452394	EIF2B3	136201	45449894	45454894
NM_001318969	chr2	-	27587218	27593324	EIF2B4	6106	27590824	27595824
NM_003907	chr3	+	183852809	183863099	EIF2B5	10290	183850309	183855309
NM_001201478	chr1	-	206764973	206785904	EIF2D	20931	206783404	206788404
NM_004094	chr14	+	67827033	67853233	EIF2S1	26200	67824533	67829533
NM_003908	chr20	-	32676103	32700162	EIF2S2	24059	32697662	32702662
NM_001415	chrX	+	24073064	24096927	EIF2S3	23863	24070564	24075564
NM_003750	chr10	-	120794540	120840334	EIF3A	45794	120837834	120842834
NM_003751	chr7	+	2394473	2420377	EIF3B	25904	2391973	2396973
NM_001199142	chr16	+	28699878	28747050	EIF3C	47172	28697378	28702378
NM_001317857	chr16	+	28722740	28747050	EIF3CL	24310	28720240	28725240
NM_003753	chr22	-	36906896	36925277	EIF3D	18381	36922777	36927777
NM_001568	chr8	-	109213971	109260959	EIF3E	46988	109258459	109263459
NM_003754	chr11	+	8008866	8017719	EIF3F	8853	8006366	8011366
NM_003755	chr19	-	10225689	10230600	EIF3G	4911	10228100	10233100
NM_003756	chr8	-	117657054	117768062	EIF3H	111008	117765562	117770562
NM_003757	chr1	+	32687184	32697205	EIF3I	10021	32684684	32689684
NM_001284335	chr15	+	44829265	44855001	EIF3J	25736	44826765	44831765
NM_001308393	chr19	+	39109711	39127599	EIF3K	17888	39107211	39112211
NM_001242923	chr22	+	38245378	38284789	EIF3L	39411	38242878	38247878
NM_001307929	chr11	+	32605312	32624419	EIF3M	19107	32602812	32607812
NM_001416	chr17	+	7476023	7482324	EIF4A1	6301	7473523	7478523
NM_001967	chr3	+	186501360	186507685	EIF4A2	6325	186498860	186503860
NM_014740	chr17	-	78109012	78120982	EIF4A3	11970	78118482	78123482
NM_001300821	chr12	+	53400041	53435999	EIF4B	35958	53397541	53402541
NM_001968	chr4	-	99792834	99851788	EIF4E	58954	99849288	99854288
NM_001099408	chr5	+	176057682	176073642	EIF4E1B	15960	176055182	176060182
NM_001282958	chr2	+	233415296	233448355	EIF4E2	33059	233412796	233417796
NM_173359	chr3	-	71728439	71803924	EIF4E3	75485	71801424	71806424
NM_004095	chr8	+	37888019	37917883	EIF4EBP1	29864	37885519	37890519
NM_004096	chr10	+	72163860	72188374	EIF4EBP2	24514	72161360	72166360
NM_019843	chr22	-	31835344	31885874	EIF4ENIF1	50530	31883374	31888374
NM_001194947	chr3	+	184032282	184053146	EIF4G1	20864	184029782	184034782
NM_001418	chr11	-	10818592	10830582	EIF4G2	11990	10828082	10833082
NM_001198801	chr1	-	21132784	21503381	EIF4G3	370597	21500881	21505881
NM_031992	chr7	+	73588705	73611429	EIF4H	22724	73586205	73591205
NM_001969	chr14	+	103800338	103811361	EIF5	11023	103797838	103802838
NM_001143760	chr17	+	7210317	7215782	EIF5A	5465	7207817	7212817
NM_020390	chr3	-	170606203	170626426	EIF5A2	20223	170623926	170628926
NM_001099692	chr10	+	81272356	81276192	EIF5AL1	3836	81269856	81274856
NM_015904	chr2	+	99953833	100016728	EIF5B	62895	99951333	99956333
NM_181466	chr20	-	33866708	33872619	EIF6	5911	33870119	33875119
NM_003310	chr2	-	3192694	3381703	EIPR1	189009	3379203	3384203
NM_018696	chr18	+	48494386	48514490	ELAC1	20104	48491886	48496886
NM_173717	chr17	-	12894928	12921381	ELAC2	26453	12918881	12923881
NM_001972	chr19	+	852208	856246	ELANE	4038	849708	854708
NM_001419	chr19	-	8023456	8070529	ELAVL1	47073	8068029	8073029
NM_001351456	chr9	-	23690102	23850638	ELAVL2	160536	23848138	23853138
NM_001420	chr19	-	11562142	11591803	ELAVL3	29661	11589303	11594303
NM_001324208	chr1	+	50513685	50669457	ELAVL4	155772	50511185	50516185
NR_110426	chr7	-	55306128	55323328	ELDR	17200	55320828	55325828
NM_172373	chr13	-	41506054	41593508	ELF1	87454	41591008	41596008
NM_001331036	chr4	-	139978412	140098372	ELF2	119960	140095872	140100872
NM_004433	chr1	+	201979689	201986315	ELF3	6626	201977189	201982189
NR_146472	chr1	-	201969178	201979481	ELF3-AS1	10303	201976981	201981981
NM_001127197	chrX	-	129198894	129244688	ELF4	45794	129242188	129247188
NM_001243080	chr11	-	34500341	34535347	ELF5	35006	34532847	34537847
NM_001128636	chr7	+	1748797	1787590	ELFN1	38793	1746297	1751297
NR_120508	chr7	-	1778265	1781946	ELFN1-AS1	3681	1779446	1784446
NR_110512	chr22	-	37736684	37823505	ELFN2	86821	37821005	37826005
NM_005229	chrX	-	47494918	47510003	ELK1	15085	47507503	47512503
NR_046211	chr14	-	106135913	106139144	ELK2AP	3231	106136644	106141644
NM_005230	chr12	+	96588159	96663613	ELK3	75454	96585659	96590659
NM_001973	chr1	-	205577070	205602000	ELK4	24930	205599500	205604500
NM_006532	chr19	-	18553472	18632937	ELL	79465	18630437	18635437
NM_012081	chr5	-	95220801	95297775	ELL2	76974	95295275	95300275
NM_025165	chr15	-	44064797	44069502	ELL3	4705	44067002	44072002
NM_001206480	chr7	-	36892510	37488929	ELMO1	596419	37486429	37491429
NR_104120	chr7	+	37037400	37053235	ELMO1-AS1	15835	37034900	37039900
NM_133171	chr20	-	44994683	45035690	ELMO2	41007	45033190	45038190
NM_024712	chr16	+	67233027	67237927	ELMO3	4900	67230527	67235527
NM_001308018	chr11	+	107461816	107537505	ELMOD1	75689	107459316	107464316
NM_153702	chr4	+	141445311	141474924	ELMOD2	29613	141442811	141447811
NM_001135021	chr2	+	85581842	85618875	ELMOD3	37033	85579342	85584342
NM_001043318	chr14	-	74181824	74253961	ELMSAN1	72137	74251461	74256461
NM_000501	chr7	+	73442118	73484236	ELN	42118	73439618	73444618
NM_003198	chr1	+	24069855	24088549	ELOA	18694	24067355	24072355
NR_038280	chr1	-	24086871	24104787	ELOA-AS1	17916	24102287	24107287
NM_016427	chr18	-	44558942	44561988	ELOA2	3046	44559488	44564488
NM_007108	chr16	-	2821414	2827297	ELOB	5883	2824797	2829797
NM_001204858	chr8	-	74857372	74884522	ELOC	27150	74882022	74887022
NM_032377	chr19	-	11663857	11670051	ELOF1	6194	11667551	11672551
NM_001256401	chr1	-	43829067	43833745	ELOVL1	4678	43831245	43836245
NM_017770	chr6	-	10980992	11044624	ELOVL2	63632	11042124	11047124
NR_038963	chr6	+	11043990	11079377	ELOVL2-AS1	35387	11041490	11046490
NM_152310	chr10	+	103986034	103989344	ELOVL3	3310	103983534	103988534
NM_022726	chr6	-	80624528	80657315	ELOVL4	32787	80654815	80659815
NM_021814	chr6	-	53132195	53213977	ELOVL5	81782	53211477	53216477
NM_024090	chr4	-	110970228	111119820	ELOVL6	149592	111117320	111122320
NM_001297618	chr5	-	60047615	60140101	ELOVL7	92486	60137601	60142601
NM_001330749	chr9	-	111629796	111696612	ELP1	66816	111694112	111699112
NM_001324467	chr18	+	33709836	33757885	ELP2	48049	33707336	33712336
NM_001284222	chr8	+	27947747	28048669	ELP3	100922	27945247	27950247
NM_019040	chr11	+	31531275	31806073	ELP4	274798	31528775	31533775
NM_203415	chr17	+	7155055	7163259	ELP5	8204	7152555	7157555
NM_001031703	chr3	-	47537129	47555199	ELP6	18070	47552699	47557699
NM_022142	chr19	+	48497907	48528410	ELSPBP1	30503	48495407	48500407
NM_198449	chr5	-	49692030	49737234	EMB	45204	49734734	49739734
NR_003955	chr1	+	121260909	121313686	EMBP1	52777	121258409	121263409
NM_001271428	chr1	-	19542157	19578053	EMC1	35896	19575553	19580553
NM_175063	chr19	+	50979733	50986783	EMC10	7050	50977233	50982233
NM_014673	chr8	+	109455811	109501417	EMC2	45606	109453311	109458311
NM_018447	chr3	-	10004363	10052932	EMC3	48569	10050432	10055432
NR_103821	chr3	+	10028576	10048687	EMC3-AS1	20111	10026076	10031076
NM_016454	chr15	+	34517197	34522366	EMC4	5169	34514697	34519697
NM_020154	chr15	-	34376223	34394053	EMC7	17830	34391553	34396553
NM_001142288	chr16	-	85812230	85833148	EMC8	20918	85830648	85835648
NM_016049	chr14	-	24608173	24610797	EMC9	2624	24608297	24613297
NM_001159694	chr4	-	101316497	101439250	EMCN	122753	101436750	101441750
NM_001166131	chr17	+	48450580	48458820	EME1	8240	48448080	48453080
NM_001257370	chr16	+	1823228	1826239	EME2	3011	1820728	1825728
NR_135131	chr12	+	7079943	7105520	EMG1	25577	7077443	7082443
NM_133455	chr22	+	29601900	29655586	EMID1	53686	29599400	29604400
NM_007046	chr2	+	27301434	27309265	EMILIN1	7831	27298934	27303934
NM_032048	chr18	+	2847027	2914090	EMILIN2	67063	2844527	2849527
NM_052846	chr20	-	39988605	39995498	EMILIN3	6893	39992998	39997998
NM_004434	chr14	+	100259744	100408395	EML1	148651	100257244	100262244
NR_147900	chr19	-	46112657	46148887	EML2	36230	46146387	46151387
NM_001300794	chr11	-	62369690	62380237	EML3	10547	62377737	62382737
NM_019063	chr2	+	42396477	42559688	EML4	163211	42393977	42398977
NM_183387	chr14	-	89081173	89259096	EML5	177923	89256596	89261596
NM_001039753	chr2	+	54952148	55199156	EML6	247008	54949648	54954648
NM_001423	chr12	+	13349601	13369708	EMP1	20107	13347101	13352101
NM_001424	chr16	-	10622278	10674573	EMP2	52295	10672073	10677073
NM_001425	chr19	+	48828628	48833810	EMP3	5182	48826128	48831128
NM_020193	chr11	+	76156068	76263943	EMSY	107875	76153568	76158568
NM_004097	chr2	+	73144603	73162020	EMX1	17417	73142103	73147103
NM_001165924	chr10	+	119301955	119309057	EMX2	7102	119299455	119304455
NR_002791	chr10	-	119243803	119304579	EMX2OS	60776	119302079	119307079
NM_001426	chr2	-	119599746	119605759	EN1	6013	119603259	119608259
NM_001427	chr7	+	155250823	155257526	EN2	6703	155248323	155253323
NM_018212	chr1	-	225674531	225840845	ENAH	166314	225838345	225843345
NM_031889	chr4	+	71494460	71512536	ENAM	18076	71491960	71496960
NM_001256574	chr5	-	73923230	73937249	ENC1	14019	73934749	73939749
NM_015036	chr11	+	94822973	94865815	ENDOD1	42842	94820473	94825473
NM_004435	chr9	+	131580778	131584955	ENDOG	4177	131578278	131583278
NM_006025	chr12	-	48103517	48119355	ENDOU	15838	48116855	48121855
NM_173627	chr17	+	78388966	78411884	ENDOV	22918	78386466	78391466
NM_000118	chr9	-	130577290	130617052	ENG	39762	130614552	130619552
NM_001042573	chr17	+	77071018	77084685	ENGASE	13667	77068518	77073518
NM_032140	chr16	-	67696847	67700659	ENKD1	3812	67698159	67703159
NM_001270383	chr10	-	25270907	25351208	ENKUR	80301	25348708	25353708
NM_001201483	chr1	-	8921058	8939151	ENO1	18093	8936651	8941651
NM_001975	chr12	+	7023613	7032859	ENO2	9246	7021113	7026113
NM_001193503	chr17	+	4854383	4860426	ENO3	6043	4851883	4856883
NM_001242699	chr10	+	118609022	118642112	ENO4	33090	118606522	118611522
NR_120457	chr4	+	83351632	83382328	ENOPH1	30696	83349132	83354132
NM_001318759	chr18	-	670319	712664	ENOSF1	42345	710164	715164
NM_017993	chr13	-	43787268	44361116	ENOX1	573848	44358616	44363616
NR_120399	chr13	+	44022987	44033624	ENOX1-AS2	10637	44020487	44025487
NM_006375	chrX	-	129757356	130037291	ENOX2	279935	130034791	130039791
NM_001977	chr4	+	111397228	111484493	ENPEP	87265	111394728	111399728
NM_006208	chr6	+	132129155	132216295	ENPP1	87140	132126655	132131655
NM_001330600	chr8	-	120569476	120685816	ENPP2	116340	120683316	120688316
NR_133007	chr6	+	131958374	132068550	ENPP3	110176	131955874	131960874
NM_014936	chr6	+	46097700	46114436	ENPP4	16736	46095200	46100200
NM_001290072	chr6	-	46126918	46138747	ENPP5	11829	46136247	46141247
NM_153343	chr4	-	185009858	185139114	ENPP6	129256	185136614	185141614
NM_178543	chr17	+	77704864	77716021	ENPP7	11157	77702364	77707364
NR_130771	chr16	+	33571843	33586742	ENPP7P13	14899	33569343	33574343
NM_207042	chr1	-	150594598	150602098	ENSA	7500	150599598	150604598
NM_152512	chr22	-	40139048	40289794	ENTHD1	150746	40287294	40292294
NM_001098175	chr10	+	97471535	97637023	ENTPD1	165488	97469035	97474035
NR_038444	chr10	-	97512962	97849992	ENTPD1-AS1	337030	97847492	97852492
NM_001246	chr9	-	139942550	139948503	ENTPD2	5953	139946003	139951003
NM_001248	chr3	+	40428646	40470117	ENTPD3	41471	40426146	40431146
NR_040100	chr3	-	40432441	40494799	ENTPD3-AS1	62358	40492299	40497299
NM_004901	chr8	-	23286664	23315244	ENTPD4	28580	23312744	23317744
NM_001330189	chr14	-	74424618	74486035	ENTPD5	61417	74483535	74488535
NM_001322382	chr20	+	25176305	25208711	ENTPD6	32406	25173805	25178805
NM_001349962	chr10	+	101419133	101471002	ENTPD7	51869	101416633	101421633
NM_198585	chr9	-	140328815	140335901	ENTPD8	7086	140333401	140338401
NM_001193557	chr8	+	110346551	110358189	ENY2	11638	110344051	110349051
NM_001278689	chr3	-	69024362	69063045	EOGT	38683	69060545	69065545
NM_005442	chr3	-	27757439	27764206	EOMES	6767	27761706	27766706
NM_001429	chr22	+	41488613	41576081	EP300	87468	41486113	41491113
NR_110514	chr22	-	41581218	41593505	EP300-AS1	12287	41591005	41596005
NM_015409	chr12	+	132434464	132565011	EP400	130547	132431964	132436964
NR_003290	chr12	+	132568827	132610885	EP400NL	42058	132566327	132571327
NM_001430	chr2	+	46524540	46613842	EPAS1	89302	46522040	46527040
NM_004437	chr1	+	29213602	29446558	EPB41	232956	29211102	29216102
NM_001258331	chr20	+	34679425	34820721	EPB41L1	141296	34676925	34681925
NM_001350301	chr6	-	131160486	131384462	EPB41L2	223976	131381962	131386962
NM_001281535	chr18	-	5392379	5628990	EPB41L3	236611	5626490	5631490
NM_001347887	chr5	-	111478138	111755013	EPB41L4A	276875	111752513	111757513
NM_019114	chr9	-	111934253	112083244	EPB41L4B	148991	112080744	112085744
NM_020909	chr2	+	120770603	120936697	EPB41L5	166094	120768103	120773103
NM_000119	chr15	-	43489425	43513323	EPB42	23898	43510823	43515823
NM_001282391	chr10	-	32556643	32667726	EPC1	111083	32665226	32670226
NM_015630	chr2	+	149402559	149545136	EPC2	142577	149400059	149405059
NM_002354	chr2	+	47596286	47614167	EPCAM	17881	47593786	47598786
NM_001242946	chr7	+	37960162	37991542	EPDR1	31380	37957662	37962662
NM_020964	chr18	-	43427573	43547305	EPG5	119732	43544805	43549805
NM_001270990	chr4	+	75174186	75182520	EPGN	8334	75171686	75176686
NM_005232	chr7	-	143088204	143105985	EPHA1	17781	143103485	143108485
NR_033897	chr7	+	143104905	143220540	EPHA1-AS1	115635	143102405	143107405
NM_001099439	chr1	-	38181645	38230824	EPHA10	49179	38228324	38233324
NM_001329090	chr1	-	16450831	16482604	EPHA2	31773	16480104	16485104
NM_005233	chr3	+	89156673	89531284	EPHA3	374611	89154173	89159173
NM_001304536	chr2	-	222282746	222438922	EPHA4	156176	222436422	222441422
NM_182472	chr4	-	66185280	66536213	EPHA5	350933	66533713	66538713
NR_034138	chr4	+	66535678	66559104	EPHA5-AS1	23426	66533178	66538178
NM_001080448	chr3	+	96533424	97467786	EPHA6	934362	96530924	96535924
NM_004440	chr6	-	93949739	94129300	EPHA7	179561	94126800	94131800
NM_020526	chr1	+	22889994	22930087	EPHA8	40093	22887494	22892494
NM_004441	chr3	+	134514098	134979307	EPHB1	465209	134511598	134516598
NM_001309193	chr1	+	23037330	23247993	EPHB2	210663	23034830	23039830
NM_004443	chr3	+	184279586	184300196	EPHB3	20610	184277086	184282086
NM_004444	chr7	-	100400186	100425143	EPHB4	24957	100422643	100427643
NM_001280794	chr7	+	142552775	142568847	EPHB6	16072	142550275	142555275
NM_001136018	chr1	+	225997775	226033262	EPHX1	35487	225995275	226000275
NM_001979	chr8	+	27348518	27402439	EPHX2	53921	27346018	27351018
NM_001142886	chr19	-	15337732	15343858	EPHX3	6126	15341358	15346358
NM_173567	chr1	+	92495532	92529093	EPHX4	33561	92493032	92498032
NM_005670	chr6	-	145946439	146056991	EPM2A	110552	146054491	146059491
NM_014805	chr3	-	37027356	37034795	EPM2AIP1	7439	37032295	37037295
NM_001321263	chr19	+	56186560	56207133	EPN1	20573	56184060	56189060
NM_014964	chr17	+	19140689	19240028	EPN2	99339	19138189	19143189
NR_048576	chr17	-	19199908	19209574	EPN2-AS1	9666	19207074	19212074
NR_046824	chr17	+	19174705	19177701	EPN2-IT1	2996	19172205	19177205
NM_017957	chr17	+	48610047	48621111	EPN3	11064	48607547	48612547
NM_000799	chr7	+	100318422	100321323	EPO	2901	100315922	100320922
NM_001130677	chr17	-	36827958	36831187	EPOP	3229	36828687	36833687
NR_033663	chr19	-	11487880	11495018	EPOR	7138	11492518	11497518
NM_020398	chr20	-	44169264	44176065	EPPIN	6801	44173565	44178565
NM_001198986	chr20	-	44164918	44176065	EPPIN-WFDC6	11147	44173565	44178565
NM_031308	chr8	-	144939491	144952632	EPPK1	13141	144950132	144955132
NM_004446	chr1	-	220141941	220220000	EPRS	78059	220217500	220222500
NM_001981	chr1	-	51819934	51984995	EPS15	165061	51982495	51987495
NM_001258374	chr19	-	16466054	16582823	EPS15L1	116769	16580323	16585323
NM_004447	chr12	-	15773074	15942510	EPS8	169436	15940010	15945010
NM_133180	chr19	+	55587220	55599291	EPS8L1	12071	55584720	55589720
NM_022772	chr11	+	706119	727727	EPS8L2	21608	703619	708619
NM_139053	chr1	-	110292701	110306644	EPS8L3	13943	110304144	110309144
NM_033255	chr13	-	43460523	43566448	EPSTI1	105925	43563948	43568948
NM_000502	chr17	+	56270084	56282535	EPX	12451	56267584	56272584
NM_004950	chr12	-	91357455	91398803	EPYC	41348	91396303	91401303
NM_001161585	chr9	-	27284653	27297137	EQTN	12484	27294637	27299637
NM_005702	chr17	+	27181974	27188085	ERAL1	6111	27179474	27184474
NM_016442	chr5	-	96096513	96143892	ERAP1	47379	96141392	96146392
NM_001329229	chr5	+	96211642	96255420	ERAP2	43778	96209142	96214142
NM_181532	chrX	+	48684922	48688279	ERAS	3357	48682422	48687422
NM_001289936	chr17	+	37844336	37884915	ERBB2	40579	37841836	37846836
NM_001982	chr12	+	56473808	56497291	ERBB3	23483	56471308	56476308
NM_005235	chr2	-	212240441	213403352	ERBB4	1162911	213400852	213405852
NM_001253697	chr5	+	65222381	65376851	ERBIN	154470	65219881	65224881
NR_027949	chr12	+	1100373	1605099	ERC1	504726	1097873	1102873
NR_132749	chr3	-	55542338	56502391	ERC2	960053	56499891	56504891
NM_001983	chr19	-	45910590	45927177	ERCC1	16587	45924677	45929677
NM_000400	chr19	-	45854648	45873845	ERCC2	19197	45871345	45876345
NM_000122	chr2	-	128014865	128051752	ERCC3	36887	128049252	128054252
NM_005236	chr16	+	14014013	14046205	ERCC4	32192	14011513	14016513
NM_000123	chr13	+	103498190	103528351	ERCC5	30161	103495690	103500690
NM_000124	chr10	-	50662525	50747169	ERCC6	84644	50744669	50749669
NM_001009954	chrX	-	71424504	71458897	ERCC6L	34393	71456397	71461397
NM_020207	chr9	+	98637899	98780735	ERCC6L2	142836	98635399	98640399
NM_000082	chr5	-	60169658	60240905	ERCC8	71247	60238405	60243405
NM_001432	chr4	+	75230859	75254477	EREG	23618	75228359	75233359
NM_006494	chr19	-	42751712	42759316	ERF	7604	42756816	42761816
NM_001291832	chr2	+	239067648	239077532	ERFE	9884	239065148	239070148
NM_001243432	chr21	-	39739182	40033704	ERG	294522	40031204	40036204
NM_007176	chr14	-	76117232	76127538	ERG28	10306	76125038	76130038
NM_001031711	chr5	+	172261222	172379688	ERGIC1	118466	172258722	172263722
NM_016570	chr12	-	29493578	29534143	ERGIC2	40565	29531643	29536643
NM_198398	chr20	+	34129777	34145405	ERGIC3	15628	34127277	34132277
NM_004450	chr14	-	69846839	69865021	ERH	18182	69862521	69867521
NM_153332	chr8	+	8860313	8890849	ERI1	30536	8857813	8862813
NM_080663	chr16	-	20791514	20817795	ERI2	26281	20815295	20820295
NM_024066	chr1	-	44686741	44820951	ERI3	134210	44818451	44823451
NR_110056	chr1	-	44688266	44709955	ERI3-IT1	21689	44707455	44712455
NM_001303100	chr8	-	564736	681239	ERICH1	116503	678739	683739
NM_001290030	chr2	+	171627191	171655481	ERICH2	28290	171624691	171629691
NM_001002912	chr1	-	75033794	75139422	ERICH3	105628	75136922	75141922
NR_121671	chr1	+	75043113	75091782	ERICH3-AS1	48669	75040613	75045613
NM_173549	chr8	+	99076749	99105838	ERICH5	29089	99074249	99079249
NM_152394	chr3	-	150377671	150421758	ERICH6	44087	150419258	150424258
NR_121675	chr3	+	150421350	150437933	ERICH6-AS1	16583	150418850	150423850
NM_182542	chr13	-	46115431	46189874	ERICH6B	74443	46187374	46192374
NM_001127398	chr2	+	54014067	54045956	ERLEC1	31889	54011567	54016567
NM_001100626	chr10	-	101909846	101945814	ERLIN1	35968	101943314	101948314
NM_007175	chr8	+	37594096	37615319	ERLIN2	21223	37591596	37596596
NM_001017922	chr1	+	43282775	43310660	ERMAP	27885	43280275	43285275
NM_001278532	chr6	+	170151717	170181680	ERMARD	29963	170149217	170154217
NM_001009959	chr2	-	158175124	158184225	ERMN	9101	158181725	158186725
NM_024896	chr9	-	5784571	5833081	ERMP1	48510	5830581	5835581
NM_001433	chr17	-	62120389	62207502	ERN1	87113	62205002	62210002
NM_033266	chr16	-	23701625	23724821	ERN2	23196	23722321	23727321
NM_014584	chr14	-	53106632	53162649	ERO1A	56017	53160149	53165149
NM_019891	chr1	-	236378421	236445339	ERO1B	66918	236442839	236447839
NM_152321	chr12	-	15066960	15091483	ERP27	24523	15088983	15093983
NM_006817	chr12	+	112451151	112461024	ERP29	9873	112448651	112453651
NM_015051	chr9	-	102741462	102861334	ERP44	119872	102858834	102863834
NM_018948	chr1	-	8071778	8086393	ERRFI1	14615	8083893	8088893
NM_001007253	chr7	-	64450732	64467124	ERV3-1	16392	64464624	64469624
NM_001348050	chr7	-	64434829	64467124	ERV3-1-ZNF117	32295	64464624	64469624
NM_207582	chr6	-	11102721	11112071	ERVFRD-1	9350	11109571	11114571
NM_001308491	chr21	-	44337360	44345708	ERVH48-1	8348	44343208	44348208
NR_040023	chr16	-	2708389	2723440	ERVK13-1	15051	2720940	2725940
NR_144445	chr19	+	58816739	58827023	ERVK3-1	10284	58814239	58819239
NM_001242690	chr4	-	53609683	53617807	ERVMER34-1	8124	53615307	53620307
NM_001191055	chr19	+	53547990	53554380	ERVV-2	6390	53545490	53550490
NM_138961	chr11	-	124623018	124632223	ESAM	9205	124629723	124634723
NM_052911	chr18	-	19109261	19180693	ESCO1	71432	19178193	19183193
NM_001017420	chr8	+	27632057	27662424	ESCO2	30367	27629557	27634557
NM_001984	chr13	-	47345390	47371367	ESD	25977	47368867	47373867
NM_001276380	chr20	-	13694968	13765579	ESF1	70611	13763079	13768079
NM_007036	chr5	-	54273694	54281414	ESM1	7720	54278914	54283914
NM_012291	chr12	+	53662082	53687427	ESPL1	25345	53659582	53664582
NM_031475	chr1	+	6484847	6521004	ESPN	36157	6482347	6487347
NM_194312	chr2	+	239008950	239041928	ESPNL	32978	239006450	239011450
NR_026567	chr1	-	17017712	17046652	ESPNP	28940	17044152	17049152
NM_001122742	chr6	+	152011630	152424408	ESR1	412778	152009130	152014130
NM_001291712	chr14	-	64693429	64805268	ESR2	111839	64802768	64807768
NR_027122	chr3	-	54666150	54673884	ESRG	7734	54671384	54676384
NM_017697	chr8	+	95653363	95719694	ESRP1	66331	95650863	95655863
NM_024939	chr16	-	68262449	68270136	ESRP2	7687	68267636	68272636
NM_001282451	chr11	+	64072999	64084212	ESRRA	11213	64070499	64075499
NM_004452	chr14	+	76837689	76968180	ESRRB	130491	76835189	76840189
NM_001134285	chr1	-	216676587	217311097	ESRRG	634510	217308597	217313597
NR_134304	chr22	-	19117791	19132190	ESS2	14399	19129690	19134690
NM_153448	chrX	-	103494718	103499599	ESX1	4881	103497099	103502099
NM_015292	chr12	+	56521985	56538460	ESYT1	16475	56519485	56524485
NM_020728	chr7	-	158523688	158622319	ESYT2	98631	158619819	158624819
NR_136409	chr3	+	138153414	138198784	ESYT3	45370	138150914	138155914
NM_019002	chr2	+	67624441	67637533	ETAA1	13092	67621941	67626941
NM_001291975	chr5	-	137841781	137878989	ETF1	37208	137876489	137881489
NM_000126	chr15	-	76508628	76603810	ETFA	95182	76601310	76606310
NM_001985	chr19	-	51848408	51869672	ETFB	21264	51867172	51872172
NM_001135864	chr12	+	31800093	31822016	ETFBKMT	21923	31797593	31802593
NM_001281737	chr4	+	159593252	159629865	ETFDH	36613	159590752	159595752
NM_001001660	chr12	+	25348149	25357949	ETFRF1	9800	25345649	25350649
NM_001320867	chr19	-	44010870	44031408	ETHE1	20538	44028908	44033908
NM_018638	chr12	+	22778075	22843608	ETNK1	65533	22775575	22780575
NM_001297761	chr1	-	204100188	204121310	ETNK2	21122	204118810	204123810
NM_001146627	chr4	-	109663201	109684235	ETNPPL	21034	109681735	109686735
NM_001143820	chr11	-	128328655	128457453	ETS1	128798	128454953	128459953
NM_001256295	chr21	+	40177230	40196878	ETS2	19648	40174730	40179730
NM_001163148	chr7	-	13930855	14031050	ETV1	100195	14028550	14033550
NM_001300974	chr19	+	36132638	36135773	ETV2	3135	36130138	36135138
NM_001145312	chr1	-	157094458	157108383	ETV3	13925	157105883	157110883
NM_001004341	chr1	-	157061834	157069600	ETV3L	7766	157067100	157072100
NM_001079675	chr17	-	41605210	41623800	ETV4	18590	41621300	41626300
NM_004454	chr3	-	185764105	185826901	ETV5	62796	185824401	185829401
NM_001987	chr12	+	11802787	12048325	ETV6	245538	11800287	11805287
NM_001207035	chr6	-	36321997	36355577	ETV7	33580	36353077	36358077
NM_032181	chr2	-	75719443	75796848	EVA1A	77405	75794348	75799348
NM_001320745	chr21	+	33783999	33887710	EVA1C	103711	33781499	33786499
NR_125857	chr6	+	71103904	71109120	EVADR	5216	71101404	71106404
NM_001306090	chr4	+	5712923	5816031	EVC	103108	5710423	5715423
NM_001166136	chr4	-	5564145	5711275	EVC2	147130	5708775	5713775
NM_014210	chr17	-	29643427	29648767	EVI2A	5340	29646267	29651267
NM_006495	chr17	-	29630787	29641130	EVI2B	10343	29638630	29643630
NM_005665	chr1	-	92974252	93257961	EVI5	283709	93255461	93260461
NM_145245	chr19	+	7895160	7929862	EVI5L	34702	7892660	7897660
NM_001330221	chr14	+	100437811	100610573	EVL	172762	100435311	100440311
NM_001320747	chr17	-	74002925	74023533	EVPL	20608	74021033	74026033
NM_001145127	chr17	+	18281078	18292960	EVPLL	11882	18278578	18283578
NM_001304519	chr7	+	27282163	27287438	EVX1	5275	27279663	27284663
NR_120507	chr7	-	27281047	27286848	EVX1-AS	5801	27284348	27289348
NM_001080458	chr2	-	176944834	176948690	EVX2	3856	176946190	176951190
NR_026949	chr15	+	69373189	69388163	EWSAT1	14974	69370689	69375689
NM_001163286	chr22	+	29663997	29696515	EWSR1	32518	29661497	29666497
NM_001286441	chr15	-	41474930	41522955	EXD1	48025	41520455	41525455
NM_001193361	chr14	+	69658193	69710737	EXD2	52544	69655693	69660693
NM_017820	chr9	-	140201345	140317714	EXD3	116369	140315214	140320214
NM_001319224	chr1	+	242011492	242053241	EXO1	41749	242008992	242013992
NM_022774	chr1	+	40974390	40981722	EXO5	7332	40971890	40976890
NM_018261	chr4	+	56719815	56771244	EXOC1	51429	56717315	56722315
NM_001351574	chr4	+	56686168	56703548	EXOC1L	17380	56683668	56688668
NR_073064	chr6	-	485137	693141	EXOC2	208004	690641	695641
NM_007277	chr5	+	443333	467409	EXOC3	24076	440833	445833
NM_178516	chr16	-	67218281	67224107	EXOC3L1	5826	67221607	67226607
NM_138568	chr19	-	45715634	45737469	EXOC3L2	21835	45734969	45739969
NM_001077594	chr14	+	103566480	103576894	EXOC3L4	10414	103563980	103568980
NM_021807	chr7	+	132937822	133750513	EXOC4	812691	132935322	132940322
NM_006544	chr14	-	57669193	57735617	EXOC5	66424	57733117	57738117
NM_001013848	chr10	+	94586587	94819251	EXOC6	232664	94584087	94589087
NM_001321730	chr2	-	72403112	73053171	EXOC6B	650059	73050671	73055671
NM_015219	chr17	-	74077073	74099868	EXOC7	22795	74097368	74102368
NM_175876	chr1	-	231468476	231473618	EXOC8	5142	231471118	231476118
NM_001318957	chr3	+	38537762	38567796	EXOG	30034	38535262	38540262
NM_001318362	chr10	-	99195665	99205774	EXOSC1	10109	99203274	99208274
NM_002685	chr1	-	11126669	11159967	EXOSC10	33298	11157467	11162467
NM_001282708	chr9	+	133569146	133580281	EXOSC2	11135	133566646	133571646
NM_016042	chr9	-	37779710	37785089	EXOSC3	5379	37782589	37787589
NM_020158	chr19	-	41892275	41903256	EXOSC5	10981	41900756	41905756
NR_023353	chr3	+	45017740	45054158	EXOSC7	36418	45015240	45020240
NM_181503	chr13	+	37574677	37583751	EXOSC8	9074	37572177	37577177
NM_005033	chr4	+	122722471	122738176	EXOSC9	15705	122719971	122724971
NM_001308019	chr11	-	108376157	108464465	EXPH5	88308	108461965	108466965
NM_000127	chr8	-	118811601	119124058	EXT1	312457	119121558	119126558
NM_001178083	chr11	+	44117098	44266980	EXT2	149882	44114598	44119598
NM_004455	chr1	+	26348270	26362954	EXTL1	14684	26345770	26350770
NM_001261440	chr1	-	101337927	101360735	EXTL2	22808	101358235	101363235
NM_001440	chr8	+	28558989	28611207	EXTL3	52218	28556489	28561489
NR_126027	chr8	-	28555919	28558981	EXTL3-AS1	3062	28556481	28561481
NM_001288575	chr8	-	72109667	72274467	EYA1	164800	72271967	72276967
NM_172110	chr20	+	45523262	45817492	EYA2	294230	45520762	45525762
NM_001282562	chr1	-	28296854	28415148	EYA3	118294	28412648	28417648
NM_172103	chr6	+	133562494	133853258	EYA4	290764	133559994	133564994
NM_001142800	chr6	-	64429875	66417118	EYS	1987243	66414618	66419618
NM_001321079	chr17	-	40852292	40897114	EZH1	44822	40894614	40899614
NM_004456	chr7	-	148504463	148581441	EZH2	76978	148578941	148583941
NM_001111077	chr6	-	159186772	159240456	EZR	53684	159237956	159242956
NR_102425	chr6	+	159239010	159243272	EZR-AS1	4262	159236510	159241510
NM_001312674	chr13	+	113777112	113803843	F10	26731	113774612	113779612
NM_000128	chr4	+	187187117	187210835	F11	23718	187184617	187189617
NR_033900	chr4	-	187207251	187422212	F11-AS1	214961	187419712	187424712
NM_016946	chr1	-	160964995	160991133	F11R	26138	160988633	160993633
NM_000505	chr5	-	176829138	176836577	F12	7439	176834077	176839077
NM_000129	chr6	-	6144310	6320924	F13A1	176614	6318424	6323424
NM_001994	chr1	-	197008320	197036397	F13B	28077	197033897	197038897
NM_000506	chr11	+	46740715	46761058	F2	20343	46738215	46743215
NM_001311313	chr5	+	76011867	76031605	F2R	19738	76009367	76014367
NM_005242	chr5	+	76114801	76131140	F2RL1	16339	76112301	76117301
NM_004101	chr5	-	75911306	75919259	F2RL2	7953	75916759	75921759
NM_003950	chr19	+	16999670	17003411	F2RL3	3741	16997170	17002170
NM_001993	chr1	-	94994731	95007413	F3	12682	95004913	95009913
NM_000130	chr1	-	169481191	169555769	F5	74578	169553269	169558269
NM_000131	chr13	+	113760101	113774995	F7	14894	113757601	113762601
NM_000132	chrX	-	154064063	154250998	F8	186935	154248498	154253498
NM_000133	chrX	+	138612894	138645617	F9	32723	138610394	138615394
NM_024306	chr16	-	74746855	74808729	FA2H	61874	74806229	74811229
NM_001441	chr1	+	46859938	46879520	FAAH	19582	46857438	46862438
NM_174912	chrX	+	57313109	57515629	FAAH2	202520	57310609	57315609
NR_045483	chr1	+	46899498	46911374	FAAHP1	11876	46896998	46901998
NR_033338	chr17	-	79506910	79519429	FAAP100	12519	79516929	79521929
NM_001146310	chr1	-	2115898	2139172	FAAP20	23274	2136672	2141672
NM_001300978	chr19	+	33463122	33468401	FAAP24	5279	33460622	33465622
NM_001443	chr2	-	88422507	88427650	FABP1	5143	88425150	88430150
NM_001105281	chr8	-	82437215	82443625	FABP12	6410	82441125	82446125
NM_000134	chr4	-	120238404	120243316	FABP2	4912	120240816	120245816
NM_004102	chr1	-	31838099	31846135	FABP3	8036	31843635	31848635
NM_001442	chr8	-	82390731	82395473	FABP4	4742	82392973	82397973
NM_001444	chr8	+	82192717	82197012	FABP5	4295	82190217	82195217
NR_002935	chr7	+	152133979	152140100	FABP5P3	6121	152131479	152136479
NM_001130958	chr5	+	159614373	159665729	FABP6	51356	159611873	159616873
NM_001319042	chr6	+	123070345	123105222	FABP7	34877	123067845	123072845
NM_001080526	chr8	-	82370617	82373758	FABP9	3141	82371258	82376258
NM_003824	chr11	+	70049268	70053508	FADD	4240	70046768	70051768
NM_013402	chr11	-	61567096	61584529	FADS1	17433	61582029	61587029
NM_001281501	chr11	+	61583674	61634826	FADS2	51152	61581174	61586174
NM_021727	chr11	-	61640994	61659017	FADS3	18023	61656517	61661517
NM_178128	chr17	-	72873441	72889909	FADS6	16468	72887409	72892409
NM_007051	chr1	-	50906934	51425936	FAF1	519002	51423436	51428436
NM_014613	chr5	+	175875355	175937075	FAF2	61720	175872855	175877855
NM_000137	chr15	+	80445232	80478924	FAH	33692	80442732	80447732
NM_001142398	chr16	+	1877224	1890203	FAHD1	12979	1874724	1879724
NM_016044	chr2	+	96068447	96078879	FAHD2A	10432	96065947	96070947
NM_001320848	chr2	-	97749322	97760619	FAHD2B	11297	97758119	97763119
NR_003698	chr2	+	96676298	96688884	FAHD2CP	12586	96673798	96678798
NM_001033032	chr3	+	138327541	138352213	FAIM	24672	138325041	138330041
NM_012306	chr12	-	50260678	50297760	FAIM2	37082	50295260	50300260
NM_001035254	chr9	-	130702860	130742812	FAM102A	39952	130740312	130745312
NM_001010883	chr1	+	109102970	109181949	FAM102B	78979	109100470	109105470
NM_031452	chr15	+	83654954	83659809	FAM103A1	4855	83652454	83657454
NM_001289410	chr17	-	71203491	71228533	FAM104A	25042	71226033	71231033
NM_138362	chrX	-	55169534	55187628	FAM104B	18094	55185128	55190128
NM_019018	chr5	+	14581890	14616287	FAM105A	34397	14579390	14584390
NM_001282714	chr3	-	58549838	58613337	FAM107A	63499	58610837	58615837
NM_001282695	chr10	-	14560555	14816896	FAM107B	256341	14814396	14819396
NM_001177997	chr12	-	111798454	111806925	FAM109A	8471	111804425	111809425
NM_001002034	chr22	+	42470254	42475442	FAM109B	5188	42467754	42472754
NM_001289146	chr20	+	814339	826922	FAM110A	12583	811839	816839
NM_147189	chr8	+	58907112	59062277	FAM110B	155165	58904612	58909612
NM_001077710	chr2	-	38813	46588	FAM110C	7775	44088	49088
NM_024869	chr1	+	26485510	26489119	FAM110D	3609	26483010	26488010
NM_001312909	chr11	+	58910218	58922511	FAM111A	12293	58907718	58912718
NM_198947	chr11	+	58874657	58894888	FAM111B	20231	58872157	58877157
NM_138389	chr4	+	38869353	38947365	FAM114A1	78012	38866853	38871853
NM_001317995	chr5	-	153369690	153418498	FAM114A2	48808	153415998	153420998
NM_030802	chr17	-	47787686	47841518	FAM117A	53832	47839018	47844018
NM_173511	chr2	+	203499900	203634480	FAM117B	134580	203497400	203502400
NR_146323	chr22	+	45704840	45737836	FAM118A	32996	45702340	45707340
NM_001330446	chr11	+	126081618	126132882	FAM118B	51264	126079118	126084118
NM_014612	chr9	+	96213977	96328397	FAM120A	114420	96211477	96216477
NR_136231	chr9	-	96208776	96215883	FAM120AOS	7107	96213383	96218383
NM_001286379	chr6	+	170599790	170716159	FAM120B	116369	170597290	170602290
NM_001300788	chrX	-	54094756	54209714	FAM120C	114958	54207214	54212214
NM_138333	chr9	+	71394921	71398795	FAM122A	3874	71392421	71397421
NM_001170757	chrX	-	133903595	133931262	FAM122B	27667	133928762	133933762
NM_001170779	chrX	+	133941222	133988641	FAM122C	47419	133938722	133943722
NM_001242312	chr13	+	51796469	51858377	FAM124A	61908	51793969	51798969
NM_001122779	chr2	-	225243414	225266711	FAM124B	23297	225264211	225269211
NM_032581	chr7	-	22980877	23053770	FAM126A	72893	23051270	23056270
NM_001321629	chr2	-	201838440	201936394	FAM126B	97954	201933894	201938894
NM_052966	chr1	-	184760158	184943718	FAM129A	183560	184941218	184946218
NM_001035534	chr9	-	130267616	130341286	FAM129B	73670	130338786	130343786
NM_173544	chr19	+	17634109	17664648	FAM129C	30539	17631609	17636609
NM_001171093	chr3	+	184053716	184064063	FAM131A	10347	184051216	184056216
NM_001278297	chr7	-	143050492	143059840	FAM131B	9348	143057340	143062340
NM_182623	chr1	-	16384263	16400127	FAM131C	15864	16397627	16402627
NM_001171110	chrX	+	92929011	92967273	FAM133A	38262	92926511	92931511
NM_152789	chr7	-	92190071	92219708	FAM133B	29637	92217208	92222208
NR_027508	chr10	+	60474774	60477293	FAM133CP	2519	60472274	60477274
NR_034169	chr7	-	92190367	92219696	FAM133DP	29329	92217196	92222196
NM_001105531	chr6	+	71123106	71270877	FAM135A	147771	71120606	71125606
NM_015912	chr8	-	139142265	139509065	FAM135B	366800	139506565	139511565
NM_032822	chr2	-	70523107	70529220	FAM136A	6113	70526720	70531720
NM_014883	chr4	-	89647104	89978346	FAM13A	331242	89975846	89980846
NR_002806	chr4	+	89630939	89651254	FAM13A-AS1	20315	89628439	89633439
NM_016603	chr5	-	137273606	137368802	FAM13B	95196	137366302	137371302
NM_001347842	chr10	-	61005888	61122939	FAM13C	117051	61120439	61125439
NM_001006655	chr4	+	187065440	187093817	FAM149A	28377	187062940	187067940
NM_173348	chr10	+	74927876	75001939	FAM149B1	74063	74925376	74930376
NM_176782	chr1	-	55074849	55089200	FAM151A	14351	55086700	55091700
NM_205548	chr5	+	79783799	79838382	FAM151B	54583	79781299	79786299
NR_146226	chr5	-	177138050	177210426	FAM153A	72376	177207926	177212926
NM_001265615	chr5	+	175490711	175541801	FAM153B	51090	175488211	175493211
NR_038353	chr5	+	177433966	177476088	FAM153C	42122	177431466	177436466
NM_001080396	chr13	-	107820878	108519460	FAM155A	698582	108516960	108521960
NR_046848	chr13	-	108439708	108487806	FAM155A-IT1	48098	108485306	108490306
NM_015686	chrX	+	68725077	68752351	FAM155B	27274	68722577	68727577
NM_001242495	chrX	-	52976463	53024651	FAM156A	48188	53022151	53027151
NM_001321181	chrX	+	52920628	52937585	FAM156B	16957	52918128	52923128
NR_146164	chr3	+	197880076	197949384	FAM157A	69308	197877576	197882576
NR_146178	chr3	+	197879909	197936238	FAM157B	56329	197877409	197882409
NR_126161	chr16	+	90168671	90244014	FAM157C	75343	90166171	90171171
NR_135157	chr1	+	53099015	53134792	FAM159A	35777	53096515	53101515
NM_001164442	chr5	+	63986134	64014017	FAM159B	27883	63983634	63988634
NM_001109977	chr4	+	152330367	152591655	FAM160A1	261288	152327867	152332867
NM_001098794	chr11	-	6232563	6255941	FAM160A2	23378	6253441	6258441
NM_001135051	chr10	+	116581502	116659586	FAM160B1	78084	116579002	116584002
NM_022749	chr8	+	21946713	21961891	FAM160B2	15178	21944213	21949213
NM_032180	chr2	-	62051982	62081278	FAM161A	29296	62078778	62083778
NM_152445	chr14	-	74399694	74417117	FAM161B	17423	74414617	74419617
NM_014367	chr3	+	122103022	122128961	FAM162A	25939	122100522	122105522
NM_001085480	chr6	-	117073359	117086886	FAM162B	13527	117084386	117089386
NM_001329713	chr1	+	179696897	179785335	FAM163A	88438	179694397	179699397
NM_001001710	chr9	-	140138034	140142244	FAM166A	4210	140139744	140144744
NM_053279	chr8	-	11278972	11324276	FAM167A	45304	11321776	11326776
NR_026814	chr8	+	11225910	11296166	FAM167A-AS1	70256	11223410	11228410
NM_001286051	chr11	-	73111522	73309234	FAM168A	197712	73306734	73311734
NM_001321744	chr2	-	131805448	131851033	FAM168B	45585	131848533	131853533
NM_015566	chr5	-	74073398	74162663	FAM169A	89265	74160163	74165163
NM_182562	chr15	-	98980390	99057611	FAM169B	77221	99055111	99060111
NM_182761	chr5	+	118965253	118971517	FAM170A	6264	118962753	118967753
NM_001164484	chr10	-	50339200	50342065	FAM170B	2865	50339565	50344565
NR_038973	chr10	+	50329883	50359592	FAM170B-AS1	29709	50327383	50332383
NM_001010924	chr10	-	15253643	15413058	FAM171A1	159415	15410558	15415558
NM_198475	chr17	-	42431100	42441235	FAM171A2	10135	42438735	42443735
NM_177454	chr2	+	187558788	187628512	FAM171B	69724	187556288	187561288
NR_028080	chr5	-	92953430	93447404	FAM172A	493974	93444904	93449904
NR_036433	chr3	+	101237710	101242731	FAM172BP	5021	101235210	101240210
NM_001258389	chr5	-	10225619	10250021	FAM173B	24402	10247521	10252521
NM_198507	chr5	+	99871008	99922444	FAM174A	51436	99868508	99873508
NM_207446	chr15	-	93160678	93199031	FAM174B	38353	93196531	93201531
NM_001079519	chr14	+	35514112	35552589	FAM177A1	38477	35511612	35516612
NR_136691	chr1	+	222910557	222924147	FAM177B	13590	222908057	222913057
NM_001122646	chr2	-	97541618	97652301	FAM178B	110683	97649801	97654801
NM_205855	chr7	-	135414345	135433594	FAM180A	19249	135431094	135436094
NM_001164379	chr11	+	47608229	47610746	FAM180B	2517	47605729	47610729
NM_001207071	chr14	+	94385239	94395954	FAM181A	10715	94382739	94387739
NR_027004	chr14	-	94371075	94392718	FAM181A-AS1	21643	94390218	94395218
NR_026713	chr20	+	26035249	26067553	FAM182A	32304	26032749	26037749
NR_027061	chr20	-	25744101	25776878	FAM182B	32777	25774378	25779378
NM_001101376	chr1	+	43613593	43622067	FAM183A	8474	43611093	43616093
NM_001288576	chr6	-	119280993	119470358	FAM184A	189365	119467858	119472858
NM_015688	chr4	-	17633708	17783135	FAM184B	149427	17780635	17785635
NR_146979	chr7	+	102389398	102491153	FAM185A	101755	102386898	102391898
NR_146190	chr7	-	76710971	76751606	FAM185BP	40635	76749106	76754106
NM_001145475	chr12	-	50721094	50790405	FAM186A	69311	50787905	50792905
NR_027450	chr12	-	49976657	49999410	FAM186B	22753	49996910	50001910
NM_152481	chr19	-	35715703	35719628	FAM187B	3925	35717128	35722128
NM_015307	chr15	-	29412454	29862927	FAM189A1	450473	29860427	29865427
NM_001127608	chr9	+	71939487	72007390	FAM189A2	67903	71936987	71941987
NM_001267608	chr1	-	155216995	155225274	FAM189B	8279	155222774	155227774
NM_024946	chr16	-	57186377	57219976	FAM192A	33599	57217476	57222476
NR_046336	chr4	+	2627158	2734302	FAM193A	107144	2624658	2629658
NM_001190946	chr5	-	176946789	176981586	FAM193B	34797	176979086	176984086
NM_001039762	chr10	-	128933689	128994422	FAM196A	60733	128991922	128996922
NM_001129891	chr5	-	169288309	169407761	FAM196B	119452	169405261	169410261
NR_001553	chrY	-	9207465	9213071	FAM197Y2	5606	9210571	9215571
NR_145461	chrY	-	9336949	9342550	FAM197Y3	5601	9340050	9345050
NR_145470	chrY	-	9207465	9213071	FAM197Y4	5606	9210571	9215571
NR_046300	chrY	-	9207465	9213071	FAM197Y5	5606	9210571	9215571
NR_145469	chrY	-	9227799	9233417	FAM197Y6	5618	9230917	9235917
NR_145460	chrY	-	9207465	9213071	FAM197Y7	5606	9210571	9215571
NR_145468	chrY	-	9207465	9213071	FAM197Y8	5606	9210571	9215571
NR_145462	chrY	-	6126373	6131976	FAM197Y9	5603	6129476	6134476
NM_001129908	chr3	+	43020758	43099207	FAM198A	78449	43018258	43023258
NM_001031700	chr4	-	159045731	159094202	FAM198B	48471	159091702	159096702
NM_207318	chrX	+	103411155	103440582	FAM199X	29427	103408655	103413655
NM_001252216	chr3	+	68040733	68594771	FAM19A1	554038	68038233	68043233
NM_178539	chr12	-	62102028	62586620	FAM19A2	484592	62584120	62589120
NM_001004440	chr1	+	113263188	113269856	FAM19A3	6668	113260688	113265688
NM_001005527	chr3	-	68780914	68981761	FAM19A4	200847	68979261	68984261
NM_001082967	chr22	+	48885271	49147747	FAM19A5	262476	48882771	48887771
NM_145111	chr7	-	99143922	99149757	FAM200A	5835	99147257	99152257
NM_001145191	chr4	+	15683351	15692070	FAM200B	8719	15680851	15685851
NM_022063	chr10	-	120068571	120101839	FAM204A	33268	120099339	120104339
NM_001141917	chr9	-	34723049	34729535	FAM205A	6486	34727035	34732035
NR_024481	chr9	-	34830263	34838583	FAM205BP	8320	34836083	34841083
NM_001309427	chr9	-	34889060	34895775	FAM205C	6715	34893275	34898275
NM_017832	chr9	+	111696672	111703237	FAM206A	6565	111694172	111699172
NM_001316988	chr21	+	46359611	46396904	FAM207A	37293	46357111	46362111
NM_001112736	chr3	-	56654159	56717135	FAM208A	62976	56714635	56719635
NM_017782	chr10	+	5726800	5805703	FAM208B	78903	5724300	5729300
NM_001013646	chr20	+	55108301	55111574	FAM209B	3273	55105801	55110801
NM_001243746	chr17	-	66531256	66597095	FAM20A	65839	66594595	66599595
NM_001324310	chr1	+	178994938	179045709	FAM20B	50771	178992438	178997438
NM_020223	chr7	+	192968	300740	FAM20C	107772	190468	195468
NM_001098801	chr18	-	13663345	13726591	FAM210A	63246	13724091	13729091
NM_080821	chr20	+	54933982	54943718	FAM210B	9736	54931482	54936482
NM_198926	chr1	-	112264685	112298419	FAM212B	33734	112295919	112300919
NR_038952	chr1	+	112282462	112290420	FAM212B-AS1	7958	112279962	112284962
NM_001243779	chr10	+	82167584	82192753	FAM213A	25169	82165084	82170084
NR_036637	chr1	+	2517898	2522908	FAM213B	5010	2515398	2520398
NM_019600	chr15	-	52873517	52970831	FAM214A	97314	52968331	52973331
NR_134455	chr9	-	35104117	35115969	FAM214B	11852	35113469	35118469
NM_013300	chr12	+	110906231	110928192	FAM216A	21961	110903731	110908731
NM_001318932	chr13	+	43355685	43365686	FAM216B	10001	43353185	43358185
NM_173563	chr6	-	4068592	4079457	FAM217A	10865	4076957	4081957
NM_001190826	chr20	+	58508818	58523702	FAM217B	14884	58506318	58511318
NM_147202	chr9	-	34398181	34458568	FAM219A	60387	34456068	34461068
NM_001321921	chr15	-	75192327	75199235	FAM219B	6908	75196735	75201735
NR_038275	chr10	-	51780941	51827563	FAM21EP	46622	51825063	51830063
NM_001037163	chr7	-	6369039	6388590	FAM220A	19551	6386090	6391090
NM_001300932	chr7	+	23719732	23742269	FAM221A	22537	23717232	23722232
NR_052026	chr9	-	35817013	35828744	FAM221B	11731	35826244	35831244
NM_032829	chr12	+	110152186	110208312	FAM222A	56126	110149686	110154686
NR_026661	chr12	-	110172013	110211292	FAM222A-AS1	39279	110208792	110213792
NM_001288636	chr17	-	27082995	27169857	FAM222B	86862	27167357	27172357
NR_002161	chrY	+	20488418	20492712	FAM224A	4294	20485918	20490918
NR_002160	chrY	+	20488439	20492736	FAM224B	4297	20485939	20490939
NR_024366	chr9	+	115875175	115882126	FAM225A	6951	115872675	115877675
NR_024376	chr9	-	115867002	115873957	FAM225B	6955	115871457	115876457
NM_001291030	chr22	-	38974124	39052634	FAM227A	78510	39050134	39055134
NM_152647	chr15	-	49620591	49913118	FAM227B	292527	49910618	49915618
NM_001040710	chr2	+	24397911	24414567	FAM228A	16656	24395411	24400411
NM_001291328	chr2	+	24299743	24392507	FAM228B	92764	24297243	24302243
NM_001033564	chr6	+	112408673	112423993	FAM229B	15320	112406173	112411173
NR_136560	chr22	+	20336993	20350461	FAM230A	13468	20334493	20339493
NR_108107	chr22	+	21521191	21546445	FAM230B	25254	21518691	21523691
NR_027278	chrUn_gl000212	+	24048	60768	FAM230C	36720	21548	26548
NR_145442	chr1	+	149288234	149291701	FAM231D	3467	149285734	149290734
NR_104317	chr16	+	284544	319942	FAM234A	35398	282044	287044
NM_020853	chr12	+	13197314	13236383	FAM234B	39069	13194814	13199814
NM_001102659	chr2	+	207508950	207514078	FAM237A	5128	207506450	207511450
NR_026793	chr10	+	26878793	26883251	FAM238A	4458	26876293	26881293
NR_026794	chr10	+	26932036	26942383	FAM238B	10347	26929536	26934536
NR_026795	chr10	-	27220134	27230930	FAM238C	10796	27228430	27233430
NM_001195442	chr3	+	46653924	46668033	FAM240A	14109	46651424	46656424
NM_001204364	chr10	-	124608609	124639157	FAM24B	30548	124636657	124641657
NR_037915	chr10	-	124591670	124639157	FAM24B-CUZD1	47487	124636657	124641657
NM_001146157	chr10	+	88780045	88784487	FAM25A	4442	88777545	88782545
NR_104039	chr10	+	47740303	47744822	FAM25BP	4519	47737803	47742803
NM_001137548	chr10	-	47177203	47181688	FAM25C	4485	47179188	47184188
NM_001137549	chr10	-	47177221	47181688	FAM25G	4467	47179188	47184188
NM_153036	chr6	+	116850175	116882286	FAM26D	32111	116847675	116852675
NM_153711	chr6	+	116832807	116845955	FAM26E	13148	116830307	116835307
NR_026800	chr14	+	106383837	106398502	FAM30A	14665	106381337	106386337
NR_145444	chr15	+	21208605	21255165	FAM30C	46560	21206105	21211105
NM_014077	chr19	+	16296211	16302857	FAM32A	6646	16293711	16298711
NM_001330112	chr10	+	88854921	88951240	FAM35A	96319	88852421	88857421
NR_027632	chr10	+	46897640	46939145	FAM35BP	41505	46895140	46900140
NR_027634	chr10	+	47379719	47421238	FAM35DP	41519	47377219	47382219
NM_001282312	chrX	-	153734489	153744566	FAM3A	10077	153742066	153747066
NM_206964	chr21	+	42688660	42729654	FAM3B	40994	42686160	42691160
NM_014888	chr7	-	120988904	121036422	FAM3C	47518	121033922	121038922
NM_138805	chr3	-	58619669	58652561	FAM3D	32892	58650061	58655061
NR_134853	chr3	+	58592806	58620167	FAM3D-AS1	27361	58590306	58595306
NR_028083	chrY	+	19612837	19628622	FAM41AY1	15785	19610337	19615337
NR_028084	chrY	+	19612837	19628622	FAM41AY2	15785	19610337	19615337
NR_027055	chr1	-	803450	812182	FAM41C	8732	809682	814682
NM_153690	chr3	+	194406621	194409766	FAM43A	3145	194404121	194409121
NM_207334	chr1	+	20878931	20881513	FAM43B	2582	20876431	20881431
NM_001303113	chr10	+	120863576	120897496	FAM45A	33920	120861076	120866076
NR_027141	chr10	+	120863628	120897376	FAM45BP	33748	120861128	120866128
NM_017633	chr6	-	82455446	82462428	FAM46A	6982	82459928	82464928
NM_052943	chr1	-	27331510	27339333	FAM46B	7823	27336833	27341833
NM_017709	chr1	+	118148603	118171011	FAM46C	22408	118146103	118151103
NM_001170574	chrX	+	79591002	79700810	FAM46D	109808	79588502	79593502
NM_203408	chrX	-	34147868	34150447	FAM47A	2579	34147947	34152947
NM_001013736	chrX	+	37026431	37029739	FAM47C	3308	37023931	37028931
NM_001242936	chr4	+	77135192	77204936	FAM47E	69744	77132692	77137692
NM_001242939	chr4	+	77172852	77232283	FAM47E-STBD1	59431	77170352	77175352
NM_030797	chr2	-	16730729	16847134	FAM49A	116405	16844634	16849634
NM_001353245	chr8	-	130851838	131029375	FAM49B	177537	131026875	131031875
NM_004699	chrX	+	153672472	153679002	FAM50A	6530	153669972	153674972
NM_001174070	chr4	-	1641607	1686040	FAM53A	44433	1683540	1688540
NM_014661	chr10	-	126307862	126432930	FAM53B	125068	126430430	126435430
NR_120631	chr10	+	126392596	126403329	FAM53B-AS1	10733	126390096	126395096
NM_001135647	chr5	+	137673223	137685418	FAM53C	12195	137670723	137675723
NM_001318008	chr17	+	635785	646208	FAM57A	10423	633285	638285
NM_001352173	chr16	-	30035743	30048014	FAM57B	12271	30045514	30050514
NM_152274	chrX	-	152853382	152864632	FAM58A	11250	152862132	152867132
NM_001135812	chr12	-	31433519	31479159	FAM60A	45640	31476659	31481659
NR_026789	chr8	+	12219527	12268510	FAM66A	48983	12217027	12222027
NR_027423	chr8	-	7159132	7212876	FAM66B	53744	7210376	7215376
NR_026788	chr12	+	8332804	8353596	FAM66C	20792	8330304	8335304
NR_027425	chr8	+	11973290	12008698	FAM66D	35408	11970790	11975790
NR_027424	chr8	+	7812534	7866277	FAM66E	53743	7810034	7815034
NM_001252273	chr1	-	93298285	93427079	FAM69A	128794	93424579	93429579
NM_152421	chr9	+	139607023	139619170	FAM69B	12147	139604523	139609523
NM_001044369	chr18	-	72102962	72124503	FAM69C	21541	72122003	72127003
NM_130899	chr5	-	156589343	156593279	FAM71B	3936	156590779	156595779
NM_173526	chr14	+	67656109	67695267	FAM71D	39158	67653609	67658609
NM_001308429	chr19	-	50970041	50980003	FAM71E1	9962	50977503	50982503
NM_001145402	chr19	-	55866275	55874620	FAM71E2	8345	55872120	55877120
NR_104243	chr7	+	128349114	128371797	FAM71F1	22683	128346614	128351614
NM_001290255	chr7	+	128312319	128327926	FAM71F2	15607	128309819	128314819
NM_001317901	chr1	+	206137264	206155151	FAM72A	17887	206134764	206139764
NM_001100910	chr1	+	120839004	120855681	FAM72B	16677	120836504	120841504
NM_001346067	chr1	-	143896524	143914673	FAM72C	18149	143912173	143917173
NR_144320	chr1	-	143896451	143914847	FAM72D	18396	143912347	143917347
NR_026803	chr9	+	41516053	41521999	FAM74A1	5946	41513553	41518553
NR_026801	chr9	+	40715523	40722679	FAM74A3	7156	40713023	40718023
NR_026802	chr9	-	65487272	65494386	FAM74A4	7114	65491886	65496886
NR_110999	chr9	+	41516053	41521999	FAM74A6	5946	41513553	41518553
NR_126166	chr9	-	43608372	43615527	FAM74A7	7155	43613027	43618027
NM_152660	chr1	+	28052489	28089423	FAM76A	36934	28049989	28054989
NM_001330357	chr11	-	95502105	95522955	FAM76B	20850	95520455	95525455
NM_033387	chr9	-	134133464	134151906	FAM78A	18442	134149406	134154406
NM_001320302	chr1	-	166025154	166135992	FAM78B	110838	166133492	166138492
NM_152450	chr15	+	59730371	59815751	FAM81A	85380	59727871	59732871
NM_152548	chr5	+	94727047	94786144	FAM81B	59097	94724547	94729547
NM_207006	chr8	+	124191286	124222319	FAM83A	31033	124188786	124193786
NM_001010872	chr6	+	54711568	54809897	FAM83B	98329	54709068	54714068
NM_178468	chr20	-	33873533	33880225	FAM83C	6692	33877725	33882725
NM_030919	chr20	+	37554954	37581703	FAM83D	26749	37552454	37557454
NM_017708	chr19	-	49103856	49116694	FAM83E	12838	49114194	49119194
NM_138435	chr22	+	40390952	40426043	FAM83F	35091	40388452	40393452
NM_001039999	chr17	-	18874380	18908060	FAM83G	33680	18905560	18910560
NM_198488	chr8	-	144806102	144815914	FAM83H	9812	144813414	144818414
NR_033849	chr8	+	144816309	144828507	FAM83H-AS1	12198	144813809	144818809
NR_144632	chr2	+	14772806	14792040	FAM84A	19234	14770306	14775306
NM_174911	chr8	-	127564682	127570711	FAM84B	6029	127568211	127573211
NR_146925	chr8	+	12043244	12060035	FAM85A	16791	12040744	12045744
NR_147089	chr8	-	7958283	8085025	FAM85B	126742	8082525	8087525
NR_003494	chr8	-	12039612	12051624	FAM86B1	12012	12049124	12054124
NM_001137610	chr8	-	12283123	12293852	FAM86B2	10729	12291352	12296352
NR_024361	chr8	+	8086091	8102387	FAM86B3P	16296	8083591	8088591
NM_152563	chr11	+	71498556	71512280	FAM86C1	13724	71496056	71501056
NR_024249	chr11	-	67559237	67572807	FAM86C2P	13570	67570307	67575307
NR_024241	chr3	-	75470702	75484266	FAM86DP	13564	75481766	75486766
NR_130741	chr4	-	3943486	3957155	FAM86EP	13669	3954655	3959655
NR_024254	chr12	-	8383644	8395542	FAM86FP	11898	8393042	8398042
NR_024252	chr3	-	129816624	129830276	FAM86HP	13652	129827776	129832776
NR_024251	chr3	+	125635443	125648867	FAM86JP	13424	125632943	125637943
NR_103537	chr8	-	325930	333174	FAM87A	7244	330674	335674
NM_198552	chr1	-	231154703	231175995	FAM89A	21292	231173495	231178495
NM_016255	chr6	+	17600517	17611950	FAM8A1	11433	17598017	17603017
NM_018088	chr12	-	8373855	8380214	FAM90A1	6359	8377714	8382714
NR_073395	chr8	-	12272029	12275541	FAM90A25P	3512	12273041	12278041
NR_046354	chr8	-	12030962	12034776	FAM90A2P	3814	12032276	12037276
NR_046343	chr8	-	7421309	7431920	FAM90A7P	10611	7429420	7434420
NM_144963	chr8	+	124780678	124827690	FAM91A1	47012	124778178	124783178
NM_001283034	chr8	+	94712734	94741478	FAM92A	28744	94710234	94715234
NM_198491	chr16	-	85131957	85146114	FAM92B	14157	85143614	85148614
NR_038409	chr2	-	95421070	95426929	FAM95A	5859	95424429	95429429
NR_026759	chr9	+	42468588	42474238	FAM95B1	5650	42466088	42471088
NR_047651	chr9	-	38540563	38545369	FAM95C	4806	38542869	38547869
NM_032231	chr15	-	64364757	64386207	FAM96A	21450	64383707	64388707
NM_001304538	chr2	-	33808727	33824429	FAM98A	15702	33821929	33826929
NM_173611	chr15	+	38746327	38779911	FAM98B	33584	38743827	38748827
NM_174905	chr19	+	38893774	38899728	FAM98C	5954	38891274	38896274
NM_174951	chrX	-	8758836	8769424	FAM9A	10588	8766924	8771924
NM_205849	chrX	-	8992272	9002168	FAM9B	9896	8999668	9004668
NM_174901	chrX	-	13053735	13062917	FAM9C	9182	13060417	13065417
NM_014967	chr15	+	31196075	31235310	FAN1	39235	31193575	31198575
NM_000135	chr16	-	89803956	89883066	FANCA	79110	89880566	89885566
NM_001324162	chrX	-	14861528	14891191	FANCB	29663	14888691	14893691
NM_000136	chr9	-	97861335	98079991	FANCC	218656	98077491	98082491
NM_001018115	chr3	+	10068070	10143621	FANCD2	75551	10065570	10070570
NM_173472	chr3	-	10123003	10149915	FANCD2OS	26912	10147415	10152415
NM_021922	chr6	+	35420137	35434881	FANCE	14744	35417637	35422637
NM_022725	chr11	-	22644078	22647387	FANCF	3309	22644887	22649887
NM_004629	chr9	-	35073834	35080013	FANCG	6179	35077513	35082513
NM_018193	chr15	+	89787193	89860362	FANCI	73169	89784693	89789693
NM_001114636	chr2	-	58386377	58468515	FANCL	82138	58466015	58471015
NM_001308133	chr14	+	45605141	45670093	FANCM	64952	45602641	45607641
NM_001350939	chr10	+	127585103	127698161	FANK1	113058	127582603	127587603
NM_004460	chr2	-	163027193	163100067	FAP	72874	163097567	163102567
NM_032228	chr11	+	13690205	13753893	FAR1	63688	13687705	13692705
NM_001271783	chr12	+	29301935	29488549	FAR2	186614	29299435	29304435
NR_026758	chr2	-	130783571	130808704	FAR2P1	25133	130806204	130811204
NR_046258	chr2	-	131174325	131186119	FAR2P2	11794	131183619	131188619
NM_001286839	chr13	+	98794815	99102027	FARP1	307212	98792315	98797315
NM_014808	chr2	+	242295663	242434257	FARP2	138594	242293163	242298163
NM_001318872	chr6	+	5261250	5771825	FARS2	510575	5258750	5263750
NM_004461	chr19	-	13033283	13044558	FARSA	11275	13042058	13047058
NR_130154	chr2	-	223436161	223521074	FARSB	84913	223518574	223523574
NR_135313	chr10	+	90750315	90776818	FAS	26503	90747815	90752815
NM_000639	chr1	+	172628147	172636012	FASLG	7865	172625647	172630647
NM_004104	chr17	-	80036213	80056106	FASN	19893	80053606	80058606
NM_033015	chr7	-	150773707	150777970	FASTK	4263	150775470	150780470
NM_024622	chr2	-	170385017	170430431	FASTKD1	45414	170427931	170432931
NM_014929	chr2	+	207630111	207660911	FASTKD2	30800	207627611	207632611
NR_073608	chr5	-	7859271	7869150	FASTKD3	9879	7866650	7871650
NM_021826	chr20	-	3127164	3140532	FASTKD5	13368	3138032	3143032
NM_005245	chr4	-	187508936	187644987	FAT1	136051	187642487	187647487
NM_001447	chr5	-	150883652	150948505	FAT2	64853	150946005	150951005
NM_001008781	chr11	+	92085261	92629635	FAT3	544374	92082761	92087761
NM_001291285	chr4	+	126237566	126414087	FAT4	176521	126235066	126240066
NM_033085	chrX	+	150884507	150891664	FATE1	7157	150882007	150887007
NR_144463	chr6	-	99719036	99798186	FAXC	79150	99795686	99800686
NM_032385	chr5	-	154198051	154230245	FAXDC2	32194	154227745	154232745
NM_001319193	chr17	-	73905654	73934313	FBF1	28659	73931813	73936813
NM_001436	chr19	-	40325092	40337054	FBL	11962	40334554	40339554
NM_001350151	chr1	+	16083153	16113089	FBLIM1	29936	16080653	16085653
NM_006486	chr22	+	45898718	45997014	FBLN1	98296	45896218	45901218
NM_001998	chr3	+	13590624	13679922	FBLN2	89298	13588124	13593124
NM_006329	chr14	-	92335754	92414046	FBLN5	78292	92411546	92416546
NM_153214	chr2	+	112895961	112945791	FBLN7	49830	112893461	112898461
NM_000138	chr15	-	48700502	48937985	FBN1	237483	48935485	48940485
NM_001999	chr5	-	127593600	127873735	FBN2	280135	127871235	127876235
NM_032447	chr19	-	8130285	8214730	FBN3	84445	8212230	8217230
NM_001127628	chr9	-	97365420	97402531	FBP1	37111	97400031	97405031
NM_003837	chr9	-	97320995	97356114	FBP2	35119	97353614	97358614
NM_001105079	chr16	+	30670839	30682131	FBRS	11292	30668339	30673339
NM_001142641	chr12	+	133067156	133161773	FBRSL1	94617	133064656	133069656
NM_001316936	chr19	-	9920942	9929779	FBXL12	8837	9927279	9932279
NR_105043	chr7	-	102453307	102715288	FBXL13	261981	102712788	102717788
NM_152441	chr12	-	1675158	1703331	FBXL14	28173	1700831	1705831
NM_024326	chr10	+	104179570	104182893	FBXL15	3323	104177070	104182070
NM_153350	chr16	-	742499	755825	FBXL16	13326	753325	758325
NM_001163315	chr5	-	107194733	107717799	FBXL17	523066	107715299	107720299
NM_024963	chr7	-	5515427	5553429	FBXL18	38002	5550929	5555929
NM_001282351	chr16	+	30934375	30960104	FBXL19	25729	30931875	30936875
NR_024348	chr16	-	30930639	30934590	FBXL19-AS1	3951	30932090	30937090
NR_146123	chr3	+	33318907	33464190	FBXL2	145283	33316407	33321407
NM_001184906	chr17	-	37408896	37557909	FBXL20	149013	37555409	37560409
NM_012159	chr5	+	135266005	135277367	FBXL21	11362	135263505	135268505
NM_203373	chr15	+	63889551	63894620	FBXL22	5069	63887051	63892051
NM_012158	chr13	-	77579388	77601331	FBXL3	21943	77598831	77603831
NM_001278716	chr6	-	99321600	99395882	FBXL4	74282	99393382	99398382
NR_036464	chr4	-	15606006	15657035	FBXL5	51029	15654535	15659535
NM_024555	chr8	-	145579087	145582183	FBXL6	3096	145579683	145584683
NM_012304	chr5	+	15500304	15939905	FBXL7	439601	15497804	15502804
NM_018378	chr16	+	67193890	67198077	FBXL8	4187	67191390	67196390
NM_012166	chr9	-	37510888	37576250	FBXO10	65362	37573750	37578750
NM_001190274	chr2	-	48034058	48132932	FBXO11	98874	48130432	48135432
NM_001142958	chr18	-	71740587	71815100	FBXO15	74513	71812600	71817600
NM_001258211	chr8	-	28285925	28347835	FBXO16	61910	28345335	28350335
NR_104026	chr19	-	39432040	39466453	FBXO17	34413	39463953	39468953
NM_001258452	chr10	+	5931534	5979558	FBXO18	48024	5929034	5934034
NM_012168	chr1	-	11708417	11714888	FBXO2	6471	11712388	11717388
NM_015002	chr12	-	117581584	117628300	FBXO21	46716	117625800	117630800
NR_037623	chr15	+	76196199	76227608	FBXO22	31409	76193699	76198699
NM_033506	chr7	+	100183955	100198740	FBXO24	14785	100181455	100186455
NM_183421	chr8	+	356807	419875	FBXO25	63068	354307	359307
NM_178820	chr19	-	39514662	39523236	FBXO27	8574	39520736	39525736
NR_049764	chr1	+	224301788	224349749	FBXO28	47961	224299288	224304288
NM_012175	chr11	-	33762489	33796071	FBXO3	33582	33793571	33798571
NM_032145	chr6	-	146119271	146135921	FBXO30	16650	146133421	146138421
NM_001282683	chr16	-	87360592	87425713	FBXO31	65121	87423213	87428213
NM_001242463	chr8	-	124510126	124553493	FBXO32	43367	124550993	124555993
NM_203301	chr14	-	39865576	39901704	FBXO33	36128	39899204	39904204
NM_017943	chr14	+	55738020	55820329	FBXO34	82309	55735520	55740520
NM_174899	chr2	+	230787206	230877825	FBXO36	90619	230784706	230789706
NM_030793	chr5	+	147763497	147822399	FBXO38	58902	147760997	147765997
NM_153230	chr17	+	6679551	6690965	FBXO39	11414	6677051	6682051
NM_001297437	chr5	+	41925353	41941672	FBXO4	16319	41922853	41927853
NM_016298	chr3	+	121312169	121349139	FBXO40	36970	121309669	121314669
NM_001080410	chr2	-	73481809	73496758	FBXO41	14949	73494258	73499258
NM_018994	chr1	-	16573334	16678986	FBXO42	105652	16676486	16681486
NR_036491	chr8	-	101145587	101158099	FBXO43	12512	101155599	101160599
NM_001304791	chr1	+	11714431	11723384	FBXO44	8953	11711931	11716931
NM_001105573	chr3	+	196295724	196315930	FBXO45	20206	196293224	196298224
NM_001329633	chr19	-	46213886	46236429	FBXO46	22543	46233929	46238929
NM_001008777	chr17	-	37092684	37123655	FBXO47	30971	37121155	37126155
NM_001024680	chr2	-	68689504	68694449	FBXO48	4945	68691949	68696949
NM_001142522	chr6	-	153291653	153304754	FBXO5	13101	153302254	153307254
NM_018438	chr1	+	11724149	11734409	FBXO6	10260	11721649	11726649
NM_012179	chr22	+	32870706	32894818	FBXO7	24112	32868206	32873206
NM_012180	chr4	-	175157809	175205402	FBXO8	47593	175202902	175207902
NM_033481	chr6	+	52929795	52965670	FBXO9	35875	52927295	52932295
NR_051988	chr17	+	18647325	18682662	FBXW10	35337	18644825	18649825
NM_012300	chr5	-	171288555	171433877	FBXW11	145322	171431377	171436377
NM_001159927	chr3	+	48413708	48436190	FBXW12	22482	48411208	48416208
NM_012164	chr9	-	123519253	123555740	FBXW2	36487	123553240	123558240
NM_001323541	chr10	-	103370420	103455052	FBXW4	84632	103452552	103457552
NM_018998	chr9	-	139834884	139839206	FBXW5	4322	139836706	139841706
NM_001349798	chr4	-	153242409	153457247	FBXW7	214838	153454747	153459747
NM_153348	chr12	+	117348760	117468953	FBXW8	120193	117346260	117351260
NM_032301	chr19	-	12799729	12807455	FBXW9	7726	12804955	12809955
NM_001170631	chr1	-	207131311	207143970	FCAMR	12659	207141470	207146470
NM_133269	chr19	+	55385548	55402786	FCAR	17238	55383048	55388048
NM_002001	chr1	+	159259503	159278014	FCER1A	18511	159257003	159262003
NM_004106	chr1	+	161185086	161189038	FCER1G	3952	161182586	161187586
NM_001220500	chr19	-	7753642	7767032	FCER2	13390	7764532	7769532
NM_015962	chr14	+	75179849	75203390	FCF1	23541	75177349	75182349
NM_003890	chr19	-	40353962	40440533	FCGBP	86571	40438033	40443033
NM_000566	chr1	+	149754249	149764074	FCGR1A	9825	149751749	149756749
NR_045213	chr1	-	120926127	120935944	FCGR1B	9817	120933444	120938444
NR_027484	chr1	+	149369293	149378303	FCGR1CP	9010	149366793	149371793
NM_001136219	chr1	+	161475204	161489360	FCGR2A	14156	161472704	161477704
NM_001002274	chr1	+	161632904	161648444	FCGR2B	15540	161630404	161635404
NM_201563	chr1	+	161551128	161571010	FCGR2C	19882	161548628	161553628
NM_001329120	chr1	-	161511549	161520527	FCGR3A	8978	161518027	161523027
NM_000570	chr1	-	161592987	161601753	FCGR3B	8766	161599253	161604253
NM_001136019	chr19	+	50015535	50029685	FCGRT	14150	50013035	50018035
NM_001161357	chr19	+	17858526	17899377	FCHO1	40851	17856026	17861026
NM_138782	chr5	+	72251807	72386349	FCHO2	134542	72249307	72254307
NM_033449	chr5	-	141018868	141030986	FCHSD1	12118	141028486	141033486
NM_014824	chr11	-	72547789	72853143	FCHSD2	305354	72850643	72855643
NM_001142473	chr1	-	207076630	207095378	FCMR	18748	207092878	207097878
NM_002003	chr9	-	137795081	137809849	FCN1	14768	137807349	137812349
NM_004108	chr9	+	137772657	137779366	FCN2	6709	137770157	137775157
NM_173452	chr1	-	27695600	27701343	FCN3	5743	27698843	27703843
NM_052938	chr1	-	157764193	157789940	FCRL1	25747	157787440	157792440
NM_001159488	chr1	-	157715522	157746922	FCRL2	31400	157744422	157749422
NM_001320333	chr1	-	157646270	157670662	FCRL3	24392	157668162	157673162
NM_031282	chr1	-	157543538	157567870	FCRL4	24332	157565370	157570370
NM_031281	chr1	-	157483166	157522310	FCRL5	39144	157519810	157524810
NM_001284217	chr1	+	159770300	159786047	FCRL6	15747	159767800	159772800
NM_001184872	chr1	+	161676761	161684142	FCRLA	7381	161674261	161679261
NM_001002901	chr1	+	161691333	161697933	FCRLB	6600	161688833	161693833
NM_152997	chr4	+	71091787	71100968	FDCSP	9181	71089287	71094287
NM_001287743	chr8	+	11653081	11696818	FDFT1	43737	11650581	11655581
NM_001135822	chr1	+	155278538	155290457	FDPS	11919	155276038	155281038
NR_003262	chr7	-	76099336	76104317	FDPSP2	4981	76101817	76106817
NM_004109	chr11	+	110300660	110335608	FDX1	34948	110298160	110303160
NM_001031734	chr19	-	10420886	10426691	FDX1L	5805	10424191	10429191
NM_138378	chr11	-	111744779	111750181	FDXACB1	5402	111747681	111752681
NM_001258013	chr17	-	72858618	72869156	FDXR	10538	72866656	72871656
NM_000140	chr18	-	55212072	55253969	FECH	41897	55251469	55256469
NM_018708	chr19	+	4791727	4795571	FEM1A	3844	4789227	4794227
NM_015322	chr15	+	68570140	68588203	FEM1B	18063	68567640	68572640
NM_020177	chr5	-	114856607	114880591	FEM1C	23984	114878091	114883091
NM_004111	chr11	+	61560108	61564714	FEN1	4606	61557608	61562608
NR_033925	chr16	-	86508130	86542466	FENDRR	34336	86539966	86544966
NM_005246	chr5	+	108083522	108532541	FER	449019	108081022	108086022
NR_119376	chr20	-	34146506	34195484	FER1L4	48978	34192984	34197984
NM_001293083	chr2	+	97308473	97370622	FER1L5	62149	97305973	97310973
NM_001039112	chr8	+	124864226	125132302	FER1L6	268076	124861726	124866726
NR_040044	chr8	-	124996377	125053023	FER1L6-AS1	56646	125050523	125055523
NR_103547	chr8	-	125058311	125183763	FER1L6-AS2	125452	125181263	125186263
NM_017671	chr20	-	6055491	6104191	FERMT1	48700	6101691	6106691
NM_006832	chr14	-	53323988	53417815	FERMT2	93827	53415315	53420315
NM_031471	chr11	+	63974151	63991363	FERMT3	17212	63971651	63976651
NM_001143785	chr15	+	91427664	91439006	FES	11342	91425164	91430164
NM_001308079	chr3	+	186358148	186370797	FETUB	12649	186355648	186360648
NM_017521	chr2	-	219845808	219850379	FEV	4571	219847879	219852879
NM_005103	chr11	-	125315640	125366206	FEZ1	50566	125363706	125368706
NM_005102	chr2	-	36779403	36825332	FEZ2	45929	36822832	36827832
NM_001160264	chr7	-	121941362	121944565	FEZF1	3203	121942065	121947065
NR_036484	chr7	+	121943711	121950131	FEZF1-AS1	6420	121941211	121946211
NM_018008	chr3	-	62355346	62359190	FEZF2	3844	62356690	62361690
NM_001195755	chr10	+	95326421	95349829	FFAR4	23408	95323921	95328921
NM_000508	chr4	-	155504277	155511918	FGA	7641	155509418	155514418
NM_005141	chr4	+	155484131	155493915	FGB	9784	155481631	155486631
NM_004463	chrX	-	54471886	54522599	FGD1	50713	54520099	54525099
NM_173558	chr6	+	36973422	36996845	FGD2	23423	36970922	36975922
NM_001083536	chr9	+	95709600	95798518	FGD3	88918	95707100	95712100
NM_001304481	chr12	+	32638905	32798984	FGD4	160079	32636405	32641405
NM_001320276	chr3	+	14860468	14976072	FGD5	115604	14857968	14862968
NR_046251	chr3	-	14984285	14989948	FGD5-AS1	5663	14987448	14992448
NR_036481	chr3	+	13974552	13978444	FGD5P1	3892	13972052	13977052
NM_018351	chr12	-	95470524	95611240	FGD6	140716	95608740	95613740
NM_001257206	chr5	-	141971742	142077635	FGF1	105893	142075135	142080135
NM_004465	chr5	-	44305096	44388784	FGF10	83688	44386284	44391284
NR_108034	chr5	+	44388833	44414091	FGF10-AS1	25258	44386333	44391333
NR_130156	chr17	+	7341591	7348251	FGF11	6660	7339091	7344091
NM_004113	chr3	-	191857181	192445388	FGF12	588207	192442888	192447888
NR_046596	chr3	+	191956418	192000884	FGF12-AS1	44466	191953918	191958918
NM_001139498	chrX	-	137713733	138287185	FGF13	573452	138284685	138289685
NR_038405	chrX	+	137794268	137798763	FGF13-AS1	4495	137791768	137796768
NM_001321949	chr13	-	102373204	103054778	FGF14	681574	103052278	103057278
NR_125912	chr13	+	103019879	103026016	FGF14-AS1	6137	103017379	103022379
NR_036486	chr13	-	102944669	103046869	FGF14-IT1	102200	103044369	103049369
NM_003867	chr8	+	21900263	21906319	FGF17	6056	21897763	21902763
NM_003862	chr5	+	170846666	170884630	FGF18	37964	170844166	170849166
NM_005117	chr11	-	69513005	69519106	FGF19	6101	69516606	69521606
NM_002006	chr4	+	123747862	123819390	FGF2	71528	123745362	123750362
NM_019851	chr8	-	16850333	16859674	FGF20	9341	16857174	16862174
NM_019113	chr19	+	49258815	49261587	FGF21	2772	49256315	49261315
NM_001300812	chr19	+	639894	643703	FGF22	3809	637394	642394
NM_020638	chr12	-	4477392	4488894	FGF23	11502	4486394	4491394
NM_005247	chr11	-	69624735	69634192	FGF3	9457	69631692	69636692
NM_033143	chr4	+	81187741	81212171	FGF5	24430	81185241	81190241
NM_020996	chr12	-	4543307	4554780	FGF6	11473	4552280	4557280
NM_002009	chr15	+	49715374	49779523	FGF7	64149	49712874	49717874
NR_003670	chr9	-	41958801	42019584	FGF7P3	60783	42017084	42022084
NR_003674	chr9	+	46687556	46746820	FGF7P6	59264	46685056	46690056
NM_001206389	chr10	-	103529886	103540126	FGF8	10240	103537626	103542626
NM_002010	chr13	+	22245214	22278640	FGF9	33426	22242714	22247714
NM_005130	chr4	-	15937192	15940363	FGFBP1	3171	15937863	15942863
NM_031950	chr4	-	15961862	15964859	FGFBP2	2997	15962359	15967359
NM_152429	chr10	-	93666344	93669258	FGFBP3	2914	93666758	93671758
NM_015850	chr8	-	38268655	38326352	FGFR1	57697	38323852	38328852
NM_001278690	chr6	+	167412804	167455906	FGFR1OP	43102	167410304	167415304
NM_001171887	chr12	+	27091304	27119581	FGFR1OP2	28277	27088804	27093804
NM_001320658	chr10	-	123237843	123357972	FGFR2	120129	123355472	123360472
NM_000142	chr4	+	1795038	1810599	FGFR3	15561	1792538	1797538
NM_002011	chr5	+	176513872	176525143	FGFR4	11271	176511372	176516372
NM_001004356	chr4	+	1005609	1020686	FGFRL1	15077	1003109	1008109
NM_000509	chr4	-	155525285	155533960	FGG	8675	155531460	155536460
NM_001350793	chr1	+	59762309	60228402	FGGY	466093	59759809	59764809
NM_004467	chr8	-	17721899	17753047	FGL1	31148	17750547	17755547
NM_006682	chr7	-	76822687	76829150	FGL2	6463	76826650	76831650
NM_005248	chr1	-	27938800	27961727	FGR	22927	27959227	27964227
NM_000143	chr1	-	241660856	241683085	FH	22229	241680585	241685585
NM_052929	chr1	+	15573767	15724622	FHAD1	150855	15571267	15576267
NM_033393	chr4	+	153864134	153900848	FHDC1	36714	153861634	153866634
NM_002012	chr3	-	59733003	61237135	FHIT	1504132	61234635	61239635
NR_027621	chrX	+	135228860	135293518	FHL1	64658	135226360	135231360
NM_201557	chr2	-	105977282	106055230	FHL2	77948	106052730	106057730
NM_004468	chr1	-	38462441	38471187	FHL3	8746	38468687	38473687
NM_020482	chr6	+	97010400	97066500	FHL5	56100	97007900	97012900
NM_001318202	chr16	-	67263291	67281425	FHOD1	18134	67278925	67283925
NM_001281739	chr18	+	33877658	34360183	FHOD3	482525	33875158	33880158
NM_001145106	chr9	-	133777824	133814455	FIBCD1	36631	133811955	133816955
NM_203371	chr11	+	27015627	27018632	FIBIN	3005	27013127	27018127
NM_004214	chr11	-	65651210	65656010	FIBP	4800	65653510	65658510
NM_007076	chr12	+	108909050	108913380	FICD	4330	108906550	108911550
NM_014845	chr6	+	110012423	110146634	FIG4	134211	110009923	110014923
NM_001004311	chr2	-	71004441	71017775	FIGLA	13334	71015275	71020275
NM_018086	chr2	-	164461461	164592517	FIGN	131056	164590017	164595017
NM_001287495	chr7	-	50505017	50518104	FIGNL1	13087	50515604	50520604
NM_001013690	chr12	-	52211675	52225701	FIGNL2	14026	52223201	52228201
NM_001300866	chr6	-	76001573	76203630	FILIP1	202057	76201130	76206130
NM_182909	chr3	-	99551987	99833357	FILIP1L	281370	99830857	99835857
NM_030917	chr4	+	54243819	54326103	FIP1L1	82284	54241319	54246319
NR_026975	chrX	-	130836677	130964671	FIRRE	127994	130962171	130967171
NM_016068	chr7	-	100882892	100888371	FIS1	5479	100885871	100890871
NM_001080472	chr20	-	42931477	42939892	FITM2	8415	42937392	42942392
NM_032836	chr19	-	56102736	56110893	FIZ1	8157	56108393	56113393
NM_014344	chr11	+	35639734	35642421	FJX1	2687	35637234	35642234
NM_021939	chr17	+	39968961	39979469	FKBP10	10508	39966461	39971461
NM_016594	chr12	-	49315741	49319330	FKBP11	3589	49316830	49321830
NR_046479	chr7	-	30050198	30066417	FKBP14	16219	30063917	30068917
NM_015258	chr9	-	115927799	115983641	FKBP15	55842	115981141	115986141
NM_000801	chr20	-	1349620	1373816	FKBP1A	24196	1371316	1376316
NR_037661	chr20	-	1290554	1373816	FKBP1A-SDCBP2	83262	1371316	1376316
NR_136539	chr2	+	24272570	24286550	FKBP1B	13980	24270070	24275070
NM_004470	chr11	+	64008412	64011607	FKBP2	3195	64005912	64010912
NM_002013	chr14	-	45584801	45603732	FKBP3	18931	45601232	45606232
NM_002014	chr12	+	2904107	2914587	FKBP4	10480	2901607	2906607
NM_001145775	chr6	-	35541361	35696360	FKBP5	154999	35693860	35698860
NM_001135211	chr7	+	72742154	72772646	FKBP6	30492	72739654	72744654
NM_001135212	chr2	-	179328390	179343355	FKBP7	14965	179340855	179345855
NM_012181	chr19	-	18642561	18654406	FKBP8	11845	18651906	18656906
NM_007270	chr7	+	32997015	33046543	FKBP9	49528	32994515	32999515
NR_003949	chr7	-	55748766	55772260	FKBP9P1	23494	55769760	55774760
NM_024301	chr19	+	47249302	47261832	FKRP	12530	47246802	47251802
NM_001198963	chr9	+	108320410	108403399	FKTN	82989	108317910	108322910
NM_001184891	chr1	+	154955769	154965587	FLAD1	9818	154953269	154958269
NM_001353229	chr17	-	17115526	17140505	FLCN	24979	17138005	17143005
NM_002016	chr1	-	152274650	152297679	FLG	23029	152295179	152300179
NR_103778	chr1	+	152285934	152339168	FLG-AS1	53234	152283434	152288434
NM_001014342	chr1	-	152321212	152332482	FLG2	11270	152329982	152334982
NM_001271012	chr11	+	128556429	128683162	FLI1	126733	128553929	128558929
NM_002018	chr17	-	18148130	18162230	FLII	14100	18159730	18164730
NR_026655	chr12	+	54452037	54516018	FLJ12825	63981	54449537	54454537
NR_024389	chr20	+	61885329	61892967	FLJ16779	7638	61882829	61887829
NR_037184	chr16	+	27279525	27301789	FLJ21408	22264	27277025	27282025
NR_039985	chr14	+	62037257	62121431	FLJ22447	84174	62034757	62039757
NR_033977	chr3	+	108855560	108868951	FLJ22763	13391	108853060	108858060
NR_026900	chr1	+	180167143	180169859	FLJ23867	2716	180164643	180169643
NR_033981	chr1	-	90090407	90098453	FLJ27354	8046	90095953	90100953
NR_147916	chr22	-	43593285	43597160	FLJ30901	3875	43594660	43599660
NR_102755	chr5	+	55290994	55299475	FLJ31104	8481	55288494	55293494
NR_103831	chr2	-	28607275	28617539	FLJ31356	10264	28615039	28620039
NR_104643	chr5	-	42985500	42993435	FLJ32255	7935	42990935	42995935
NR_040080	chr2	-	11239976	11272302	FLJ33534	32326	11269802	11274802
NR_027060	chr6	+	114225550	114242806	FLJ34503	17256	114223050	114228050
NR_027084	chr17	+	21904061	21913070	FLJ36000	9009	21901561	21906561
NR_033847	chr10	-	127393858	127408062	FLJ37035	14204	127405562	127410562
NR_026835	chr10	-	91451056	91457685	FLJ37201	6629	91455185	91460185
NR_024279	chr1	-	16160709	16174642	FLJ37453	13933	16172142	16177142
NR_147502	chr1	+	247267812	247272863	FLJ39095	5051	247265312	247270312
NR_034161	chr17	+	47325604	47336027	FLJ40194	10423	47323104	47328104
NR_046323	chr7	+	132333552	132413528	FLJ40288	79976	132331052	132336052
NR_033863	chr9	-	13406378	13431328	FLJ41200	24950	13428828	13433828
NR_038862	chr11	-	71116791	71134400	FLJ42102	17609	71131900	71136900
NR_024492	chr16	+	2688982	2696130	FLJ42627	7148	2686482	2691482
NR_033962	chr8	+	102064281	102088479	FLJ42969	24198	102061781	102066781
NR_033856	chrUn_gl000211	+	48502	93165	FLJ43315	44663	46002	51002
NM_207422	chrX	+	71364033	71381600	FLJ44635	17567	71361533	71366533
NM_001242791	chr17	+	47923271	47926199	FLJ45513	2928	47920771	47925771
NR_046114	chr8	-	93725189	93798288	FLJ46284	73099	93795788	93800788
NR_147695	chr2	-	157193083	157198632	FLJ46875	5549	157196132	157201132
NR_033896	chr6	+	139012804	139018425	FLJ46906	5621	139010304	139015304
NM_001456	chrX	-	153576899	153603006	FLNA	26107	153600506	153605506
NM_001164319	chr3	+	57994126	58157982	FLNB	163856	57991626	57996626
NR_135534	chr3	-	58148275	58156362	FLNB-AS1	8087	58153862	58158862
NM_001458	chr7	+	128470482	128499328	FLNC	28846	128467982	128472982
NM_005803	chr6_ssto_hap7	-	2027792	2042945	FLOT1	15153	2040445	2045445
NM_001330170	chr17	-	27206352	27224754	FLOT2	18402	27222254	27227254
NM_013280	chr11	+	63871361	63886645	FLRT1	15284	63868861	63873861
NM_001346144	chr14	+	85996368	86095040	FLRT2	98672	85993868	85998868
NM_013281	chr20	-	14304638	14318313	FLRT3	13675	14315813	14320813
NM_002019	chr13	-	28874482	29069265	FLT1	194783	29066765	29071765
NR_130706	chr13	-	28577410	28674729	FLT3	97319	28672229	28677229
NM_001278638	chr19	+	49977465	49989488	FLT3LG	12023	49974965	49979965
NM_182925	chr5	-	180028505	180076624	FLT4	48119	180074124	180079124
NM_014053	chr1	+	213031596	213072705	FLVCR1	41109	213029096	213034096
NM_017791	chr14	+	76044939	76114512	FLVCR2	69573	76042439	76047439
NM_001308068	chr16	+	2961979	3001209	FLYWCH1	39230	2959479	2964479
NM_001142500	chr16	+	2933195	2949383	FLYWCH2	16188	2930695	2935695
NR_073060	chr7	+	139025195	139031065	FMC1	5870	139022695	139027695
NM_001277313	chr15	-	33057744	33486934	FMN1	429190	33484434	33489434
NM_020066	chr1	+	240255184	240638489	FMN2	383305	240252684	240257684
NM_005892	chr17	+	43299291	43324683	FMNL1	25392	43296791	43301791
NM_052905	chr2	+	153191750	153506348	FMNL2	314598	153189250	153194250
NM_198900	chr12	-	50031723	50101197	FMNL3	69474	50098697	50103697
NM_001282694	chr1	+	171217609	171255117	FMO1	37508	171215109	171220109
NM_001301347	chr1	+	171154346	171181822	FMO2	27476	171151846	171156846
NM_001319173	chr1	+	171060017	171086959	FMO3	26942	171057517	171062517
NM_002022	chr1	+	171283321	171311223	FMO4	27902	171280821	171285821
NM_001144829	chr1	-	146655883	146697230	FMO5	41347	146694730	146699730
NR_002601	chr1	+	171106878	171130702	FMO6P	23824	171104378	171109378
NR_002925	chr1	+	166573152	166594473	FMO9P	21321	166570652	166575652
NM_002023	chr1	-	203309748	203320557	FMOD	10809	203318057	203323057
NR_033699	chrX	+	146993468	147032647	FMR1	39179	146990968	146995968
NM_152578	chrX	+	147062848	147108187	FMR1NB	45339	147060348	147065348
NM_001306130	chr2	-	216225162	216300793	FN1	75631	216298293	216303293
NM_022158	chr17	+	80693451	80709073	FN3K	15622	80690951	80695951
NM_024619	chr17	+	80674581	80685893	FN3KRP	11312	80672081	80677081
NM_015033	chr9	-	132649465	132805473	FNBP1	156008	132802973	132807973
NM_017737	chr1	+	93913687	94020218	FNBP1L	106531	93911187	93916187
NM_001318339	chr11	-	47738045	47789030	FNBP4	50985	47786530	47791530
NM_032532	chr6	+	159590428	159693140	FNDC1	102712	159587928	159592928
NM_024059	chr20	+	62184372	62188060	FNDC11	3688	62181872	62186872
NM_001079673	chr13	+	49550047	49783915	FNDC3A	233868	49547547	49552547
NM_022763	chr3	+	171757417	172118492	FNDC3B	361075	171754917	171759917
NM_022823	chr2	-	27714749	27718126	FNDC4	3377	27715626	27720626
NM_001171941	chr1	-	33327868	33338093	FNDC5	10225	33335593	33340593
NM_001144937	chr1	+	109255555	109285367	FNDC7	29812	109253055	109258055
NM_017559	chr17	+	33448597	33457751	FNDC8	9154	33446097	33451097
NM_001001343	chr5	-	156768606	156772729	FNDC9	4123	156770229	156775229
NM_133372	chr5	-	130977406	131132756	FNIP1	155350	131130256	131135256
NM_001346043	chr4	+	159690146	159829202	FNIP2	139056	159687646	159692646
NR_033698	chr8	+	42911441	42940932	FNTA	29491	42908941	42913941
NM_002028	chr14	+	65453506	65529370	FNTB	75864	65451006	65456006
NM_017794	chr9	+	20658307	20995954	FOCAD	337647	20655807	20660807
NM_001014986	chr11	-	49166645	49230222	FOLH1	63577	49227722	49232722
NM_153696	chr11	+	89392464	89431886	FOLH1B	39422	89389964	89394964
NM_016725	chr11	+	71900601	71907367	FOLR1	6766	71898101	71903101
NM_000803	chr11	+	71927818	71932994	FOLR2	5176	71925318	71930318
NM_001318045	chr11	+	71846755	71850936	FOLR3	4181	71844255	71849255
NM_001304497	chr16	-	15959575	15982506	FOPNL	22931	15980006	15985006
NM_005252	chr14	+	75745480	75748937	FOS	3457	75742980	75747980
NM_006732	chr19	+	45971252	45978437	FOSB	7185	45968752	45973752
NM_001300857	chr11	-	65659606	65667997	FOSL1	8391	65665497	65670497
NM_005253	chr2	+	28615778	28637516	FOSL2	21738	28613278	28618278
NM_004496	chr14	-	38058756	38064325	FOXA1	5569	38061825	38066825
NM_153675	chr20	-	22561641	22566101	FOXA2	4460	22563601	22568601
NM_004497	chr19	+	46367517	46377055	FOXA3	9538	46365017	46370017
NM_001453	chr6	+	1610680	1614129	FOXC1	3449	1608180	1613180
NR_125795	chr16	-	86598750	86601367	FOXC2-AS1	2617	86598867	86603867
NM_004474	chr1	+	47901688	47906363	FOXD2	4675	47899188	47904188
NR_026878	chr1	-	47897806	47900313	FOXD2-AS1	2507	47897813	47902813
NR_121637	chr1	-	63786554	63790112	FOXD3-AS1	3558	63787612	63792612
NM_001126334	chr9	-	70175706	70178815	FOXD4L5	3109	70176315	70181315
NM_001085476	chr9	-	69199479	69202204	FOXD4L6	2725	69199704	69204704
NM_004473	chr9	+	100615536	100618997	FOXE1	3461	100613036	100618036
NM_001451	chr16	+	86544132	86548070	FOXF1	3938	86541632	86546632
NM_001452	chr6	+	1390068	1395832	FOXF2	5764	1387568	1392568
NM_005249	chr14	+	29236277	29239483	FOXG1	3206	29233777	29238777
NR_125758	chr14	-	29194447	29234525	FOXG1-AS1	40078	29232025	29237025
NM_003923	chr8	-	145699114	145701718	FOXH1	2604	145699218	145704218
NM_012188	chr5	+	169532916	169536729	FOXI1	3813	169530416	169535416
NM_207426	chr10	+	129535537	129539450	FOXI2	3913	129533037	129538037
NM_001135649	chr2	-	88747725	88752053	FOXI3	4328	88749553	88754553
NM_001454	chr17	-	74132414	74137380	FOXJ1	4966	74134880	74139880
NM_018416	chr12	+	8185358	8208118	FOXJ2	22760	8182858	8187858
NM_001198850	chr1	-	42642209	42801548	FOXJ3	159339	42799048	42804048
NM_001037165	chr7	+	4721929	4811074	FOXK1	89145	4719429	4724429
NM_004514	chr17	+	80477593	80562483	FOXK2	84890	80475093	80480093
NM_005250	chr16	+	86612114	86615304	FOXL1	3190	86609614	86614614
NM_023067	chr3	-	138663065	138665982	FOXL2	2917	138663482	138668482
NM_001040061	chr3	+	138666075	138672830	FOXL2NB	6755	138663575	138668575
NM_001243088	chr12	-	2966846	2986321	FOXM1	19475	2983821	2988821
NM_003593	chr17	+	26850958	26865175	FOXN1	14217	26848458	26853458
NM_002158	chr2	+	48541794	48606434	FOXN2	64640	48539294	48544294
NM_001085471	chr14	-	89622515	90085494	FOXN3	462979	90082994	90087994
NM_213596	chr12	-	109715782	109747025	FOXN4	31243	109744525	109749525
NM_002015	chr13	-	41129800	41240734	FOXO1	110934	41238234	41243234
NM_201559	chr6	+	108881025	109005971	FOXO3	124946	108878525	108883525
NR_026718	chr17	-	18569235	18576494	FOXO3B	7259	18573994	18578994
NM_005938	chrX	+	70315998	70323384	FOXO4	7386	70313498	70318498
NM_001291281	chr1	+	41827602	41849263	FOXO6	21661	41825102	41830102
NM_001244810	chr3	-	71003864	71633140	FOXP1	629276	71630640	71635640
NR_126463	chr3	+	71338908	71355005	FOXP1-AS1	16097	71336408	71341408
NR_033766	chr7	+	113726364	114333827	FOXP2	607463	113723864	113728864
NM_014009	chrX	-	49106896	49121288	FOXP3	14392	49118788	49123788
NM_138457	chr6	+	41514163	41570122	FOXP4	55959	41511663	41516663
NR_126415	chr6	-	41491632	41516359	FOXP4-AS1	24727	41513859	41518859
NM_181721	chr11	+	118842416	118851995	FOXR1	9579	118839916	118844916
NM_198451	chrX	+	55649832	55652621	FOXR2	2789	55647332	55652332
NR_037647	chr11	+	126138934	126148027	FOXRED1	9093	126136434	126141434
NM_001102371	chr22	-	36883232	36903148	FOXRED2	19916	36900648	36905648
NM_001288803	chr9	+	130565136	130576360	FPGS	11224	130562636	130567636
NM_001199329	chr1	+	74663895	74674386	FPGT	10491	74661395	74666395
NM_001112808	chr1	+	74663895	75010116	FPGT-TNNI3K	346221	74661395	74666395
NM_001193306	chr19	-	52249022	52255150	FPR1	6128	52252650	52257650
NM_001005738	chr19	+	52264452	52273779	FPR2	9327	52261952	52266952
NM_002030	chr19	+	52298398	52329443	FPR3	31045	52295898	52300898
NM_001347714	chr10	-	95427639	95462716	FRA10AC1	35077	95460216	95465216
NM_025074	chr4	+	78978723	79465423	FRAS1	486700	78976223	78981223
NM_005479	chr10	+	99079021	99081672	FRAT1	2651	99076521	99081521
NM_144966	chr9	-	14734663	14910993	FREM1	176330	14908493	14913493
NM_207361	chr13	+	39261172	39461267	FREM2	200095	39258672	39263672
NR_146963	chr13	-	39395820	39401728	FREM2-AS1	5908	39399228	39404228
NM_001168235	chr4	-	144498560	144621828	FREM3	123268	144619328	144624328
NM_004477	chr4	+	190861973	190884359	FRG1	22386	190859473	190864473
NR_145491	chr20	+	29611839	29653908	FRG1BP	42069	29609339	29614339
NR_132315	chrUn_gl000241	-	14738	36767	FRG1CP	22029	34267	39267
NR_132316	chr20	+	29612047	29628331	FRG1DP	16284	29609547	29614547
NR_146067	chrUn_gl000219	-	73353	99632	FRG1EP	26279	97132	102132
NR_034006	chr9	+	68726540	68748376	FRG1HP	21836	68724040	68729040
NR_033907	chr9	-	68427783	68455368	FRG1JP	27585	68452868	68457868
NM_001286820	chr4	-	190945522	190948412	FRG2	2890	190945912	190950912
NM_001124759	chr3	+	75713341	75716368	FRG2C	3027	75710841	75715841
NR_026980	chr16	-	34711784	34714967	FRG2DP	3183	34712467	34717467
NR_037925	chr3	+	75713480	75716368	FRG2EP	2888	75710980	75715980
NR_135055	chr16	-	31574542	31579036	FRG2KP	4494	31576536	31581536
NM_002031	chr6	-	116262692	116381921	FRK	119229	116379421	116384421
NR_110312	chr6	-	168456463	168482237	FRMD1	25774	168479737	168484737
NM_001244959	chr9	-	85857904	86153348	FRMD3	295444	86150848	86155848
NM_018027	chr10	-	13685705	14372883	FRMD4A	687178	14370383	14375383
NM_015123	chr3	-	69217933	69435455	FRMD4B	217522	69432955	69437955
NM_032892	chr15	-	44162958	44487492	FRMD5	324534	44484992	44489992
NM_001042481	chr14	+	51955838	52197444	FRMD6	241606	51953338	51958338
NR_051990	chr14	-	51921229	52066670	FRMD6-AS2	145441	52064170	52069170
NM_001306193	chrX	-	131211013	131262048	FRMD7	51035	131259548	131264548
NM_031904	chr11	+	65154040	65180995	FRMD8	26955	65151540	65156540
NM_014907	chr9	+	37651051	37746901	FRMPD1	95850	37648551	37653551
NM_001018071	chr10	-	49364601	49482941	FRMPD2	118340	49480441	49485441
NR_033172	chr10	-	46657134	46675788	FRMPD2B	18654	46673288	46678288
NM_032428	chrX	+	106765679	106848481	FRMPD3	82802	106763179	106768179
NR_046750	chrX	-	106756212	106789051	FRMPD3-AS1	32839	106786551	106791551
NM_014728	chrX	+	12156584	12742642	FRMPD4	586058	12154084	12159084
NM_001013660	chr1	-	100174258	100231349	FRRS1	57091	100228849	100233849
NM_014334	chr9	-	111892572	111929571	FRRS1L	36999	111927071	111932071
NM_001278354	chr12	+	69864128	69973571	FRS2	109443	69861628	69866628
NM_006653	chr6	-	41737913	41747643	FRS3	9730	41745143	41750143
NM_023037	chr13	+	32605436	32870776	FRY	265340	32602936	32607936
NR_103839	chr13	-	32598195	32605776	FRY-AS1	7581	32603276	32608276
NM_015030	chr4	-	48499379	48782316	FRYL	282937	48779816	48784816
NM_001463	chr2	-	183698004	183731498	FRZB	33494	183728998	183733998
NM_001256141	chr8	-	95439939	95449180	FSBP	9241	95446680	95451680
NM_032135	chr14	-	44973353	44976499	FSCB	3146	44973999	44978999
NM_003088	chr7	+	5632435	5646287	FSCN1	13852	5629935	5634935
NM_012418	chr17	+	79495416	79504156	FSCN2	8740	79492916	79497916
NM_020369	chr7	+	127233688	127241851	FSCN3	8163	127231188	127236188
NM_024333	chr19	+	4304590	4323843	FSD1	19253	4302090	4307090
NM_001330739	chr9	+	108210314	108314714	FSD1L	104400	108207814	108212814
NM_001281805	chr15	-	83424116	83474822	FSD2	50706	83472322	83477322
NM_000510	chr11	+	30252562	30256824	FSHB	4262	30250062	30255062
NM_000145	chr2	-	49189295	49381666	FSHR	192371	49379166	49384166
NM_001324338	chr15	-	39892231	40075039	FSIP1	182808	40072539	40077539
NM_173651	chr2	+	186603621	186698016	FSIP2	94395	186601121	186606121
NR_144453	chr2	-	186648417	186664877	FSIP2-AS1	16460	186662377	186667377
NM_006350	chr5	+	52776263	52782304	FST	6041	52773763	52778763
NM_007085	chr3	-	120113060	120169918	FSTL1	56858	120167418	120172418
NM_005860	chr19	+	676388	683392	FSTL3	7004	673888	678888
NM_015082	chr5	-	132532151	132948223	FSTL4	416072	132945723	132950723
NM_020116	chr4	-	162305043	163085186	FSTL5	780143	163082686	163087686
NM_001320412	chr21	-	47556175	47575481	FTCD	19306	47572981	47577981
NM_001350854	chr2	-	200625258	200715896	FTCDNL1	90638	200713396	200718396
NM_002032	chr11	-	61731756	61735132	FTH1	3376	61732632	61737632
NR_015446	chr4	+	69048009	69078188	FTLP10	30179	69045509	69050509
NM_001080432	chr16	+	53737874	54148379	FTO	410505	53735374	53740374
NM_001282157	chrX	+	48334408	48344752	FTSJ1	10344	48331908	48336908
NM_017647	chr17	-	61896792	61905031	FTSJ3	8239	61902531	61907531
NR_028379	chrX	-	73247970	73513409	FTX	265439	73510909	73515909
NR_146540	chr1	-	78409735	78444889	FUBP1	35154	78442389	78447389
NM_003934	chr9	+	133454959	133513739	FUBP3	58780	133452459	133457459
NM_000147	chr1	-	24171571	24194859	FUCA1	23288	24192359	24197359
NM_032020	chr6	-	143815948	143833020	FUCA2	17072	143830520	143835520
NM_145059	chr16	+	70488497	70514177	FUK	25680	70485997	70490997
NM_173794	chrX	-	44382884	44402221	FUNDC1	19337	44399721	44404721
NM_023934	chrX	+	154255063	154285191	FUNDC2	30128	154252563	154257563
NM_198472	chr10	-	135168657	135171529	FUOM	2872	135169029	135174029
NM_002569	chr15	+	91411821	91426688	FURIN	14867	91409321	91414321
NM_001170634	chr16	+	31191430	31206192	FUS	14762	31188930	31193930
NM_000148	chr19	-	49251267	49258647	FUT1	7380	49256147	49261147
NM_032664	chr8	-	33228343	33330664	FUT10	102321	33328164	33333164
NM_173540	chr10	+	75532048	75535976	FUT11	3928	75529548	75534548
NM_001097638	chr19	+	49199227	49209191	FUT2	9964	49196727	49201727
NM_000149	chr19	-	5842898	5851485	FUT3	8587	5848985	5853985
NM_002033	chr11	+	94277016	94283064	FUT4	6048	94274516	94279516
NM_002034	chr19	-	5865836	5870551	FUT5	4715	5868051	5873051
NM_000150	chr19	-	5830636	5839742	FUT6	9106	5837242	5842242
NM_004479	chr9	-	139924625	139927292	FUT7	2667	139924792	139929792
NM_178156	chr14	+	65877309	66210839	FUT8	333530	65874809	65879809
NM_006581	chr6	+	96463844	96663488	FUT9	199644	96461344	96466344
NM_001352262	chr19	-	50310122	50316567	FUZ	6445	50314067	50319067
NM_001161706	chr9	+	71650478	71715094	FXN	64616	71647978	71652978
NM_005087	chr3	+	180630233	180700539	FXR1	70306	180627733	180632733
NM_004860	chr17	-	7494547	7518215	FXR2	23668	7515715	7520715
NM_021902	chr19	+	35629692	35633959	FXYD1	4267	35627192	35632192
NM_021603	chr11	-	117690789	117698807	FXYD2	8018	117696307	117701307
NM_001136012	chr19	+	35606731	35615228	FXYD3	8497	35604231	35609231
NM_001184963	chr10	+	43867091	43871783	FXYD4	4692	43864591	43869591
NM_001320913	chr19	+	35645624	35660788	FXYD5	15164	35643124	35648124
NM_001164831	chr11	-	117707690	117748201	FXYD6	40511	117745701	117750701
NM_001243598	chr11	-	117690789	117747746	FXYD6-FXYD2	56957	117745246	117750246
NM_022006	chr19	+	35634153	35645205	FXYD7	11052	35631653	35636653
NM_001243093	chr5	-	39105353	39270759	FYB1	165406	39268259	39273259
NM_001004303	chr1	-	57184476	57285369	FYB2	100893	57282869	57287869
NM_024513	chr3	-	45959390	46037316	FYCO1	77926	46034816	46039816
NM_002037	chr6	-	111981534	112194655	FYN	213121	112192155	112197155
NM_001011537	chr3	+	197476423	197511317	FYTTD1	34894	197473923	197478923
NM_003505	chr7	+	90893782	90898132	FZD1	4350	90891282	90896282
NM_007197	chr12	+	130647003	130650285	FZD10	3282	130644503	130649503
NR_033834	chr12	-	130636137	130646223	FZD10-AS1	10086	130643723	130648723
NM_001466	chr17	+	42634811	42638630	FZD2	3819	42632311	42637311
NM_017412	chr8	+	28351721	28431785	FZD3	80064	28349221	28354221
NM_012193	chr11	-	86656716	86666440	FZD4	9724	86663940	86668940
NM_003468	chr2	-	208627309	208634143	FZD5	6834	208631643	208636643
NM_001164615	chr8	+	104310660	104345094	FZD6	34434	104308160	104313160
NM_003507	chr2	+	202899309	202903160	FZD7	3851	202896809	202901809
NM_031866	chr10	-	35927176	35930362	FZD8	3186	35927862	35932862
NM_016263	chr19	+	3506294	3536755	FZR1	30461	3503794	3508794
NM_001308097	chr14	+	31028328	31089267	G2E3	60939	31025828	31030828
NM_005754	chr5	+	151151475	151184915	G3BP1	33440	151148975	151153975
NM_203505	chr4	-	76567952	76598667	G3BP2	30715	76596167	76601167
NM_000151	chr17	+	41052813	41066450	G6PC	13637	41050313	41055313
NM_021176	chr2	+	169757749	169766510	G6PC2	8761	169755249	169760249
NM_001319945	chr17	+	42148097	42153712	G6PC3	5615	42145597	42150597
NM_001042351	chrX	-	153759604	153775801	G6PD	16197	153773301	153778301
NM_001079804	chr17	+	78075324	78093681	GAA	18357	78072824	78077824
NM_207123	chr4	+	144257982	144395718	GAB1	137736	144255482	144260482
NM_080491	chr11	-	77926335	78128868	GAB2	202533	78126368	78131368
NR_104114	chrX	-	153903526	153979858	GAB3	76332	153977358	153982358
NM_001037814	chr22	-	17442826	17489112	GAB4	46286	17486612	17491612
NM_031412	chr12	+	10365488	10375724	GABARAPL1	10236	10362988	10367988
NM_007285	chr16	+	75600248	75611779	GABARAPL2	11531	75597748	75602748
NR_028287	chr15	-	90889762	90892679	GABARAPL3	2917	90890179	90895179
NM_001319053	chr6_cox_hap2	-	1088813	1119722	GABBR1	30909	1117222	1122222
NM_005458	chr9	-	101050363	101471479	GABBR2	421116	101468979	101473979
NM_001197297	chr21	+	27107257	27144771	GABPA	37514	27104757	27109757
NM_001320910	chr15	-	50569388	50647626	GABPB1	78238	50645126	50650126
NR_024490	chr15	+	50646370	50650503	GABPB1-AS1	4133	50643870	50648870
NR_026891	chr15	-	50641134	50647076	GABPB1-IT1	5942	50644576	50649576
NM_001323906	chr1	+	151043053	151098021	GABPB2	54968	151040553	151045553
NM_000806	chr5	+	161274196	161326965	GABRA1	52769	161271696	161276696
NM_001286827	chr4	-	46245564	46392085	GABRA2	146521	46389585	46394585
NM_000808	chrX	-	151335633	151619831	GABRA3	284198	151617331	151622331
NM_000809	chr4	-	46920916	46996424	GABRA4	75508	46993924	46998924
NM_000810	chr15	+	27111865	27194357	GABRA5	82492	27109365	27114365
NM_000811	chr5	+	161112657	161129598	GABRA6	16941	161110157	161115157
NM_000812	chr4	+	47033294	47428447	GABRB1	395153	47030794	47035794
NM_021911	chr5	-	160715435	160975130	GABRB2	259695	160972630	160977630
NM_021912	chr15	-	26788693	27018935	GABRB3	230242	27016435	27021435
NM_000815	chr1	+	1950767	1962192	GABRD	11425	1948267	1953267
NM_004961	chrX	-	151121595	151143151	GABRE	21556	151140651	151145651
NM_173536	chr4	-	46037786	46126082	GABRG1	88296	46123582	46128582
NM_198904	chr5	+	161494647	161582545	GABRG2	87898	161492147	161497147
NM_033223	chr15	+	27216428	27778373	GABRG3	561945	27213928	27218928
NR_120343	chr15	-	27402881	27406466	GABRG3-AS1	3585	27403966	27408966
NM_014211	chr5	+	170210722	170241050	GABRP	30328	170208222	170213222
NM_018558	chrX	+	151806636	151821825	GABRQ	15189	151804136	151809136
NM_001267582	chr6	-	89887222	89941007	GABRR1	53785	89938507	89943507
NM_002043	chr6	-	89964185	90025018	GABRR2	60833	90022518	90027518
NR_047685	chr3	-	97705526	97754148	GABRR3	48622	97751648	97756648
NR_126370	chr2	+	108370567	108438585	GACAT1	68018	108368067	108373067
NR_120598	chr18	-	8695853	8707619	GACAT2	11766	8705119	8710119
NR_126559	chr2	+	16190548	16225811	GACAT3	35263	16188048	16193048
NM_000817	chr2	+	171673199	171717659	GAD1	44460	171670699	171675699
NM_000818	chr10	+	26505235	26593491	GAD2	88256	26502735	26507735
NM_001924	chr1	+	68150859	68154021	GADD45A	3162	68148359	68153359
NM_052850	chr19	-	13064969	13068068	GADD45GIP1	3099	13065568	13070568
NM_207359	chr3	-	30767691	30936153	GADL1	168462	30933653	30938653
NR_102272	chrX	+	49363615	49373139	GAGE1	9524	49361115	49366115
NM_001098413	chrX	+	49160124	49176323	GAGE10	16199	49157624	49162624
NM_001127345	chrX	+	49296814	49304080	GAGE12B	7266	49294314	49299314
NM_001098408	chrX	+	49325444	49332811	GAGE12C	7367	49322944	49327944
NM_001127199	chrX	+	49325433	49332821	GAGE12D	7388	49322933	49327933
NM_001098418	chrX	+	49325444	49332811	GAGE12E	7367	49322944	49327944
NM_001098405	chrX	+	49325410	49332811	GAGE12F	7401	49322910	49327910
NM_001098409	chrX	+	49325444	49332811	GAGE12G	7367	49322944	49327944
NM_001098410	chrX	+	49296779	49304144	GAGE12H	7365	49294279	49299279
NM_001477	chrX	+	49325506	49332811	GAGE12I	7305	49323006	49328006
NM_001098406	chrX	+	49178508	49294588	GAGE12J	116080	49176008	49181008
NM_001098412	chrX	+	49188080	49294588	GAGE13	106508	49185580	49190580
NM_001127212	chrX	+	49197581	49313700	GAGE2A	116119	49195081	49200081
NM_001098411	chrX	+	49235707	49242997	GAGE2B	7290	49233207	49238207
NM_001472	chrX	+	49216647	49294598	GAGE2C	77951	49214147	49219147
NM_001098407	chrX	+	49197562	49223943	GAGE2D	26381	49195062	49200062
NM_001127200	chrX	+	49178515	49294598	GAGE2E	116083	49176015	49181015
NM_001474	chrX	+	49216648	49223939	GAGE4	7291	49214148	49219148
NM_001475	chrX	+	49216656	49223943	GAGE5	7287	49214156	49219156
NM_001476	chrX	+	49325479	49332807	GAGE6	7328	49322979	49327979
NM_021123	chrX	+	49216677	49223939	GAGE7	7262	49214177	49219177
NM_012196	chrX	+	49188103	49313700	GAGE8	125597	49185603	49190603
NM_001318134	chr4	-	843062	926178	GAK	83116	923678	928678
NM_015973	chr11	+	68451942	68458643	GAL	6701	68449442	68454442
NM_001318104	chr22	-	30950621	30970574	GAL3ST1	19953	30968074	30973074
NM_022134	chr2	+	242716239	242743702	GAL3ST2	27463	242713739	242718739
NM_033036	chr11	-	65808235	65816651	GAL3ST3	8416	65814151	65819151
NM_024637	chr7	-	99756864	99766373	GAL3ST4	9509	99763873	99768873
NM_001201402	chr14	-	88399357	88460009	GALC	60652	88457509	88462509
NM_001008216	chr1	-	24122088	24127294	GALE	5206	24124794	24129794
NM_000154	chr17	-	73754017	73761280	GALK1	7263	73758780	73763780
NM_001001556	chr15	+	49447955	49622002	GALK2	174047	49445455	49450455
NM_138801	chr2	+	38893051	38961909	GALM	68858	38890551	38895551
NM_001323544	chr16	-	88880141	88923378	GALNS	43237	88920878	88925878
NM_020474	chr18	+	33234532	33291798	GALNT1	57266	33232032	33237032
NM_198321	chr5	+	153570294	153800543	GALNT10	230249	153567794	153572794
NM_001304514	chr7	+	151722758	151819432	GALNT11	96674	151720258	151725258
NM_024642	chr9	+	101569980	101612363	GALNT12	42383	101567480	101572480
NM_052917	chr2	+	154728410	155310489	GALNT13	582079	154725910	154730910
NM_024572	chr2	-	31133330	31361592	GALNT14	228262	31359092	31364092
NM_001319051	chr3	+	16215828	16273499	GALNT15	57671	16213328	16218328
NM_001168368	chr14	+	69726680	69821190	GALNT16	94510	69724180	69729180
NM_022479	chr7	+	70597522	71178586	GALNT17	581064	70595022	70600022
NM_198516	chr11	-	11292420	11643561	GALNT18	351141	11641061	11646061
NM_001291866	chr1	+	230193535	230417876	GALNT2	224341	230191035	230196035
NM_004482	chr2	-	166604312	166650803	GALNT3	46491	166648303	166653303
NM_003774	chr12	-	89913189	89918583	GALNT4	5394	89916083	89921083
NM_014568	chr2	+	158114109	158175001	GALNT5	60892	158111609	158116609
NM_007210	chr12	-	51745832	51785200	GALNT6	39368	51782700	51787700
NM_017423	chr4	+	174089903	174245118	GALNT7	155215	174087403	174092403
NM_017417	chr12	+	4829751	4881892	GALNT8	52141	4827251	4832251
NM_001122636	chr12	-	132680916	132905905	GALNT9	224989	132903405	132908405
NR_033169	chr7	+	151653463	151717019	GALNTL5	63556	151650963	151655963
NM_001034845	chr4	+	172734574	173961558	GALNTL6	1226984	172732074	172737074
NM_001145546	chr19	+	56687388	56697144	GALP	9756	56684888	56689888
NM_001480	chr18	+	74962007	74982096	GALR1	20089	74959507	74964507
NM_003857	chr17	+	74070881	74073622	GALR2	2741	74068381	74073381
NM_000155	chr9	+	34646585	34650595	GALT	4010	34644085	34649085
NM_000156	chr19	-	1397024	1401569	GAMT	4545	1399069	1404069
NM_022041	chr16	+	81348570	81413803	GAN	65233	81346070	81351070
NM_001329225	chr11	-	62392297	62414198	GANAB	21901	62411698	62416698
NM_198141	chr15	+	42566365	42645864	GANC	79499	42563865	42568865
NM_001130064	chr3	+	115342150	115440334	GAP43	98184	115339650	115344650
NM_001289745	chr12	+	6643570	6647541	GAPDH	3971	6641070	6646070
NM_014364	chr19	+	36024313	36036221	GAPDHS	11908	36021813	36026813
NR_110429	chr18	+	3466247	3478976	GAPLINC	12729	3463747	3468747
NM_001304431	chr5	+	57787261	57792185	GAPT	4924	57784761	57789761
NM_001330777	chr9	+	128024072	128129486	GAPVD1	105414	128021572	128026572
NM_032993	chr4	+	110736665	110745893	GAR1	9228	110734165	110739165
NM_001242409	chr18	-	29843483	30050447	GAREM1	206964	30047947	30052947
NM_001168241	chr2	+	26395959	26412532	GAREM2	16573	26393459	26398459
NM_001286779	chr9	+	130025940	130155828	GARNL3	129888	130023440	130028440
NM_001316772	chr7	+	30634350	30673648	GARS	39298	30631850	30636850
NM_001136006	chr21	-	34876237	34915198	GART	38961	34912698	34917698
NM_002048	chr9	-	89559276	89562104	GAS1	2828	89559604	89564604
NR_049794	chr9	+	89563612	89616948	GAS1RR	53336	89561112	89566112
NM_001143830	chr11	+	22688159	22834547	GAS2	146388	22685659	22690659
NM_001278730	chr22	+	29702984	29708778	GAS2L1	5794	29700484	29705484
NR_002942	chr9	-	99837952	99844227	GAS2L1P2	6275	99841727	99846727
NM_139285	chr17	-	34071529	34079897	GAS2L2	8368	34077397	34082397
NM_174942	chr12	+	100967438	101022066	GAS2L3	54628	100964938	100969938
NR_002578	chr1	-	173833038	173837125	GAS5	4087	173834625	173839625
NM_000820	chr13	-	114523521	114567076	GAS6	43555	114564576	114569576
NR_044995	chr13	+	114518582	114545814	GAS6-AS1	27232	114516082	114521082
NR_044993	chr13	+	114567149	114569805	GAS6-AS2	2656	114564649	114569649
NM_201433	chr17	-	9813925	10101868	GAS7	287943	10099368	10104368
NM_001286209	chr16	+	90086036	90111379	GAS8	25343	90083536	90088536
NM_000805	chr17	+	39868577	39872221	GAST	3644	39866077	39871077
NM_002049	chrX	+	48644981	48652717	GATA1	7736	48642481	48647481
NM_032638	chr3	-	128198264	128212030	GATA2	13766	128209530	128214530
NR_125398	chr3	+	128208045	128222050	GATA2-AS1	14005	128205545	128210545
NM_002051	chr10	+	8096666	8117164	GATA3	20498	8094166	8099166
NR_024256	chr10	-	8092412	8095447	GATA3-AS1	3035	8092947	8097947
NM_001308094	chr8	+	11534427	11617511	GATA4	83084	11531927	11536927
NM_080473	chr20	-	61038552	61051026	GATA5	12474	61048526	61053526
NM_005257	chr18	+	19749397	19782491	GATA6	33094	19746897	19751897
NR_052016	chr7	+	92076761	92089381	GATAD1	12620	92074261	92079261
NM_017660	chr19	+	19496641	19619741	GATAD2A	123100	19494141	19499141
NM_020699	chr1	-	153777382	153895451	GATAD2B	118069	153892951	153897951
NM_004564	chr4	-	152591808	152682175	GATB	90367	152679675	152684675
NM_176818	chr12	+	120884240	120901556	GATC	17316	120881740	120886740
NM_001318818	chr11	-	767222	777502	GATD1	10280	775002	780002
NM_001321015	chr15	-	45653321	45694515	GATM	41194	45692015	45697015
NM_178831	chr7	-	99798277	99869855	GATS	71578	99867355	99872355
NM_001171811	chr1	-	155204238	155214653	GBA	10415	155212153	155217153
NM_001330660	chr9	-	35736858	35749233	GBA2	12375	35746733	35751733
NR_102356	chr4	+	22694536	22821195	GBA3	126659	22692036	22697036
NR_002188	chr1	-	155183615	155197325	GBAP1	13710	155194825	155199825
NM_000158	chr3	-	81538849	81810950	GBE1	272101	81808450	81813450
NM_001199378	chr10	+	104005254	104142656	GBF1	137402	104002754	104007754
NM_001288573	chr9	-	136028334	136039332	GBGT1	10998	136036832	136041832
NM_002053	chr1	-	89517986	89531043	GBP1	13057	89528543	89533543
NR_003133	chr1	+	89873237	89890493	GBP1P1	17256	89870737	89875737
NM_004120	chr1	-	89571815	89591842	GBP2	20027	89589342	89594342
NR_135007	chr1	-	89472359	89488549	GBP3	16190	89486049	89491049
NM_052941	chr1	-	89646830	89664633	GBP4	17803	89662133	89667133
NM_052942	chr1	-	89724633	89738544	GBP5	13911	89736044	89741044
NM_001320257	chr1	+	89829435	89853719	GBP6	24284	89826935	89831935
NM_207398	chr1	-	89597433	89641723	GBP7	44290	89639223	89644223
NM_001098834	chr7	-	150845675	150864635	GBX1	18960	150862135	150867135
NM_001301687	chr2	-	237073878	237076652	GBX2	2774	237074152	237079152
NM_001204306	chr4	-	72607410	72671237	GC	63827	72668737	72673737
NM_001330265	chr2	+	163175272	163219618	GCA	44346	163172772	163177772
NM_001171690	chr22	+	38203911	38213183	GCAT	9272	38201411	38206411
NM_024523	chr7	-	127220681	127225654	GCC1	4973	127223154	127228154
NR_028063	chr2	+	109065576	109125854	GCC2	60278	109063076	109068076
NR_135290	chr2	-	109123996	109150675	GCC2-AS1	26679	109148175	109153175
NM_013976	chr19	+	13001942	13010813	GCDH	8871	12999442	13004442
NM_003203	chr2	-	75889831	75938111	GCFC2	48280	75935611	75940611
NM_002054	chr2	-	162999378	163008914	GCG	9536	163006414	163011414
NM_000160	chr17	+	79762007	79771889	GCGR	9882	79759507	79764507
NM_000161	chr14	-	55308723	55369542	GCH1	60819	55367042	55372042
NM_005258	chr15	+	41056284	41059911	GCHFR	3627	41053784	41058784
NM_000162	chr7	-	44183869	44229022	GCK	45153	44226522	44231522
NM_001486	chr2	+	27719705	27746550	GCKR	26845	27717205	27722205
NM_001498	chr6	-	53362139	53409927	GCLC	47788	53407427	53412427
NM_002061	chr1	-	94350755	94375154	GCLM	24399	94372654	94377654
NM_003643	chr6	-	52991759	53013624	GCM1	21865	53011124	53016124
NM_004752	chr6	-	10873455	10882098	GCM2	8643	10879598	10884598
NM_006836	chr12	-	120565013	120632513	GCN1	67500	120630013	120635013
NM_052957	chrX	+	70797873	70833433	GCNA	35560	70795373	70800373
NM_001097634	chr9	+	79056581	79122332	GCNT1	65751	79054081	79059081
NM_145649	chr6	+	10521567	10629601	GCNT2	108034	10519067	10524067
NM_004751	chr15	+	59903981	59912210	GCNT3	8229	59901481	59906481
NM_016591	chr5	-	74323288	74326724	GCNT4	3436	74324224	74329224
NM_080615	chr20	-	55066547	55100981	GCNT7	34434	55098481	55103481
NM_001285900	chr15	+	57884101	58009755	GCOM1	125654	57881601	57886601
NM_152785	chr3	-	111839687	111852152	GCSAM	12465	111849652	111854652
NM_001281838	chr1	+	247670359	247740992	GCSAML	70633	247667859	247672859
NR_027309	chr1	-	247687980	247694106	GCSAML-AS1	6126	247691606	247696606
NR_033249	chr16	-	81115551	81129980	GCSH	14429	81127480	81132480
NM_001242507	chr9	+	74729510	74867140	GDA	137630	74727010	74732010
NR_046346	chr8	+	75262617	75279335	GDAP1	16718	75260117	75265117
NM_001256738	chr20	+	42875738	42909557	GDAP1L1	33819	42873238	42878238
NM_017686	chr1	-	118406106	118472302	GDAP2	66196	118469802	118474802
NR_136689	chr16	-	19513014	19533467	GDE1	20453	19530967	19535967
NM_001492	chr19	-	18979354	19006953	GDF1	27599	19004453	19009453
NM_004962	chr10	-	48425778	48439138	GDF10	13360	48436638	48441638
NM_005811	chr12	+	56137063	56147154	GDF11	10091	56134563	56139563
NM_004864	chr19	+	18496769	18499987	GDF15	3218	18494269	18499269
NM_016204	chr10	-	48411773	48416872	GDF2	5099	48414372	48419372
NM_020634	chr12	-	7842377	7848389	GDF3	6012	7845889	7850889
NM_001319138	chr20	-	34021144	34042568	GDF5	21424	34040068	34045068
NM_001001557	chr8	-	97154560	97173020	GDF6	18460	97170520	97175520
NM_182828	chr2	+	20866423	20879001	GDF7	12578	20863923	20868923
NM_001288825	chr5	-	132196873	132202576	GDF9	5703	132200076	132205076
NM_001493	chrX	+	153665258	153671814	GDI1	6556	153662758	153667758
NM_001494	chr10	-	5807185	5855512	GDI2	48327	5853012	5858012
NM_000514	chr5	-	37812778	37839782	GDNF	27004	37837282	37842282
NR_145476	chr5	+	37839985	37875900	GDNF-AS1	35915	37837485	37842485
NM_001165993	chr17	+	57297827	57353330	GDPD1	55503	57295327	57300327
NM_017711	chrX	+	69642880	69653241	GDPD2	10361	69640380	69645380
NM_024307	chr16	-	30116130	30124878	GDPD3	8748	30122378	30127378
NM_182833	chr11	-	76927602	77012711	GDPD4	85109	77010211	77015211
NM_001351168	chr11	-	75145684	75236618	GDPD5	90934	75234118	75239118
NM_001013657	chr15	+	90777486	90785312	GDPGP1	7826	90774986	90779986
NM_005261	chr8	-	95261484	95274547	GEM	13063	95272047	95277047
NM_003616	chr14	+	39583487	39606177	GEMIN2	22690	39580987	39585987
NM_015721	chr17	-	647660	655501	GEMIN4	7841	653001	658001
NM_001252156	chr5	-	154266975	154317776	GEMIN5	50801	154315276	154320276
NM_024775	chr2	+	39005326	39009106	GEMIN6	3780	39002826	39007826
NM_001007270	chr19	+	45582517	45594782	GEMIN7	12265	45580017	45585017
NM_017856	chrX	-	14024844	14048035	GEMIN8	23191	14045535	14050535
NM_182625	chr2	+	17935124	17967180	GEN1	32056	17932624	17937624
NM_015949	chr7	+	916190	936071	GET4	19881	913690	918690
NM_002055	chr17	-	42982993	42992920	GFAP	9927	42990420	42995420
NM_005262	chr16	+	2034149	2037750	GFER	3601	2031649	2036649
NM_005263	chr1	-	92940317	92952433	GFI1	12116	92949933	92954933
NM_004188	chr9	+	135820931	135867084	GFI1B	46153	135818431	135823431
NM_001308164	chr3	+	158362316	158410360	GFM1	48044	158359816	158364816
NM_032380	chr5	-	74017028	74063196	GFM2	46168	74060696	74065696
NM_018988	chr6	-	13363586	13487869	GFOD1	124283	13485369	13490369
NM_030819	chr16	-	67708435	67753273	GFOD2	44838	67750773	67755773
NM_001244710	chr2	-	69546900	69614386	GFPT1	67486	69611886	69616886
NM_005110	chr5	-	179727689	179780387	GFPT2	52698	179777887	179782887
NM_001145453	chr10	-	117816441	118033157	GFRA1	216716	118030657	118035657
NM_001495	chr8	-	21549529	21646346	GFRA2	96817	21643846	21648846
NM_001496	chr5	-	137588068	137610253	GFRA3	22185	137607753	137612753
NM_022139	chr20	-	3639938	3644046	GFRA4	4108	3641546	3646546
NM_207410	chr6	+	55192266	55267291	GFRAL	75025	55189766	55194766
NM_013365	chr22	+	38004480	38029571	GGA1	25091	38001980	38006980
NM_015044	chr16	-	23474862	23521815	GGA2	46953	23519315	23524315
NM_001172704	chr17	-	73232686	73258474	GGA3	25788	73255974	73260974
NM_001195087	chr13	-	101182417	101241046	GGACT	58629	101238546	101243546
NM_001199815	chr7	-	30536236	30544457	GGCT	8221	30541957	30546957
NM_001142269	chr2	-	85771842	85788657	GGCX	16815	85786157	85791157
NM_003878	chr8	-	63927638	63951610	GGH	23972	63949110	63954110
NM_152657	chr19	-	38874991	38878668	GGN	3677	38876168	38881168
NR_028361	chr6	+	33551475	33556803	GGNBP1	5328	33548975	33553975
NM_024835	chr17	+	34900736	34946276	GGNBP2	45540	34898236	34903236
NM_001037277	chr1	+	235491752	235507844	GGPS1	16092	235489252	235494252
NM_013430	chr22	+	24979717	25024972	GGT1	45255	24977217	24982217
NM_001351304	chr22	-	21562261	21632151	GGT2	69890	21629651	21634651
NR_003267	chr22	-	18761201	18779474	GGT3P	18273	18776974	18781974
NM_004121	chr22	-	24615621	24641110	GGT5	25489	24638610	24643610
NM_001122890	chr17	-	4460221	4463891	GGT6	3670	4461391	4466391
NM_178026	chr20	-	33432522	33460661	GGT7	28139	33458161	33463161
NR_003503	chr2	+	91963367	91970153	GGT8P	6786	91960867	91965867
NR_003191	chr9	-	124217318	124262306	GGTA1P	44988	124259806	124264806
NM_178311	chr20	-	23965689	23969416	GGTLC1	3727	23966916	23971916
NM_001282879	chr22	+	22987090	22990368	GGTLC2	3278	22984590	22989590
NM_001142623	chr17	-	40341104	40346550	GHDC	5446	40344050	40349050
NM_014394	chr10	+	85899184	85913311	GHITM	14127	85896684	85901684
NM_000163	chr5	+	42423876	42721980	GHR	298104	42421376	42426376
NM_021081	chr20	-	35879489	35885311	GHRH	5822	35882811	35887811
NM_000823	chr7	+	31003635	31019146	GHRHR	15511	31001135	31006135
NM_001134944	chr3	-	10327433	10334631	GHRL	7198	10332131	10337131
NR_004431	chr3	+	10322635	10335133	GHRLOS	12498	10320135	10325135
NM_198407	chr3	-	172161080	172166246	GHSR	5166	172163746	172168746
NM_024052	chr17	+	17942610	17971718	GID4	29108	17940110	17945110
NM_017896	chr20	+	61569440	61579827	GID8	10387	61566940	61571940
NM_005142	chr11	-	59596745	59612974	GIF	16229	59610474	59615474
NM_022574	chr7	-	100277128	100287071	GIGYF1	9943	100284571	100289571
NM_015575	chr2	+	233562014	233725289	GIGYF2	163275	233559514	233564514
NM_130759	chr7	+	150413644	150421368	GIMAP1	7724	150411144	150416144
NM_001303630	chr7	+	150413644	150440737	GIMAP1-GIMAP5	27093	150411144	150416144
NM_015660	chr7	+	150382793	150390728	GIMAP2	7935	150380293	150385293
NM_018326	chr7	+	150264457	150271041	GIMAP4	6584	150261957	150266957
NM_018384	chr7	+	150434435	150440737	GIMAP5	6302	150431935	150436935
NM_024711	chr7	-	150322463	150329736	GIMAP6	7273	150327236	150332236
NM_153236	chr7	+	150211944	150218161	GIMAP7	6217	150209444	150214444
NM_175571	chr7	+	150147717	150176483	GIMAP8	28766	150145217	150150217
NM_001195138	chr4	-	107279339	107288592	GIMD1	9253	107286092	107291092
NM_017676	chr5	-	102421703	102455842	GIN1	34139	102453342	102458342
NM_138785	chr6	+	149887343	149912887	GINM1	25544	149884843	149889843
NM_021067	chr20	+	25388318	25429191	GINS1	40873	25385818	25390818
NM_016095	chr16	-	85711279	85722588	GINS2	11309	85720088	85725088
NM_022770	chr16	+	58426297	58440048	GINS3	13751	58423797	58428797
NM_032336	chr8	+	41386724	41402565	GINS4	15841	41384224	41389224
NM_004123	chr17	-	47035917	47045955	GIP	10038	47043455	47048455
NM_202494	chr19	-	14588570	14606961	GIPC1	18391	14604461	14609461
NM_001304725	chr1	+	78510645	78604133	GIPC2	93488	78508145	78513145
NM_133261	chr19	+	3585568	3593539	GIPC3	7971	3583068	3588068
NM_001308418	chr19	+	46171501	46186982	GIPR	15481	46169001	46174001
NM_014030	chr17	-	27900486	27916610	GIT1	16124	27914110	27919110
NM_057170	chr12	-	110367596	110434194	GIT2	66598	110431694	110436694
NM_000165	chr6	+	121756722	121770890	GJA1	14168	121754222	121759222
NM_021954	chr13	-	20712394	20735183	GJA3	22789	20732683	20737683
NM_002060	chr1	+	35258598	35261348	GJA4	2750	35256098	35261098
NM_005266	chr1	-	147228331	147245466	GJA5	17135	147242966	147247966
NM_005267	chr1	+	147374945	147381395	GJA8	6450	147372445	147377445
NM_030772	chr1	-	39339738	39347298	GJA9	7560	39344798	39349798
NR_037634	chr1	-	39328161	39347298	GJA9-MYCBP	19137	39344798	39349798
NM_001097642	chrX	+	70435061	70445065	GJB1	10004	70432561	70437561
NM_004004	chr13	-	20761603	20767114	GJB2	5511	20764614	20769614
NM_024009	chr1	+	35246789	35251965	GJB3	5176	35244289	35249289
NM_153212	chr1	+	35225341	35229325	GJB4	3984	35222841	35227841
NM_005268	chr1	+	35220647	35224113	GJB5	3466	35218147	35223147
NM_001110219	chr13	-	20796100	20806534	GJB6	10434	20804034	20809034
NM_198568	chr6	-	87992696	88038996	GJB7	46300	88036496	88041496
NM_001080383	chr17	-	42875815	42908179	GJC1	32364	42905679	42910679
NM_020435	chr1	+	228337414	228347527	GJC2	10113	228334914	228339914
NM_181538	chr7	-	99520891	99527243	GJC3	6352	99524743	99529743
NM_152219	chr17	-	38516904	38520945	GJD3	4041	38518445	38523445
NM_153368	chr10	+	35894337	35897863	GJD4	3526	35891837	35896837
NM_000167	chrX	+	30671475	30749577	GK	78102	30668975	30673975
NR_033289	chr3	-	141876368	141944449	GK5	68081	141941949	141946949
NM_025211	chr9	-	86354335	86432752	GKAP1	78417	86430252	86435252
NM_019617	chr2	+	69201704	69208112	GKN1	6408	69199204	69204204
NM_182536	chr2	-	69172363	69180102	GKN2	7739	69177602	69182602
NM_000169	chrX	-	100652778	100663001	GLA	10223	100660501	100665501
NM_001317040	chr3	-	33038099	33138722	GLB1	100623	33136222	33141222
NM_001286423	chr2	-	220101319	220110151	GLB1L	8832	220107651	220112651
NM_138342	chr11	+	134201767	134246218	GLB1L2	44451	134199267	134204267
NM_001080407	chr11	+	134146274	134189458	GLB1L3	43184	134143774	134148774
NM_138426	chr7	+	8008373	8128709	GLCCI1	120336	8005873	8010873
NM_001324092	chr15	+	69452935	69564544	GLCE	111609	69450435	69455435
NM_000170	chr9	-	6532463	6645692	GLDC	113229	6643192	6648192
NM_181789	chr15	+	51633700	51700197	GLDN	66497	51631200	51636200
NM_001003722	chr9	+	131266970	131304580	GLE1	37610	131264470	131269470
NM_001145667	chr16	-	74481325	74641042	GLG1	159717	74638542	74643542
NM_001160045	chr12	+	57853917	57866047	GLI1	12130	57851417	57856417
NM_005270	chr2	+	121554866	121750229	GLI2	195363	121552366	121557366
NM_000168	chr7	-	42000547	42276618	GLI3	276071	42274118	42279118
NM_138465	chr8	+	144349606	144359101	GLI4	9495	144347106	144352106
NR_126046	chr9	-	41948513	41955177	GLIDR	6664	41952677	41957677
NM_006851	chr12	+	75874512	75895716	GLIPR1	21204	75872012	75877012
NM_001304964	chr12	+	75728418	75764169	GLIPR1L1	35751	75725918	75730918
NR_072995	chr12	+	75784849	75826177	GLIPR1L2	41328	75782349	75787349
NR_104639	chr9	+	36136532	36163910	GLIPR2	27378	36134032	36139032
NM_147193	chr1	-	53971905	54199877	GLIS1	227972	54197377	54202377
NM_001318918	chr16	+	4364761	4389598	GLIS2	24837	4362261	4367261
NR_110901	chr16	-	4374648	4378341	GLIS2-AS1	3693	4375841	4380841
NM_001042413	chr9	-	3824127	4300035	GLIS3	475908	4297535	4302535
NR_026663	chr9	+	3898645	3901248	GLIS3-AS1	2603	3896145	3901145
NM_001319683	chr1	-	92711954	92764566	GLMN	52612	92762066	92767066
NM_001256605	chr1	-	156262477	156265480	GLMP	3003	156262980	156267980
NM_006708	chr6	-	38643701	38670952	GLO1	27251	38668452	38673452
NM_016080	chr17	-	662548	685571	GLOD4	23023	683071	688071
NM_001080489	chrX	+	48620153	48632064	GLOD5	11911	48617653	48622653
NM_002062	chr6	+	39016556	39059079	GLP1R	42523	39014056	39019056
NM_004246	chr17	+	9728867	9795420	GLP2R	66553	9726367	9731367
NM_001292000	chr5	-	151202073	151304397	GLRA1	102324	151301897	151306897
NM_002063	chrX	+	14547419	14749933	GLRA2	202514	14544919	14549919
NM_006529	chr4	-	175563161	175750466	GLRA3	187305	175747966	175752966
NM_001024452	chrX	-	102962271	102983552	GLRA4	21281	102981052	102986052
NM_001166061	chr4	+	157997276	158093242	GLRB	95966	157994776	157999776
NM_001243659	chr5	-	95149552	95158577	GLRX	9025	95156077	95161077
NM_016066	chr1	-	193065594	193075244	GLRX2	9650	193072744	193077744
NM_001199868	chr10	+	131934638	131978646	GLRX3	44008	131932138	131937138
NM_016417	chr14	+	96001322	96011055	GLRX5	9733	95998822	96003822
NM_014905	chr2	+	191745546	191830270	GLS	84724	191743046	191748046
NM_001280797	chr12	-	56864727	56882198	GLS2	17471	56879698	56884698
NR_133646	chr12	+	129337978	129469509	GLT1D1	131531	129335478	129340478
NM_182974	chr9	-	138515501	138531386	GLT6D1	15885	138528886	138533886
NM_018446	chr3	-	52728499	52740099	GLT8D1	11600	52737599	52742599
NM_001316967	chr12	-	104382760	104457955	GLT8D2	75195	104455455	104460455
NM_016433	chr12	-	110288747	110318293	GLTP	29546	110315793	110320793
NM_001318905	chr10	-	88809958	88854804	GLUD1	44846	88852304	88857304
NR_111968	chr10	+	48952591	48980339	GLUD1P7	27748	48950091	48955091
NM_002065	chr1	-	182347227	182361341	GLUL	14114	182358841	182363841
NM_201648	chr11	-	58476229	58499447	GLYAT	23218	58496947	58501947
NM_001220494	chr11	+	58695101	58724547	GLYATL1	29446	58692601	58697601
NM_145016	chr11	-	58601539	58611997	GLYATL2	10458	58609497	58614497
NM_001010904	chr6	+	49467670	49495777	GLYATL3	28107	49465170	49470170
NM_145262	chr3	+	52321835	52329272	GLYCTK	7437	52319335	52324335
NM_001324098	chr16	-	4853203	4897389	GLYR1	44186	4894889	4899889
NM_000405	chr5	+	150632612	150649953	GM2A	17341	150630112	150635112
NM_178439	chr2	+	70056737	70108527	GMCL1	51790	70054237	70059237
NR_003281	chr5	-	177611510	177614433	GMCL1P1	2923	177611933	177616933
NM_001500	chr6	-	1624034	2245868	GMDS	621834	2243368	2248368
NR_046229	chr6	+	2245986	2413825	GMDS-AS1	167839	2243486	2248486
NM_001319674	chr1	+	28995239	29042115	GMEB1	46876	28992739	28997739
NM_012384	chr20	-	62218946	62258454	GMEB2	39508	62255954	62260954
NM_004124	chr14	-	54941208	54955744	GMFB	14536	54953244	54958244
NM_004877	chr19	-	39818996	39826726	GMFG	7730	39824226	39829226
NM_001288998	chr19	-	19740281	19754476	GMIP	14195	19751976	19756976
NM_002066	chr8	+	143916216	143928262	GML	12046	143913716	143918716
NM_001146686	chr3	-	190570525	190580465	GMNC	9940	190577965	190582965
NM_015895	chr6	+	24775158	24786325	GMNN	11167	24772658	24777658
NM_013335	chr2	+	220363586	220371718	GMPPA	8132	220361086	220366086
NM_006877	chr6	+	16238810	16295780	GMPR	56970	16236310	16241310
NR_104265	chr14	+	24701627	24708447	GMPR2	6820	24699127	24704127
NM_003875	chr3	+	155588324	155655520	GMPS	67196	155585824	155590824
NM_002067	chr19	+	3094407	3124000	GNA11	29593	3091907	3096907
NM_001293092	chr7	-	2767740	2883959	GNA12	116219	2881459	2886459
NM_006572	chr17	-	63005406	63052920	GNA13	47514	63050420	63055420
NM_004297	chr9	-	80037994	80263232	GNA14	225238	80260732	80265732
NR_121184	chr9	+	80062564	80141678	GNA14-AS1	79114	80060064	80065064
NM_002068	chr19	+	3136029	3163767	GNA15	27738	3133529	3138529
NM_002069	chr7	+	79764139	79848725	GNAI1	84586	79761639	79766639
NM_001282619	chr3	+	50264119	50296786	GNAI2	32667	50261619	50266619
NM_006496	chr1	+	110091185	110138454	GNAI3	47269	110088685	110093685
NM_182978	chr18	+	11689013	11885683	GNAL	196670	11686513	11691513
NM_020988	chr16	+	56225250	56391356	GNAO1	166106	56222750	56227750
NM_002072	chr9	-	80331189	80646365	GNAQ	315176	80643865	80648865
NM_016592	chr20	+	57414772	57486251	GNAS	71479	57412272	57417272
NR_002785	chr20	-	57393972	57425958	GNAS-AS1	31986	57423458	57428458
NM_144499	chr3	+	50229042	50235129	GNAT1	6087	50226542	50231542
NM_005272	chr1	-	110145888	110155705	GNAT2	9817	110153205	110158205
NM_001102386	chr7	-	80087950	80141325	GNAT3	53375	80138825	80143825
NM_002073	chr22	+	23412539	23467224	GNAZ	54685	23410039	23415039
NM_001282538	chr1	-	1716723	1822556	GNB1	105833	1820056	1825056
NM_053004	chr22	-	19775933	19842462	GNB1L	66529	19839962	19844962
NM_005273	chr7	+	100271362	100276792	GNB2	5430	100268862	100273862
NM_002075	chr12	+	6950017	6956559	GNB3	6542	6947517	6952517
NM_021629	chr3	-	179113875	179169371	GNB4	55496	179166871	179171871
NM_016194	chr15	-	52413122	52483565	GNB5	70443	52481065	52486065
NM_001190388	chr9	-	36214438	36277053	GNE	62615	36274553	36279553
NM_001198664	chr9	+	114423850	114432526	GNG10	8676	114421350	114426350
NM_004126	chr7	+	93551015	93555826	GNG11	4811	93548515	93553515
NM_018841	chr1	-	68167148	68299155	GNG12	132007	68296655	68301655
NR_040077	chr1	+	68297970	68668670	GNG12-AS1	370700	68295470	68300470
NM_016541	chr16	-	848040	850733	GNG13	2693	848233	853233
NM_053064	chr14	+	52327021	52436518	GNG2	109497	52324521	52329521
NM_001098721	chr1	-	235710984	235814054	GNG4	103070	235811554	235816554
NM_005274	chr1	-	84964005	84972262	GNG5	8257	84969762	84974762
NM_052847	chr19	-	2511217	2702746	GNG7	191529	2700246	2705246
NM_021955	chr7	+	93535819	93540577	GNGT1	4758	93533319	93538319
NM_001198754	chr17	-	47283595	47287936	GNGT2	4341	47285436	47290436
NM_005275	chr6_cox_hap2	-	2021202	2037420	GNL1	16218	2034920	2039920
NM_001323624	chr1	-	38032412	38061586	GNL2	29174	38059086	38064086
NM_206825	chr3	+	52719935	52728510	GNL3	8575	52717435	52722435
NM_001184819	chrX	+	54556643	54593720	GNL3L	37077	54554143	54559143
NM_001302758	chr2	+	85921413	85925974	GNLY	4561	85918913	85923913
NR_134899	chr6	+	42928491	42931618	GNMT	3127	42925991	42930991
NM_001316350	chr1	+	231376918	231413719	GNPAT	36801	231374418	231379418
NM_005471	chr5	-	141380233	141392620	GNPDA1	12387	141390120	141395120
NM_001270880	chr4	-	44703811	44728651	GNPDA2	24840	44726151	44731151
NM_198066	chr14	-	53241910	53258386	GNPNAT1	16476	53255886	53260886
NM_024312	chr12	-	102139274	102224645	GNPTAB	85371	102222145	102227145
NM_032520	chr16	+	1401899	1413352	GNPTG	11453	1399399	1404399
NM_000825	chr8	-	25276773	25282556	GNRH1	5783	25280056	25285056
NM_000406	chr4	-	68603098	68621804	GNRHR	18706	68619304	68624304
NR_002328	chr1	-	145509751	145516076	GNRHR2	6325	145513576	145518576
NM_002076	chr12	-	65107221	65153226	GNS	46005	65150726	65155726
NM_002077	chr9	-	127640572	127703386	GOLGA1	62814	127700886	127705886
NM_004486	chr9	-	131018107	131038268	GOLGA2	20161	131035768	131040768
NR_033936	chr15	-	83140198	83182977	GOLGA2P10	42779	83180477	83185477
NR_136885	chr15	-	62534727	62540994	GOLGA2P11	6267	62538494	62543494
NR_001555	chrY	-	26356113	26360978	GOLGA2P2Y	4865	26358478	26363478
NR_002195	chrY	-	26356113	26360978	GOLGA2P3Y	4865	26358478	26363478
NR_036632	chr12	-	100550174	100567121	GOLGA2P5	16947	100564621	100569621
NR_120609	chr10	-	30653255	30660836	GOLGA2P6	7581	30658336	30663336
NR_027001	chr15	-	84867599	84898920	GOLGA2P7	31321	84896420	84901420
NR_033899	chr19	+	22779058	22786352	GOLGA2P9	7294	22776558	22781558
NM_005895	chr12	-	133345494	133405288	GOLGA3	59794	133402788	133407788
NM_001172713	chr3	+	37284681	37408370	GOLGA4	123689	37282181	37287181
NM_005113	chr14	+	93260575	93306306	GOLGA5	45731	93258075	93263075
NM_001038640	chr15	-	74362197	74374891	GOLGA6A	12694	74372391	74377391
NM_018652	chr15	+	72947037	72959738	GOLGA6B	12701	72944537	72949537
NM_001164404	chr15	+	75550898	75565796	GOLGA6C	14898	75548398	75553398
NM_001145224	chr15	+	75575181	75588148	GOLGA6D	12967	75572681	75577681
NM_001001413	chr15	+	22736245	22746002	GOLGA6L1	9757	22733745	22738745
NM_001164465	chr15	-	82632349	83018198	GOLGA6L10	385849	83015698	83020698
NR_111962	chr15	+	82804002	83195272	GOLGA6L17P	391270	82801502	82806502
NM_001304388	chr15	-	23684532	23692390	GOLGA6L2	7858	23689890	23694890
NM_001271664	chr15	-	23403865	23579357	GOLGA6L22	175492	23576857	23581857
NM_001310153	chr15	+	85783640	85790418	GOLGA6L3	6778	85781140	85786140
NM_001267536	chr15	+	84904524	84914120	GOLGA6L4	9596	84902024	84907024
NR_003246	chr15	-	85049398	85060078	GOLGA6L5P	10680	85057578	85062578
NM_001145004	chr15	-	20737093	20747114	GOLGA6L6	10021	20744614	20749614
NM_001291420	chr15	+	82804768	83108111	GOLGA6L9	303343	82802268	82807268
NM_001174124	chr8	+	41348080	41368499	GOLGA7	20419	41345580	41350580
NM_001010917	chr10	+	99609994	99631335	GOLGA7B	21341	99607494	99612494
NR_027409	chr15	-	34671269	34729667	GOLGA8A	58398	34727167	34732167
NR_027410	chr15	-	34817483	34875771	GOLGA8B	58288	34873271	34878271
NR_027411	chr15	+	20767673	20781026	GOLGA8CP	13353	20765173	20770173
NR_027407	chr15	-	22702284	22715728	GOLGA8DP	13444	22713228	22718228
NR_033350	chr15	+	23435069	23448423	GOLGA8EP	13354	23432569	23437569
NM_001350920	chr15	+	28623809	28637171	GOLGA8F	13362	28621309	28626309
NR_033353	chr15	+	28623783	28637171	GOLGA8G	13388	28621283	28626283
NM_001282490	chr15	+	30896232	30910029	GOLGA8H	13797	30893732	30898732
NR_024074	chr15	+	23255241	23262743	GOLGA8IP	7502	23252741	23257741
NM_001282472	chr15	+	30375157	30388904	GOLGA8J	13747	30372657	30377657
NM_001282493	chr15	-	32681785	32695493	GOLGA8K	13708	32692993	32697993
NM_001282468	chr15	-	28943840	28957567	GOLGA8M	13727	28955067	28960067
NM_001282494	chr15	+	32885656	32899511	GOLGA8N	13855	32883156	32888156
NM_001277308	chr15	-	32734114	32747835	GOLGA8O	13721	32745335	32750335
NM_001282484	chr15	-	30692764	30706463	GOLGA8R	13699	30703963	30708963
NR_038843	chr15	+	23599894	23613471	GOLGA8S	13577	23597394	23602394
NR_033933	chr15	+	30427989	30439395	GOLGA8T	11406	30425489	30430489
NM_001256486	chr3	-	121382045	121468614	GOLGB1	86569	121466114	121471114
NM_014498	chr3	-	167726460	167813713	GOLIM4	87253	167811213	167816213
NM_177937	chr9	-	88641057	88715116	GOLM1	74059	88712616	88717616
NM_022130	chr5	-	32124823	32174425	GOLPH3	49602	32171925	32176925
NM_018178	chr1	-	150618700	150669672	GOLPH3L	50972	150667172	150672172
NM_198447	chr1	-	204167287	204183220	GOLT1A	15933	204180720	204185720
NM_016072	chr12	+	21654698	21671337	GOLT1B	16639	21652198	21657198
NM_001282856	chr1	-	155719448	155829191	GON4L	109743	155826691	155831691
NM_032490	chr14	-	93669236	93673459	GON7	4223	93670959	93675959
NM_020399	chr6	-	117881432	117923705	GOPC	42273	117921205	117926205
NM_152281	chr1	+	170501262	170522974	GORAB	21712	170498762	170503762
NM_031899	chr3	-	39138089	39149854	GORASP1	11765	39147354	39152354
NM_001201428	chr2	+	171784947	171823643	GORASP2	38696	171782447	171787447
NM_004871	chr17	+	28804425	28853832	GOSR1	49407	28801925	28806925
NM_001321133	chr17	+	45000482	45044366	GOSR2	43884	44997982	45002982
NM_002079	chr10	-	101156626	101190530	GOT1	33904	101188030	101193030
NM_152413	chr8	-	37791799	37797647	GOT1L1	5848	37795147	37800147
NM_001286220	chr16	-	58741034	58768261	GOT2	27227	58765761	58770761
NM_000173	chr17	+	4835569	4838325	GP1BA	2756	4833069	4838069
NM_001502	chr16	-	20320895	20338942	GP2	18047	20336442	20341442
NM_004488	chr3	-	194115549	194119995	GP5	4446	194117495	194122495
NM_016363	chr19	-	55525074	55549632	GP6	24558	55547132	55552132
NM_005814	chr1	-	167022072	167059868	GPA33	37796	167057368	167062368
NM_003801	chr8	+	145137523	145141119	GPAA1	3596	145135023	145140023
NM_001316952	chr13	+	45563664	45607743	GPALPP1	44079	45561164	45566164
NM_001244949	chr10	-	113909621	113943537	GPAM	33916	113941037	113946037
NM_001199237	chr6_ssto_hap7	-	2959803	2964865	GPANK1	5062	2962365	2967365
NM_001321531	chr2	-	96687693	96701722	GPAT2	14029	96699222	96704222
NM_001256422	chr4	+	84457066	84527027	GPAT3	69961	84454566	84459566
NM_178819	chr8	+	41435706	41482520	GPAT4	46814	41433206	41438206
NR_135270	chr19	+	33571785	33621318	GPATCH1	49533	33569285	33574285
NM_001278505	chr2	+	37311593	37326387	GPATCH11	14794	37309093	37314093
NM_018040	chr1	-	217600334	217804454	GPATCH2	204120	217801954	217806954
NM_017926	chr14	+	76618227	76679146	GPATCH2L	60919	76615727	76620727
NM_022078	chr1	-	27216978	27226962	GPATCH3	9984	27224462	27229462
NM_015590	chr1	-	156564099	156571279	GPATCH4	7180	156568779	156573779
NM_001304941	chr17	-	42472644	42580970	GPATCH8	108326	42578470	42583470
NM_001321950	chr2	+	219124218	219128582	GPBAR1	4364	219121718	219126718
NM_022913	chr5	+	56469774	56560506	GPBP1	90732	56467274	56472274
NM_021639	chr1	-	46092975	46152302	GPBP1L1	59327	46149802	46154802
NM_002081	chr2	+	241375114	241407495	GPC1	32381	241372614	241377614
NM_152742	chr7	-	99767228	99775049	GPC2	7821	99772549	99777549
NM_004484	chrX	-	132669775	133119673	GPC3	449898	133117173	133122173
NM_001448	chrX	-	132435063	132549205	GPC4	114142	132546705	132551705
NM_004466	chr13	+	92050872	93519487	GPC5	1468615	92048372	92053372
NR_046520	chr13	-	93353641	93373867	GPC5-AS1	20226	93371367	93376367
NR_120382	chr13	-	92992046	93004460	GPC5-AS2	12414	93001960	93006960
NM_005708	chr13	+	93879060	95060273	GPC6	1181213	93876560	93881560
NR_046535	chr13	-	94806446	94840245	GPC6-AS1	33799	94837745	94842745
NR_046536	chr13	-	94470676	94510726	GPC6-AS2	40050	94508226	94513226
NM_019593	chr20	-	5525079	5591672	GPCPD1	66593	5589172	5594172
NM_001257199	chr12	+	50497601	50505103	GPD1	7502	50495101	50500101
NM_015141	chr3	+	32148002	32210207	GPD1L	62205	32145502	32150502
NM_001083112	chr2	+	157291964	157442915	GPD2	150951	157289464	157294464
NM_001505	chr7	+	1126442	1133451	GPER1	7009	1123942	1128942
NM_145171	chr14	-	63779548	63785593	GPHB5	6045	63783093	63788093
NM_020806	chr14	+	66974124	67648525	GPHN	674401	66971624	66976624
NM_001289789	chr19	+	34855644	34893318	GPI	37674	34853144	34858144
NM_178172	chr8	+	144295067	144299044	GPIHBP1	3977	144292567	144297567
NM_015698	chrX	-	48970322	48980151	GPKOW	9829	48977651	48982651
NM_001503	chr6	-	24426061	24489850	GPLD1	63789	24487350	24492350
NM_201592	chr4	-	176554087	176923842	GPM6A	369755	176921342	176926342
NM_001318729	chrX	-	13789040	13956943	GPM6B	167903	13954443	13959443
NM_001145049	chr2	+	27851514	27873713	GPN1	22199	27849014	27854014
NM_018066	chr1	-	27205872	27216869	GPN2	10997	27214369	27219369
NM_001164372	chr12	-	110890290	110906526	GPN3	16236	110904026	110909026
NM_002510	chr7	+	23286315	23314729	GPNMB	28414	23283815	23288815
NM_001261453	chr2	-	207040041	207082771	GPR1	42730	207080271	207085271
NR_104359	chr2	+	207068099	207130967	GPR1-AS	62868	207065599	207070599
NM_001136558	chr9	+	132815984	132902448	GPR107	86464	132813484	132818484
NM_001080452	chr19	-	6729924	6737633	GPR108	7709	6735133	6740133
NM_005288	chr13	-	27329338	27334922	GPR12	5584	27332422	27337422
NM_001278695	chr14	-	105515725	105531887	GPR132	16162	105529387	105534387
NM_001170726	chr11	+	64051810	64056972	GPR137	5162	64049310	64054310
NM_003272	chr1	+	236305831	236372209	GPR137B	66378	236303331	236308331
NM_001099652	chr14	+	53019865	53104431	GPR137C	84566	53017365	53022365
NM_001318483	chr16	-	20042806	20085100	GPR139	42294	20082600	20087600
NM_001329993	chr7	+	37723377	37783423	GPR141	60046	37720877	37725877
NM_001331077	chr17	+	72363644	72368739	GPR142	5095	72361144	72366144
NM_000273	chrX	-	9693452	9734005	GPR143	40553	9731505	9736505
NM_001303473	chr7	+	1084208	1098905	GPR146	14697	1081708	1086708
NM_001038705	chr3	-	154052732	154147504	GPR149	94772	154145004	154150004
NM_005290	chr3	+	98250742	98253523	GPR15	2781	98248242	98253242
NM_207370	chr1	-	6307405	6321035	GPR153	13630	6318535	6323535
NM_001267050	chr2	-	175296299	175351816	GPR155	55517	175349316	175354316
NM_001168271	chr3	-	119884327	119963142	GPR156	78815	119960642	119965642
NM_024980	chr1	-	9164475	9189229	GPR157	24754	9186729	9191729
NM_020752	chr10	+	25464289	25891157	GPR158	426868	25461789	25466789
NR_027333	chr10	-	25447000	25465205	GPR158-AS1	18205	25462705	25467705
NM_014373	chr3	+	169755734	169803183	GPR160	47449	169753234	169758234
NM_001267609	chr1	-	168048779	168106905	GPR161	58126	168104405	168109405
NM_014449	chr12	+	6930962	6936583	GPR162	5621	6928462	6933462
NM_001161415	chr2	+	128403438	128410213	GPR17	6775	128400938	128405938
NM_013308	chr3	-	150915618	150920988	GPR171	5370	150918488	150923488
NM_018969	chrX	+	53078505	53109796	GPR173	31291	53076005	53081005
NM_007223	chr15	-	40091222	40213093	GPR176	121871	40210593	40215593
NM_001004334	chr17	-	36481492	36499693	GPR179	18201	36497193	36502193
NM_005292	chr13	-	99906966	99910682	GPR18	3716	99908182	99913182
NM_180989	chr13	+	95254103	95286899	GPR180	32796	95251603	95256603
NM_004951	chr13	-	99946788	99959749	GPR183	12961	99957249	99962249
NM_006143	chr12	-	12813994	12849121	GPR19	35127	12846621	12851621
NM_005293	chr8	-	142366586	142377365	GPR20	10779	142374865	142379865
NM_005295	chr7	+	107110501	107116125	GPR22	5624	107108001	107113001
NM_153442	chr10	+	125425870	125456913	GPR26	31043	125423370	125428370
NM_018971	chr3	+	71802874	71805531	GPR27	2657	71800374	71805374
NM_005281	chr1	+	27719147	27722317	GPR3	3170	27716647	27721647
NM_001197184	chr14	-	31952149	31957151	GPR33	5002	31954651	31959651
NM_001097579	chrX	+	41548225	41556530	GPR34	8305	41545725	41550725
NM_001195382	chr2	+	241544824	241570676	GPR35	25852	241542324	241547324
NM_005302	chr7	-	124385654	124406079	GPR37	20425	124403579	124408579
NM_004767	chr1	+	202092028	202098634	GPR37L1	6606	202089528	202094528
NM_001508	chr2	+	133174146	133404169	GPR39	230023	133171646	133176646
NM_005282	chr19	-	46093022	46105466	GPR4	12444	46102966	46107966
NM_004224	chrX	+	150345055	150349937	GPR50	4882	150342555	150347555
NR_135300	chrX	-	150343669	150346308	GPR50-AS1	2639	150343808	150348808
NM_005683	chr2	-	231772042	231789941	GPR55	17899	231787441	231792441
NM_031936	chr1	+	110082493	110088455	GPR61	5962	110079993	110084993
NM_030784	chr6	-	97241997	97285353	GPR63	43356	97282853	97287853
NM_003608	chr14	+	88471467	88481155	GPR65	9688	88468967	88473967
NM_003485	chr14	-	91698875	91720224	GPR68	21349	91717724	91722724
NM_006794	chr2	-	54080049	54087170	GPR75	7121	54084670	54089670
NM_001164165	chr2	-	53897449	54087170	GPR75-ASB3	189721	54084670	54089670
NR_045511	chr4	+	8581963	8591750	GPR78	9787	8579463	8584463
NM_080817	chrX	+	41583407	41589388	GPR82	5981	41580907	41585907
NM_001330345	chr11	-	94110476	94134589	GPR83	24113	94132089	94137089
NM_018970	chr7	-	112720467	112727833	GPR85	7366	112725333	112730333
NM_023915	chr3	-	151011875	151034636	GPR87	22761	151032136	151037136
NM_022049	chr1	+	101003727	101007583	GPR88	3856	101001227	101006227
NR_036541	chr1	-	145764594	145827103	GPR89A	62509	145824603	145829603
NM_001350180	chr1	+	147400486	147465824	GPR89B	65338	147397986	147402986
NM_001099410	chrX	+	101906293	101914010	GPRASP1	7717	101903793	101908793
NM_138437	chrX	+	101967103	101972661	GPRASP2	5558	101964603	101969603
NM_003979	chr12	+	13043955	13066601	GPRC5A	22646	13041455	13046455
NM_001304771	chr16	-	19870292	19896956	GPRC5B	26664	19894456	19899456
NM_022036	chr17	+	72427666	72443568	GPRC5C	15902	72425166	72430166
NM_018654	chr12	-	13093708	13103318	GPRC5D	9610	13100818	13105818
NM_001286355	chr6	-	117113247	117150220	GPRC6A	36973	117147720	117152720
NM_052899	chr5	-	176022802	176037131	GPRIN1	14329	176034631	176039631
NM_014696	chr10	+	46993545	47000568	GPRIN2	7023	46991045	46996045
NM_198281	chr4	-	90165428	90229161	GPRIN3	63733	90226661	90231661
NM_001330539	chr17	+	80009740	80015937	GPS1	6197	80007240	80012240
NM_004489	chr17	-	7215977	7218658	GPS2	2681	7216158	7221158
NM_001145638	chr9	+	139221931	139254057	GPSM1	32126	139219431	139224431
NM_001321039	chr1	+	109419602	109476957	GPSM2	57355	109417102	109422102
NM_022107	chr6	-	32158542	32163300	GPSM3	4758	32160800	32165800
NM_005309	chr8	+	145729464	145732555	GPT	3091	145726964	145731964
NM_133443	chr16	+	46918291	46965209	GPT2	46918	46915791	46920791
NM_002083	chr14	-	65405869	65409623	GPX2	3754	65407123	65412123
NM_002084	chr5	+	150399972	150408554	GPX3	8582	150397472	150402472
NM_001039847	chr19	+	1103924	1106788	GPX4	2864	1101424	1106424
NM_001509	chr6	+	28493788	28502728	GPX5	8940	28491288	28496288
NM_182701	chr6	-	28471072	28483570	GPX6	12498	28481070	28486070
NM_015696	chr1	+	53068042	53074723	GPX7	6681	53065542	53070542
NM_001306198	chr5	+	54455945	54463129	GPX8	7184	54453445	54458445
NM_001320036	chr19	+	35485687	35517375	GRAMD1A	31688	35483187	35488187
NM_001330396	chr11	+	123380586	123498479	GRAMD1B	117893	123378086	123383086
NM_017577	chr3	+	113557680	113666021	GRAMD1C	108341	113555180	113560180
NM_001012642	chr15	-	72452146	72490136	GRAMD2A	37990	72487636	72492636
NM_001146319	chr5	+	125695787	125829853	GRAMD2B	134066	125693287	125698287
NM_015124	chr22	+	47016298	47075688	GRAMD4	59390	47013798	47018798
NM_001330148	chr17	-	18923968	18950365	GRAP	26397	18947865	18952865
NM_004810	chr22	+	40297085	40369346	GRAP2	72261	40294585	40299585
NM_001129778	chr17	+	19030781	19062148	GRAPL	31367	19028281	19033281
NM_181711	chr12	+	52400728	52409673	GRASP	8945	52398228	52403228
NM_001001555	chr7	-	50657759	50861159	GRB10	203400	50858659	50863659
NM_004490	chr2	-	165349322	165478360	GRB14	129038	165475860	165480860
NM_203506	chr17	-	73314156	73401790	GRB2	87634	73399290	73404290
NM_001330207	chr17	+	37894153	37903538	GRB7	9385	37891653	37896653
NM_014668	chr2	+	11674241	11782912	GREB1	108671	11671741	11676741
NM_001142966	chr18	+	18822202	19106073	GREB1L	283871	18819702	18824702
NM_001191323	chr15	+	33010204	33026870	GREM1	16666	33007704	33012704
NM_022469	chr1	-	240652872	240775462	GREM2	122590	240772962	240777962
NM_198182	chr2	+	10091791	10142412	GRHL1	50621	10089291	10094291
NM_001330593	chr8	+	102504666	102681952	GRHL2	177286	102502166	102507166
NM_198174	chr1	+	24645811	24690970	GRHL3	45159	24643311	24648311
NM_012203	chr9	+	37422706	37436986	GRHPR	14280	37420206	37425206
NM_001258019	chr5	+	152870083	153193429	GRIA1	323346	152867583	152872583
NM_000826	chr4	+	158141735	158287226	GRIA2	145491	158139235	158144235
NM_000828	chrX	+	122318095	122624766	GRIA3	306671	122315595	122320595
NM_000829	chr11	+	105480799	105852819	GRIA4	372020	105478299	105483299
NM_017551	chr10	-	87359311	88126250	GRID1	766939	88123750	88128750
NR_038986	chr10	+	87337487	87366972	GRID1-AS1	29485	87334987	87339987
NM_001510	chr4	+	93225549	94695706	GRID2	1470157	93223049	93228049
NM_001145118	chr7	-	6536408	6591067	GRID2IP	54659	6588567	6593567
NM_001320618	chr21	-	30909253	31312370	GRIK1	403117	31309870	31314870
NR_027021	chr21	+	31120493	31136325	GRIK1-AS1	15832	31117993	31122993
NR_033368	chr21	+	30968359	31003067	GRIK1-AS2	34708	30965859	30970859
NM_021956	chr6	+	101846860	102517958	GRIK2	671098	101844360	101849360
NM_000831	chr1	-	37261127	37499844	GRIK3	238717	37497344	37502344
NM_014619	chr11	+	120382454	120859513	GRIK4	477059	120379954	120384954
NM_002088	chr19	-	42502467	42569957	GRIK5	67490	42567457	42572457
NM_001185091	chr9	+	140033608	140063214	GRIN1	29606	140031108	140036108
NM_000833	chr16	-	9847261	10276611	GRIN2A	429350	10274111	10279111
NM_000834	chr12	-	13714409	14133022	GRIN2B	418613	14130522	14135522
NM_000835	chr17	-	72838161	72856007	GRIN2C	17846	72853507	72858507
NM_000836	chr19	+	48898131	48948188	GRIN2D	50057	48895631	48900631
NM_133445	chr9	-	104331633	104500862	GRIN3A	169229	104498362	104503362
NM_138690	chr19	+	1000417	1009731	GRIN3B	9314	997917	1002917
NM_001009184	chr8	+	145064225	145067583	GRINA	3358	145061725	145066725
NM_001178074	chr12	-	66741210	67072925	GRIP1	331715	67070425	67075425
NM_001080423	chr3	-	14530618	14581850	GRIP2	51232	14579350	14584350
NM_020137	chrX	-	48830130	48858675	GRIPAP1	28545	48856175	48861175
NM_002929	chr13	+	114321596	114438637	GRK1	117041	114319096	114324096
NM_001619	chr11	+	67033904	67054029	GRK2	20125	67031404	67036404
NM_005160	chr22	+	25960860	26125258	GRK3	164398	25958360	25963360
NM_001350173	chr4	+	2965297	3042474	GRK4	77177	2962797	2967797
NM_005308	chr10	+	120967196	121215131	GRK5	247935	120964696	120969696
NM_002082	chr5	+	176853686	176869850	GRK6	16164	176851186	176856186
NR_144554	chr13	+	21893174	21896242	GRK6P1	3068	21890674	21895674
NM_139209	chr3	+	141497042	141535892	GRK7	38850	141494542	141499542
NM_001278065	chr6	+	146348917	146758734	GRM1	409817	146346417	146351417
NM_000839	chr3	+	51741048	51752625	GRM2	11577	51738548	51743548
NM_000840	chr7	+	86273229	86494192	GRM3	220963	86270729	86275729
NM_001256809	chr6	-	33986419	34123399	GRM4	136980	34120899	34125899
NM_000842	chr11	-	88237743	88796846	GRM5	559103	88794346	88799346
NR_049724	chr11	+	88237743	88257222	GRM5-AS1	19479	88235243	88240243
NM_000843	chr5	-	178405329	178422124	GRM6	16795	178419624	178424624
NM_000844	chr3	+	6902801	7783218	GRM7	880417	6900301	6905301
NR_046606	chr3	-	7561427	7576971	GRM7-AS1	15544	7574471	7579471
NR_110123	chr3	-	6674044	6847136	GRM7-AS3	173092	6844636	6849636
NM_001127323	chr7	-	126078651	126892428	GRM8	813777	126889928	126894928
NM_002087	chr17	+	42422453	42430474	GRN	8021	42419953	42424953
NM_002091	chr18	+	56887399	56898006	GRP	10607	56884899	56889899
NM_025196	chr4	-	7060621	7069937	GRPEL1	9316	7067437	7072437
NM_152407	chr5	+	148724976	148734146	GRPEL2	9170	148722476	148727476
NR_132366	chr5	-	148727678	148737205	GRPEL2-AS1	9527	148734705	148739705
NM_005314	chrX	+	16141423	16171641	GRPR	30218	16138923	16143923
NM_002092	chr4	-	71681498	71705627	GRSF1	24129	71703127	71708127
NM_001286733	chr13	-	113978478	114018463	GRTP1	39985	114015963	114020963
NR_046541	chr13	+	114005987	114016182	GRTP1-AS1	10195	114003487	114008487
NM_031485	chr19	+	48949029	48957164	GRWD1	8135	48946529	48951529
NM_001080476	chr4	+	42895282	43032675	GRXCR1	137393	42892782	42897782
NM_001080516	chr5	-	145239295	145252531	GRXCR2	13236	145250031	145255031
NR_111973	chr7	-	65995291	66057394	GS1-124K5.11	62103	66054894	66059894
NR_045217	chr8	+	6693075	6699975	GS1-24F4.2	6900	6690575	6695575
NR_038424	chr1	-	185292978	185304171	GS1-279B7.1	11193	185301671	185306671
NR_126564	chrX	+	15621003	15639607	GS1-594A7.3	18604	15618503	15623503
NR_046087	chrX	+	13328770	13338052	GS1-600G8.3	9282	13326270	13331270
NM_017439	chr7	-	76940067	77045717	GSAP	105650	77043217	77048217
NM_178171	chr17	+	38119225	38134019	GSDMA	14794	38116725	38121725
NM_001165958	chr17	-	38060847	38074903	GSDMB	14056	38072403	38077403
NM_031415	chr8	-	130760441	130799134	GSDMC	38693	130796634	130801634
NM_001166237	chr8	+	144635556	144645231	GSDMD	9675	144633056	144638056
NM_001134473	chr16	+	85645028	85709812	GSE1	64784	85642528	85647528
NR_033839	chr11	-	126211611	126225482	GSEC	13871	126222982	126227982
NM_001080554	chr12	-	13236470	13256630	GSG1	20160	13254130	13259130
NM_001109763	chr16	-	27798849	28074830	GSG1L	275981	28072330	28077330
NM_001310219	chr17	-	9705702	9725388	GSG1L2	19686	9722888	9727888
NM_019884	chr19	-	42734337	42746736	GSK3A	12399	42744236	42749236
NM_001146156	chr3	-	119540801	119813264	GSK3B	272463	119810764	119815764
NM_001271905	chr14	+	96829788	96853627	GSKIP	23839	96827288	96832288
NM_001353053	chr9	+	123963760	124095120	GSN	131360	123961260	123966260
NR_103560	chr9	-	124043045	124047808	GSN-AS1	4763	124045308	124050308
NM_001130007	chr16	-	11961984	12010519	GSPT1	48535	12008019	12013019
NM_018094	chrX	+	51486480	51489326	GSPT2	2846	51483980	51488980
NM_000637	chr8	-	30535579	30585516	GSR	49937	30583016	30588016
NM_001322494	chr20	-	33516235	33543830	GSS	27595	33541330	33546330
NM_145740	chr6	-	52656177	52668765	GSTA1	12588	52666265	52671265
NM_000846	chr6	-	52614884	52628361	GSTA2	13477	52625861	52630861
NM_000847	chr6	-	52761438	52774496	GSTA3	13058	52771996	52776996
NM_001512	chr6	-	52842745	52860178	GSTA4	17433	52857678	52862678
NM_153699	chr6	-	52696540	52710893	GSTA5	14353	52708393	52713393
NR_033760	chr6	-	52604260	52609957	GSTA7P	5697	52607457	52612457
NM_024751	chr4	+	106629940	106768882	GSTCD	138942	106627440	106632440
NM_001143681	chr7	+	142960521	142966222	GSTK1	5701	142958021	142963021
NM_000561	chr1	+	110230417	110236367	GSTM1	5950	110227917	110232917
NM_001142368	chr1	+	110210643	110226619	GSTM2	15976	110208143	110213143
NR_024537	chr1	-	110276553	110283660	GSTM3	7107	110281160	110286160
NM_147148	chr1	+	110198697	110208123	GSTM4	9426	110196197	110201197
NM_000851	chr1	+	110254863	110260890	GSTM5	6027	110252363	110257363
NM_001191003	chr10	+	106013951	106027222	GSTO1	13271	106011451	106016451
NM_183239	chr10	+	106028630	106059176	GSTO2	30546	106026130	106031130
NM_000852	chr11	+	67351065	67354124	GSTP1	3059	67348565	67353565
NM_001293814	chr22	-	24376132	24384311	GSTT1	8179	24381811	24386811
NR_126445	chr22	-	24299600	24303488	GSTT2	3888	24300988	24305988
NM_001080843	chr22	+	24322338	24326106	GSTT2B	3768	24319838	24324838
NR_003081	chr22	-	24340594	24347258	GSTTP1	6664	24344758	24349758
NR_003082	chr22	-	24385937	24401899	GSTTP2	15962	24399399	24404399
NM_001312660	chr14	+	77787229	77797940	GSTZ1	10711	77784729	77789729
NM_001284238	chr2	-	144703580	145090101	GTDC1	386521	145087601	145092601
NM_201595	chr14	-	81641795	81687575	GTF2A1	45780	81685075	81690075
NM_001193487	chr2	+	48844918	48906751	GTF2A1L	61833	48842418	48847418
NM_001320930	chr15	-	59930260	59949740	GTF2A2	19480	59947240	59952240
NM_001514	chr1	-	89318320	89357301	GTF2B	38981	89354801	89359801
NM_005513	chr3	+	120461557	120501916	GTF2E1	40359	120459057	120464057
NM_002095	chr8	-	30435834	30515758	GTF2E2	79924	30513258	30518258
NM_002096	chr19	-	6379579	6393291	GTF2F1	13712	6390791	6395791
NM_004128	chr13	+	45694630	45858239	GTF2F2	163609	45692130	45697130
NM_005316	chr11	+	18343815	18388590	GTF2H1	44775	18341315	18346315
NM_001515	chr5	-	70330950	70363497	GTF2H2	32547	70360997	70365997
NR_033417	chr5	+	69711196	69746189	GTF2H2B	34993	69708696	69713696
NM_001098728	chr5	+	68856050	68888729	GTF2H2C	32679	68853550	68858550
NM_001042490	chr5	+	68856073	68888352	GTF2H2C_2	32279	68853573	68858573
NM_001271867	chr12	+	124118285	124147151	GTF2H3	28866	124115785	124120785
NM_001517	chr6	+	30875976	30881880	GTF2H4	5904	30873476	30878476
NM_207118	chr6	+	158589378	158620376	GTF2H5	30998	158586878	158591878
NM_033001	chr7	+	74071990	74175022	GTF2I	103032	74069490	74074490
NR_002206	chr7	-	74601103	74867641	GTF2IP1	266538	74865141	74870141
NR_135112	chr4	-	120370724	120375783	GTF2IP12	5059	120373283	120378283
NR_132119	chr1	-	224138967	224180346	GTF2IP20	41379	224177846	224182846
NR_135738	chr7	+	66312436	66349260	GTF2IP23	36824	66309936	66314936
NR_003580	chr7	-	74601103	74653459	GTF2IP4	52356	74650959	74655959
NR_135079	chr7	-	75721380	75738080	GTF2IP7	16700	75735580	75740580
NM_016328	chr7	+	73868119	74016920	GTF2IRD1	148801	73865619	73870619
NR_003934	chr7	-	66274979	66309813	GTF2IRD1P1	34834	66307313	66312313
NM_173537	chr7	-	74210482	74267872	GTF2IRD2	57390	74265372	74270372
NM_001003795	chr7	+	74508346	74565623	GTF2IRD2B	57277	74505846	74510846
NM_002097	chr13	+	27998680	28009846	GTF3A	11166	27996180	28001180
NM_001520	chr16	-	27471933	27561251	GTF3C1	89318	27558751	27563751
NM_001521	chr2	-	27548715	27579901	GTF3C2	31186	27577401	27582401
NM_012086	chr2	-	197627755	197664492	GTF3C3	36737	197661992	197666992
NM_012204	chr9	+	135545421	135570342	GTF3C4	24921	135542921	135547921
NM_001122823	chr9	+	135906061	135933890	GTF3C5	27829	135903561	135908561
NM_138408	chr6	+	111279762	111289091	GTF3C6	9329	111277262	111282262
NM_004286	chr22	+	39101806	39129592	GTPBP1	27786	39099306	39104306
NM_033107	chr7	+	89975978	90020769	GTPBP10	44791	89973478	89978478
NM_019096	chr6	-	43588217	43596983	GTPBP2	8766	43594483	43599483
NM_001195422	chr19	+	17445790	17453540	GTPBP3	7750	17443290	17448290
NM_012341	chr10	+	1034348	1063708	GTPBP4	29360	1031848	1036848
NM_012227	chrX	-	221416	230887	GTPBP6	9471	228387	233387
NM_138485	chr3	+	112709799	112720221	GTPBP8	10422	112707299	112712299
NM_001278515	chr18	-	68297754	68318093	GTSCR1	20339	68315593	68320593
NM_016426	chr22	+	46692637	46726707	GTSE1	34070	46690137	46695137
NM_144594	chr12	-	54849735	54867386	GTSF1	17651	54864886	54869886
NM_001319062	chr6	+	42123114	42147821	GUCA1A	24707	42120614	42125614
NM_002098	chr6	-	42151021	42162694	GUCA1B	11673	42160194	42165194
NM_005459	chr3	-	108626641	108672677	GUCA1C	46036	108670177	108675177
NM_001284252	chr22	-	24936390	24951903	GUCD1	15513	24949403	24954403
NM_000855	chr11	-	106544737	106889171	GUCY1A2	344434	106886671	106891671
NM_001130682	chr4	+	156587861	156658214	GUCY1A3	70353	156585361	156590361
NR_003923	chr13	-	51568646	51640293	GUCY1B2	71647	51637793	51642793
NM_000857	chr4	+	156680124	156728794	GUCY1B3	48670	156677624	156682624
NM_004963	chr12	-	14765565	14849519	GUCY2C	83954	14847019	14852019
NM_000180	chr17	+	7905987	7923658	GUCY2D	17671	7903487	7908487
NR_024042	chr11	-	76391209	76432833	GUCY2EP	41624	76430333	76435333
NM_001522	chrX	-	108616134	108725285	GUCY2F	109151	108722785	108727785
NR_028134	chr10	-	114067935	114116353	GUCY2GP	48418	114113853	114118853
NM_001345867	chr4	+	44680411	44702697	GUF1	22286	44677911	44682911
NM_001242839	chr1	+	228327784	228336655	GUK1	8871	228325284	228330284
NM_001252668	chr2	+	189156395	189460652	GULP1	304257	189153895	189158895
NM_001284290	chr7	-	65425671	65447301	GUSB	21630	65444801	65449801
NR_027026	chr5	+	21459588	21589481	GUSBP1	129893	21457088	21462088
NR_030766	chr7	-	57233376	57247863	GUSBP10	14487	57245363	57250363
NR_024448	chr22	-	23980674	24059610	GUSBP11	78936	24057110	24062110
NR_003504	chr6	-	26839265	26924333	GUSBP2	85068	26921833	26926833
NR_027386	chr5	-	69515015	69881629	GUSBP3	366614	69879129	69884129
NR_132999	chr6	-	58234830	58263207	GUSBP4	28377	58260707	58265707
NR_033968	chr5	-	69812078	69851150	GUSBP9	39072	69848650	69853650
NR_003945	chr11	-	6734375	6743110	GVINP1	8735	6740610	6745610
NM_001242740	chr6	-	139046347	139094816	GVQW2	48469	139092316	139097316
NM_173601	chr12	-	42475647	42538673	GXYLT1	63026	42536173	42541173
NR_121572	chr9	+	42493516	42498676	GXYLT1P3	5160	42491016	42496016
NM_001080393	chr3	+	72937384	73024522	GXYLT2	87138	72934884	72939884
NM_004130	chr3	+	148709194	148745456	GYG1	36262	148706694	148711694
NM_001184702	chrX	+	2746862	2800861	GYG2	53999	2744362	2749362
NR_033667	chrY	-	14517914	14533389	GYG2P1	15475	14530889	14535889
NM_001308187	chr4	-	145030455	145061939	GYPA	31484	145059439	145064439
NM_002100	chr4	-	144917256	144940498	GYPB	23242	144937998	144942998
NM_002101	chr2	+	127413510	127454251	GYPC	40741	127411010	127416010
NM_198682	chr4	-	144792018	144826716	GYPE	34698	144824216	144829216
NR_027763	chr19	-	49471381	49496610	GYS1	25229	49494110	49499110
NM_021957	chr12	-	21689122	21757781	GYS2	68659	21755281	21760281
NM_001317012	chr20	+	23342768	23353698	GZF1	10930	23340268	23345268
NM_006144	chr5	+	54398473	54406080	GZMA	7607	54395973	54400973
NM_004131	chr14	-	25100160	25103475	GZMB	3315	25100975	25105975
NM_001270781	chr14	-	25075685	25078926	GZMH	3241	25076426	25081426
NM_002104	chr5	+	54320106	54329960	GZMK	9854	54317606	54322606
NM_001258351	chr19	+	544033	549920	GZMM	5887	541533	546533
NR_131224	chr11	-	2016405	2022696	H19	6291	2020196	2025196
NM_153833	chr3	+	129262056	129270310	H1FOO	8254	129259556	129264556
NR_026991	chr3	+	129035113	129043412	H1FX-AS1	8299	129032613	129037613
NR_027716	chr12	+	14927269	14930936	H2AFJ	3667	14924769	14929769
NM_138635	chr7	-	44866487	44887725	H2AFV	21238	44885225	44890225
NM_004893	chr5	-	134670070	134735577	H2AFY	65507	134733077	134738077
NM_018649	chr10	+	71812356	71872040	H2AFY2	59684	71809856	71814856
NM_001164416	chrX	+	103294515	103297021	H2BFM	2506	103292015	103297015
NM_001002916	chrX	-	103265718	103268259	H2BFWT	2541	103265759	103270759
NM_002107	chr1	+	226250407	226259703	H3F3A	9296	226247907	226252907
NR_002315	chr1	+	226250427	226259703	H3F3AP4	9276	226247927	226252927
NM_005324	chr17	-	73772514	73776016	H3F3B	3502	73773516	73778516
NM_004285	chr1	+	9294862	9331394	H6PD	36532	9292362	9297362
NM_012205	chr2	-	42994228	43019751	HAAO	25523	43017251	43022251
NM_001177660	chr10	+	115310589	115349360	HABP2	38771	115308089	115313089
NM_014282	chr9	+	99212436	99253618	HABP4	41182	99209936	99214936
NM_014241	chr10	-	17631957	17659373	HACD1	27416	17656873	17661873
NM_001329783	chr3	-	123210394	123304032	HACD2	93638	123301532	123306532
NM_016395	chr15	+	65822826	65870693	HACD3	47867	65820326	65825326
NM_001010915	chr9	-	21003622	21031674	HACD4	28052	21029174	21034174
NM_020771	chr6	-	105175967	105307794	HACE1	131827	105305294	105310294
NR_104315	chr3	-	15602210	15643359	HACL1	41149	15640859	15645859
NM_001184705	chr4	+	108910869	108956331	HADH	45462	108908369	108913369
NM_000182	chr2	-	26413503	26467594	HADHA	54091	26465094	26470094
NM_001281512	chr2	+	26467615	26513333	HADHB	45718	26465115	26470115
NM_005326	chr16	-	1859103	1877195	HAGH	18092	1874695	1879695
NM_001323636	chr16	+	776935	779715	HAGHL	2780	774435	779435
NR_033979	chr2	-	177037916	177053686	HAGLR	15770	177051186	177056186
NM_001258333	chr12	-	96366439	96390143	HAL	23704	96387643	96392643
NM_021175	chr19	+	35773248	35776045	HAMP	2797	35770748	35775748
NM_004821	chr5	-	153854531	153857824	HAND1	3293	153855324	153860324
NM_021973	chr4	-	174447651	174451378	HAND2	3727	174448878	174453878
NR_136196	chr4	+	174451521	174512406	HAND2-AS1	60885	174449021	174454021
NM_017545	chr20	-	7863630	7921093	HAO1	57463	7918593	7923593
NM_001005783	chr1	+	119911398	119936753	HAO2	25355	119908898	119913898
NM_177977	chr17	-	39878890	39890898	HAP1	12008	39888398	39893398
NM_001884	chr5	-	82934016	83016896	HAPLN1	82880	83014396	83019396
NM_021817	chr1	+	156589085	156595517	HAPLN2	6432	156586585	156591585
NM_001307952	chr15	-	89420515	89438857	HAPLN3	18342	89436357	89441357
NM_023002	chr19	-	19366451	19373596	HAPLN4	7145	19371096	19376096
NR_003244	chr20	+	61732643	61735737	HAR1A	3094	61730143	61735143
NR_003245	chr20	-	61726844	61733671	HAR1B	6827	61731171	61736171
NM_173811	chr11	-	46624855	46638777	HARBI1	13922	46636277	46641277
NM_001289092	chr5	-	140053488	140071312	HARS	17824	140068812	140073812
NM_001278731	chr5	+	140071010	140078903	HARS2	7893	140068510	140073510
NM_001523	chr19	-	52216364	52227245	HAS1	10881	52224745	52229745
NM_005328	chr8	-	122625270	122653630	HAS2	28360	122651130	122656130
NR_002835	chr8	+	122651585	122657564	HAS2-AS1	5979	122649085	122654085
NM_138612	chr16	+	69140128	69152619	HAS3	12491	69137628	69142628
NM_031965	chr17	+	3627196	3629992	HASPIN	2796	3624696	3629696
NR_027862	chr2	+	172778934	172848600	HAT1	69666	172776434	172781434
NR_026978	chr18	+	43684297	43708299	HAUS1	24002	43681797	43686797
NM_001323630	chr15	+	42841010	42862190	HAUS2	21180	42838510	42843510
NM_001303143	chr4	-	2233562	2243891	HAUS3	10329	2241391	2246391
NM_001166269	chr14	-	23415436	23426351	HAUS4	10915	23423851	23428851
NM_015302	chr19	+	36103645	36116251	HAUS5	12606	36101145	36106145
NM_017645	chr9	-	19053134	19102940	HAUS6	49806	19100440	19105440
NR_073156	chrX	-	152713122	152760983	HAUS7	47861	152758483	152763483
NM_001011699	chr19	-	17160570	17186343	HAUS8	25773	17183843	17188843
NM_001308156	chr5	-	156456423	156486130	HAVCR1	29707	156483630	156488630
NM_032782	chr5	-	156512842	156536248	HAVCR2	23406	156533748	156538748
NM_006118	chr1	+	154245038	154248355	HAX1	3317	154242538	154247538
NM_001945	chr5	-	139712427	139726188	HBEGF	13761	139723688	139728688
NM_001244262	chr7	+	106809405	106842974	HBP1	33569	106806905	106811905
NM_001145158	chr6	-	135281516	135376036	HBS1L	94520	135373536	135378536
NM_032554	chr12	-	123212152	123215129	HCAR1	2977	123212629	123217629
NM_001122608	chrX	+	11129405	11141204	HCCS	11799	11126905	11131905
NM_005334	chrX	-	153213007	153236819	HCFC1	23812	153234319	153239319
NM_013320	chr12	+	104458235	104500304	HCFC2	42069	104455735	104460735
NR_026790	chr6	+	26521933	26527612	HCG11	5679	26519433	26524433
NR_135289	chr6_apd_hap1	+	255927	259785	HCG15	3858	253427	258427
NR_052012	chr6_apd_hap1	-	1442003	1605540	HCG17	163537	1603040	1608040
NR_024053	chr6	-	30255173	30294933	HCG18	39760	30292433	30297433
NR_138037	chr6_dbb_hap3	+	2028383	2054115	HCG20	25732	2025883	2030883
NR_138040	chr6	-	30913755	30922639	HCG21	8884	30920139	30925139
NR_003948	chr6_apd_hap1	+	2335935	2342365	HCG22	6430	2333435	2338435
NR_044996	chr6_mcf_hap5	+	3737843	3741026	HCG23	3183	3735343	3740343
NR_138084	chr6_cox_hap2	+	4554914	4560424	HCG24	5510	4552414	4557414
NR_044997	chr6	+	33217312	33222667	HCG25	5355	33214812	33219812
NR_026791	chr6_mcf_hap5	+	2547502	2553759	HCG27	6257	2545002	2550002
NR_001317	chr6	-	29892368	29894992	HCG4B	2624	29892492	29897492
NR_028032	chr6_qbl_hap6	+	1235683	1238972	HCG9	3289	1233183	1238183
NM_001172133	chr20	+	30639990	30689657	HCK	49667	30637490	30642490
NM_005335	chr3	-	121350244	121379795	HCLS1	29551	121377295	121382295
NM_021072	chr5	-	45255051	45696220	HCN1	441169	45693720	45698720
NM_001194	chr19	+	589892	617159	HCN2	27267	587392	592392
NM_020897	chr1	+	155247217	155259639	HCN3	12422	155244717	155249717
NM_005477	chr15	-	73612199	73661605	HCN4	49406	73659105	73664105
NR_040662	chr6	+	31430956	31433586	HCP5	2630	31428456	31433456
NM_001525	chr1	+	32083300	32092919	HCRTR1	9619	32080800	32085800
NM_001526	chr6	+	54971257	55147538	HCRTR2	176281	54968757	54973757
NM_004964	chr1	+	32757707	32799224	HDAC1	41517	32755207	32760207
NM_001159286	chr22	-	50683612	50689834	HDAC10	6222	50687334	50692334
NM_001330636	chr3	+	13521664	13547918	HDAC11	26254	13519164	13524164
NR_046690	chr3	-	13518487	13521553	HDAC11-AS1	3066	13519053	13524053
NR_033441	chr6	-	114257319	114292359	HDAC2	35040	114289859	114294859
NR_125845	chr6	+	114290864	114661893	HDAC2-AS2	371029	114288364	114293364
NM_003883	chr5	-	141000442	141016423	HDAC3	15981	141013923	141018923
NM_006037	chr2	-	239969863	240322643	HDAC4	352780	240320143	240325143
NM_005474	chr17	-	42154120	42201014	HDAC5	46894	42198514	42203514
NM_001321225	chrX	+	48659783	48683392	HDAC6	23609	48657283	48662283
NM_001308090	chr12	-	48176493	48213763	HDAC7	37270	48211263	48216263
NM_001166418	chrX	-	71549365	71792953	HDAC8	243588	71790453	71795453
NM_001321868	chr7	+	18126564	19042037	HDAC9	915473	18124064	18129064
NM_001306146	chr15	-	50534145	50558162	HDC	24017	50555662	50560662
NM_016063	chr6	-	125596495	125623282	HDDC2	26787	125620782	125625782
NR_135008	chr1	-	156711898	156722240	HDGF	10342	156719740	156724740
NM_032631	chr19	+	4472192	4502232	HDGFL2	30040	4469692	4474692
NM_016073	chr15	-	83806803	83876770	HDGFL3	69967	83874270	83879270
NM_001318765	chr18	-	44633772	44676891	HDHD2	43119	44674391	44679391
NM_001304509	chr9	-	116135695	116139289	HDHD3	3594	116136789	116141789
NM_017829	chr22	-	17618409	17646177	HDHD5	27768	17643677	17648677
NR_024483	chr22	+	17640278	17646335	HDHD5-AS1	6057	17637778	17642778
NM_005336	chr2	-	242166678	242255257	HDLBP	88579	242252757	242257757
NM_001177479	chrX	-	83572881	83757487	HDX	184606	83754987	83759987
NM_018072	chr1	-	236712304	236767841	HEATR1	55537	236765341	236770341
NM_182922	chr16	+	50099851	50141183	HEATR3	41332	50097351	50102351
NM_203309	chr14	-	73945188	74025651	HEATR4	80463	74023151	74028151
NM_015473	chr14	-	31760993	31889788	HEATR5A	128795	31887288	31892288
NM_019024	chr2	-	37208143	37311488	HEATR5B	103345	37308988	37313988
NM_022070	chr17	-	58120551	58156292	HEATR6	35741	58153792	58158792
NM_001321395	chr17	-	34181949	34195895	HEATR9	13946	34193395	34198395
NM_015987	chr12	-	13127798	13153243	HEBP1	25445	13150743	13155743
NM_001326380	chr6	+	138724667	138734582	HEBP2	9915	138722167	138727167
NM_016217	chr6	+	139456248	139501946	HECA	45698	139453748	139458748
NM_015382	chr14	-	31569320	31676729	HECTD1	107409	31674229	31679229
NM_001348365	chr10	+	93168991	93274585	HECTD2	105594	93166491	93171491
NR_024467	chr10	-	93066718	93371217	HECTD2-AS1	304499	93368717	93373717
NM_024602	chr1	-	45468219	45477027	HECTD3	8808	45474527	45479527
NM_001109662	chr12	-	112597991	112819896	HECTD4	221905	112817396	112822396
NM_001287059	chr7	+	43152197	43602938	HECW1	450741	43149697	43154697
NR_135295	chr7	+	43157494	43202786	HECW1-IT1	45292	43154994	43159994
NM_001348768	chr2	-	197059093	197458416	HECW2	399323	197455916	197460916
NM_020733	chr3	-	124684553	124774802	HEG1	90249	124772302	124777302
NM_033647	chr12	+	66696324	66737423	HELB	41099	66693824	66698824
NM_001289068	chr10	+	96305523	96361856	HELLS	56333	96303023	96308023
NM_001297755	chr4	-	84328495	84377036	HELQ	48541	84374536	84379536
NM_001330447	chr17	-	65066553	65241320	HELZ	174767	65238820	65243820
NM_001037335	chr20	-	62189438	62205592	HELZ2	16154	62203092	62208092
NM_018437	chr9	-	100689072	100707197	HEMGN	18125	100704697	100709697
NM_016173	chr3	+	50606582	50622421	HEMK1	15839	50604082	50609082
NM_144584	chr1	-	109190909	109204148	HENMT1	13239	109201648	109206648
NM_152722	chr11	-	124789145	124806308	HEPACAM	17163	124803808	124808808
NM_001346642	chr7	-	92817851	92861511	HEPACAM2	43660	92859011	92864011
NM_138737	chrX	+	65382390	65487230	HEPH	104840	65379890	65384890
NM_001098672	chr11	+	93754377	93847374	HEPHL1	92997	93751877	93756877
NM_003922	chr15	-	63900816	64126147	HERC1	225331	64123647	64128647
NM_004667	chr15	-	28356182	28567298	HERC2	211116	28564798	28569798
NR_072991	chr15	+	31110238	31119986	HERC2P10	9748	31107738	31112738
NR_145479	chr15	-	28818925	28834386	HERC2P11	15461	28831886	28836886
NR_002824	chr15	-	23282264	23378259	HERC2P2	95995	23375759	23380759
NR_036432	chr15	-	20613649	20711433	HERC2P3	97784	20708933	20713933
NR_109773	chr16	-	32181363	32199434	HERC2P4	18071	32196934	32201934
NR_036470	chr15	+	23390721	23393943	HERC2P7	3222	23388221	23393221
NR_036443	chr15	+	28899587	28930410	HERC2P9	30823	28897087	28902087
NM_014606	chr4	+	89513573	89629693	HERC3	116120	89511073	89516073
NM_015601	chr10	-	69681655	69835103	HERC4	153448	69832603	69837603
NM_016323	chr4	+	89378267	89427319	HERC5	49052	89375767	89380767
NM_001165136	chr4	+	89299890	89364249	HERC6	64359	89297390	89302390
NM_001272103	chr16	+	56966001	56977793	HERPUD1	11792	56963501	56968501
NM_022373	chr7	-	35672269	35734772	HERPUD2	62503	35732272	35737272
NM_019089	chr1	-	6475293	6479979	HES2	4686	6477479	6482479
NM_032580	chr17	-	8023907	8027410	HES7	3503	8024910	8029910
NM_001318825	chr15	-	72635775	72668814	HEXA	33039	72666314	72671314
NR_027262	chr15	+	72668453	72671129	HEXA-AS1	2676	72665953	72670953
NM_001292004	chr5	+	73935847	74017113	HEXB	81266	73933347	73938347
NM_001330542	chr17	+	80376229	80400521	HEXDC	24292	80373729	80378729
NM_006460	chr17	+	43224683	43229468	HEXIM1	4785	43222183	43227183
NM_001303436	chr17	+	43237540	43247407	HEXIM2	9867	43235040	43240040
NM_001040708	chr8	-	80676244	80680098	HEY1	3854	80677598	80682598
NM_012259	chr6	+	126070731	126082415	HEY2	11684	126068231	126073231
NM_014571	chr1	-	40089102	40105348	HEYL	16246	40102848	40107848
NM_139008	chr6	+	26087508	26095469	HFE	7961	26085008	26090008
NM_213652	chr1	+	145413190	145417545	HFE2	4355	145410690	145415690
NM_001017975	chr1	-	91726322	91870426	HFM1	144104	91867926	91872926
NM_000187	chr3	-	120347014	120401418	HGD	54404	120398918	120403918
NM_000601	chr7	-	81328323	81399514	HGF	71191	81397014	81402014
NM_001528	chr4	+	3443659	3451222	HGFAC	7563	3441159	3446159
NM_016458	chr8	+	145192671	145195746	HGH1	3075	145190171	145195171
NM_004712	chr17	+	79650961	79669151	HGS	18190	79648461	79653461
NM_152419	chr8	+	42995591	43057970	HGSNAT	62379	42993091	42998091
NM_001170564	chr1	+	210501595	210849638	HHAT	348043	210499095	210504095
NM_020707	chr3	-	42734154	42744319	HHATL	10165	42741819	42746819
NR_146957	chr3	+	42744032	42748257	HHATL-AS1	4225	42741532	42746532
NM_002729	chr10	+	94449680	94455408	HHEX	5728	94447180	94452180
NM_022475	chr4	+	145567147	145659881	HHIP	92734	145564647	145569647
NR_037595	chr4	-	145564067	145567171	HHIP-AS1	3104	145564671	145569671
NM_001329411	chr14	+	100070833	100136675	HHIPL1	65842	100068333	100073333
NM_024746	chr1	-	222695601	222721444	HHIPL2	25843	222718944	222723944
NM_001145095	chr8	-	133073732	133117512	HHLA1	43780	133115012	133120012
NM_001282556	chr3	+	108015336	108097131	HHLA2	81795	108012836	108017836
NM_001031693	chr1	+	70820492	70833705	HHLA3	13213	70817992	70822992
NM_152740	chr7	-	27565058	27702620	HIBADH	137562	27700120	27705120
NM_198047	chr2	-	191069359	191184771	HIBCH	115412	191182271	191187271
NM_006497	chr17	+	1958392	1962981	HIC1	4589	1955892	1960892
NM_015094	chr22	+	21771692	21805750	HIC2	34058	21769192	21774192
NM_030630	chr17	-	72946838	72968900	HID1	22062	72966400	72971400
NR_110878	chr17	+	72966783	72971823	HID1-AS1	5040	72964283	72969283
NM_001530	chr14	+	62162118	62214977	HIF1A	52859	62159618	62164618
NR_047116	chr14	-	62147758	62162541	HIF1A-AS1	14783	62160041	62165041
NM_017902	chr10	+	102295640	102313681	HIF1AN	18041	102293140	102298140
NM_152795	chr19	+	46800302	46846690	HIF3A	46388	46797802	46802802
NM_001099669	chr3	-	42824399	42846027	HIGD1A	21628	42843527	42848527
NM_001271880	chr17	+	42923720	42927848	HIGD1B	4128	42921220	42926220
NM_001109619	chr12	+	51347781	51364289	HIGD1C	16508	51345281	51350281
NM_001350932	chr15	-	72968122	72978490	HIGD2B	10368	72975990	72980990
NM_016401	chr11	+	86013252	86056985	HIKESHI	43733	86010752	86015752
NM_013332	chr7	+	128095883	128098472	HILPDA	2589	128093383	128098383
NM_198971	chr11	+	118992232	119005765	HINFP	13533	118989732	118994732
NR_134494	chr5	-	130494975	130501041	HINT1	6066	130498541	130503541
NM_138571	chr6	+	126277860	126301389	HINT3	23529	126275360	126280360
NM_001243198	chr7	-	75162618	75368290	HIP1	205672	75365790	75370790
NM_003959	chr12	+	123319984	123347507	HIP1R	27523	123317484	123322484
NM_198268	chr1	+	114471995	114520491	HIPK1	48496	114469495	114474495
NR_110726	chr1	-	114466622	114472147	HIPK1-AS1	5525	114469647	114474647
NM_022740	chr7	-	139246315	139477693	HIPK2	231378	139475193	139480193
NM_001278163	chr11	+	33278217	33378568	HIPK3	100351	33275717	33280717
NM_144685	chr19	-	40885177	40896128	HIPK4	10951	40893628	40898628
NM_003325	chr22	-	19318223	19419219	HIRA	100996	19416719	19421719
NM_001197323	chr16	-	30003641	30007417	HIRIP3	3776	30004917	30009917
NM_138720	chr6	+	26158348	26171576	HIST1H2BD	13228	26155848	26160848
NM_080593	chr6	-	27106071	27114637	HIST1H2BK	8566	27112137	27117137
NM_003530	chr6	-	26197011	26199521	HIST1H3D	2510	26197021	26202021
NR_027337	chr1	+	120906033	120914842	HIST2H2BA	8809	120903533	120908533
NM_001161334	chr1	-	149754244	149783928	HIST2H2BF	29684	149781428	149786428
NM_002114	chr6	+	12012723	12165232	HIVEP1	152509	12010223	12015223
NM_006734	chr6	-	143072603	143266338	HIVEP2	193735	143263838	143268838
NM_024503	chr1	-	41972035	42384378	HIVEP3	412343	42381878	42386878
NM_001282962	chr2	-	234745346	234763212	HJURP	17866	234760712	234765712
NM_001322365	chr10	+	71029755	71161637	HK1	131882	71027255	71032255
NM_000189	chr2	+	75059781	75120481	HK2	60700	75057281	75062281
NM_002115	chr5	-	176307869	176326333	HK3	18464	176323833	176328833
NM_025130	chr10	+	70980058	71027315	HKDC1	47257	70977558	70982558
NR_138103	chr19	+	37803738	37855358	HKR1	51620	37801238	37806238
NM_002116	chr6_mcf_hap5	+	1150097	1295564	HLA-A	145467	1147597	1152597
NM_005514	chr6_mcf_hap5	-	2701422	2704815	HLA-B	3393	2702315	2707315
NM_002117	chr6	-	31236525	31239913	HLA-C	3388	31237413	31242413
NM_006120	chr6_apd_hap1	-	4203376	4207888	HLA-DMA	4512	4205388	4210388
NM_002118	chr6	-	32902405	32908847	HLA-DMB	6442	32906347	32911347
NM_002119	chr6_mcf_hap5	-	4308821	4314252	HLA-DOA	5431	4311752	4316752
NM_002120	chr6	-	32780539	32784825	HLA-DOB	4286	32782325	32787325
NM_001242525	chr6_qbl_hap6	-	4264796	4281012	HLA-DPA1	16216	4278512	4283512
NM_002121	chr6_mann_hap4	+	4501242	4515019	HLA-DPB1	13777	4498742	4503742
NR_001435	chr6_dbb_hap3	+	4325157	4378196	HLA-DPB2	53039	4322657	4327657
NM_002122	chr6	+	32605182	32611429	HLA-DQA1	6247	32602682	32607682
NM_020056	chr6_qbl_hap6	+	3941245	3946758	HLA-DQA2	5513	3938745	3943745
NM_001243962	chr6_cox_hap2	-	4072510	4080111	HLA-DQB1	7601	4077611	4082611
NM_001300790	chr6_dbb_hap3	-	4006438	4013897	HLA-DQB2	7459	4011397	4016397
NM_019111	chr6_mann_hap4	+	3749678	3754894	HLA-DRA	5216	3747178	3752178
NM_001243965	chr6_ssto_hap7	-	3850433	3993164	HLA-DRB1	142731	3990664	3995664
NM_022555	chr6_cox_hap2	-	3934126	3947195	HLA-DRB3	13069	3944695	3949695
NM_021983	chr6_mcf_hap5	-	3882323	3897292	HLA-DRB4	14969	3894792	3899792
NM_002125	chr6	-	32485153	32498006	HLA-DRB5	12853	32495506	32500506
NR_001298	chr6	-	32520489	32527779	HLA-DRB6	7290	32525279	32530279
NM_005516	chr6	+	30457182	30461982	HLA-E	4800	30454682	30459682
NM_001098478	chr6_mcf_hap5	+	991650	1359214	HLA-F	367564	989150	994150
NR_026972	chr6_qbl_hap6	-	995238	1017689	HLA-F-AS1	22451	1015189	1020189
NM_002127	chr6_cox_hap2	+	1310646	1314804	HLA-G	4158	1308146	1313146
NR_001434	chr6	+	29855349	29858856	HLA-H	3507	29852849	29857849
NR_024240	chr6	+	29973747	29977733	HLA-J	3986	29971247	29976247
NR_027822	chr6	+	30227338	30234728	HLA-L	7390	30224838	30229838
NM_000411	chr21	-	38120925	38362694	HLCS	241769	38360194	38365194
NM_002126	chr17	+	53342320	53402426	HLF	60106	53339820	53344820
NM_001318935	chr3	-	148747850	148804341	HLTF	56491	148801841	148806841
NR_046648	chr3	+	148804118	148820610	HLTF-AS1	16492	148801618	148806618
NM_021958	chr1	+	221052742	221058400	HLX	5658	221050242	221055242
NR_046901	chr1	-	221006104	221053482	HLX-AS1	47378	221050982	221055982
NM_178580	chr20	+	30102212	30157370	HM13	55158	30099712	30104712
NR_046853	chr20	-	30155389	30161066	HM13-AS1	5677	30158566	30163566
NM_001324393	chr8	+	28747886	28910787	HMBOX1	162901	28745386	28750386
NM_001258208	chr11	+	118955586	118964259	HMBS	8673	118953086	118958086
NM_020187	chr3	+	128997683	129024135	HMCES	26452	128995183	129000183
NM_031935	chr1	+	185703682	186160085	HMCN1	456403	185701182	185706182
NM_001291815	chr9	+	133028157	133309510	HMCN2	281353	133025657	133030657
NM_001304505	chr15	+	77712992	77777946	HMG20A	64954	77710492	77715492
NM_006339	chr19	+	3572942	3579081	HMG20B	6139	3570442	3575442
NM_001319081	chr6	+	34204576	34214008	HMGA1	9432	34202076	34207076
NR_037938	chr6	-	134435110	134438818	HMGA1P7	3708	134436318	134441318
NM_003483	chr12	+	66218239	66360071	HMGA2	141832	66215739	66220739
NM_001313893	chr13	-	31032052	31191734	HMGB1	159682	31189234	31194234
NM_002129	chr4	-	174252526	174255595	HMGB2	3069	174253095	174258095
NM_001301231	chrX	+	150148980	150159248	HMGB3	10268	150146480	150151480
NM_145205	chr1	+	34326075	34330392	HMGB4	4317	34323575	34328575
NM_001166059	chr1	-	24128366	24151949	HMGCL	23583	24149449	24154449
NM_001287753	chr6	-	55299170	55444012	HMGCLL1	144842	55441512	55446512
NM_000859	chr5	+	74632992	74657926	HMGCR	24934	74630492	74635492
NM_002130	chr5	-	43287571	43313614	HMGCS1	26043	43311114	43316114
NM_005518	chr1	-	120290618	120311555	HMGCS2	20937	120309055	120314055
NM_004965	chr21	-	40714240	40721047	HMGN1	6807	40718547	40723547
NM_005517	chr1	+	26798901	26803133	HMGN2	4232	26796401	26801401
NR_022014	chr15	+	45803333	45848928	HMGN2P46	45595	45800833	45805833
NM_001318888	chr6	-	79910961	79944455	HMGN3	33494	79941955	79946955
NR_040671	chr6	+	79943390	79946517	HMGN3-AS1	3127	79940890	79945890
NM_006353	chr6	+	26538571	26547164	HMGN4	8593	26536071	26541071
NM_030763	chrX	-	80369199	80457441	HMGN5	88242	80454941	80459941
NM_014983	chr5	+	149380168	149432706	HMGXB3	52538	149377668	149382668
NR_027780	chr22	+	35653444	35691800	HMGXB4	38356	35650944	35655944
NM_021182	chr5	+	143191725	143200284	HMHB1	8559	143189225	143194225
NM_012485	chr5	+	162887516	162918953	HMMR	31437	162885016	162890016
NR_109892	chr5	-	162909609	162921064	HMMR-AS1	11455	162918564	162923564
NM_002133	chr22	+	35777059	35790207	HMOX1	13148	35774559	35779559
NM_001127206	chr16	+	4524703	4560348	HMOX2	35645	4522203	4527203
NM_001123366	chr18	+	61616587	61627645	HMSD	11058	61614087	61619087
NM_001306142	chr4	-	8847801	8873543	HMX1	25742	8871043	8876043
NM_005519	chr10	+	124907637	124910188	HMX2	2551	124905137	124910137
NM_001306179	chr12	+	121416370	121440314	HNF1A	23944	121413870	121418870
NM_000458	chr17	-	36046433	36105069	HNF1B	58636	36102569	36107569
NM_001287182	chr20	+	42984440	43061485	HNF4A	77045	42981940	42986940
NR_109949	chr20	-	43006382	43024346	HNF4A-AS1	17964	43021846	43026846
NM_001330561	chr8	+	76319904	76479077	HNF4G	159173	76317404	76322404
NM_006895	chr2	+	138721807	138773934	HNMT	52127	138719307	138724307
NM_006805	chr5	-	137087072	137090039	HNRNPA0	2967	137087539	137092539
NR_135167	chr12	+	54674473	54680872	HNRNPA1	6399	54671973	54676973
NM_001011724	chr13	+	53191604	53217919	HNRNPA1L2	26315	53189104	53194104
NR_002944	chr12	+	54674532	54678663	HNRNPA1P10	4131	54672032	54677032
NM_031243	chr7	-	26229555	26240413	HNRNPA2B1	10858	26237913	26242913
NM_001330248	chr2	+	178077421	178088687	HNRNPA3	11266	178074921	178079921
NR_002726	chr10	-	44282859	44285865	HNRNPA3P1	3006	44283365	44288365
NM_004499	chr5	+	177631507	177638184	HNRNPAB	6677	177629007	177634007
NM_031314	chr14	-	21677295	21737638	HNRNPC	60343	21735138	21740138
NM_031369	chr4	-	83274466	83295149	HNRNPD	20683	83292649	83297649
NR_003249	chr4	-	83343716	83351378	HNRNPDL	7662	83348878	83353878
NM_001098204	chr10	-	43881064	43904696	HNRNPF	23632	43902196	43907196
NM_005520	chr5	-	179041178	179050722	HNRNPH1	9544	179048222	179053222
NM_019597	chrX	+	100663120	100669128	HNRNPH2	6008	100660620	100665620
NM_001322445	chr10	+	70091449	70102953	HNRNPH3	11504	70088949	70093949
NM_031262	chr9	-	86582997	86595697	HNRNPK	12700	86593197	86598197
NR_033868	chr11	-	43283053	43290919	HNRNPKP3	7866	43288419	43293419
NM_001005335	chr19	-	39327027	39342979	HNRNPL	15952	39340479	39345479
NM_138394	chr2	-	38790327	38830178	HNRNPLL	39851	38827678	38832678
NM_001297418	chr19	+	8509711	8554002	HNRNPM	44291	8507211	8512211
NM_005826	chr1	-	23631180	23670857	HNRNPR	39677	23668357	23673357
NM_004501	chr1	-	245013601	245027827	HNRNPU	14226	245025327	245030327
NM_144732	chr19	+	41768380	41813688	HNRNPUL1	45308	41765880	41770880
NM_001079559	chr11	-	62480096	62494857	HNRNPUL2	14761	62492357	62497357
NR_037946	chr11	-	62457733	62494856	HNRNPUL2-BSCL2	37123	62492356	62497356
NM_138413	chr10	+	99344101	99372555	HOGA1	28454	99341601	99346601
NM_001277077	chr5	-	78669646	78809659	HOMER1	140013	78807159	78812159
NM_199330	chr15	-	83517728	83621476	HOMER2	103748	83618976	83623976
NM_004838	chr19	-	19040009	19052041	HOMER3	12032	19049541	19054541
NM_020834	chr14	-	23742843	23755309	HOMEZ	12466	23752809	23757809
NM_015888	chr1	+	60280532	60342050	HOOK1	61518	60278032	60283032
NM_001100176	chr19	-	12873816	12886434	HOOK2	12618	12883934	12888934
NM_032410	chr8	+	42752032	42885682	HOOK3	133650	42749532	42754532
NM_032495	chr4	-	57514153	57547872	HOPX	33719	57545372	57550372
NM_001199829	chr1	-	150670534	150693364	HORMAD1	22830	150690864	150695864
NM_001329457	chr22	+	30476057	30573064	HORMAD2	97007	30473557	30478557
NR_110541	chr22	-	30404730	30476469	HORMAD2-AS1	71739	30473969	30478969
NR_047517	chr12	-	54356091	54368740	HOTAIR	12649	54366240	54371240
NR_038366	chr7	+	27135712	27139877	HOTAIRM1	4165	27133212	27138212
NM_001293171	chr11	+	2013637	2017524	HOTS	3887	2011137	2016137
NR_037843	chr7	+	27240039	27246878	HOTTIP	6839	27237539	27242539
NR_122069	chr7	+	27161537	27168379	HOXA-AS2	6842	27159037	27164037
NR_038832	chr7	+	27179982	27195547	HOXA-AS3	15565	27177482	27182482
NM_153620	chr7	-	27132613	27135625	HOXA1	3012	27133125	27138125
NR_037939	chr7	-	27210209	27219880	HOXA10	9671	27217380	27222380
NR_046609	chr7	+	27208517	27211534	HOXA10-AS	3017	27206017	27211017
NR_037940	chr7	-	27202056	27219880	HOXA10-HOXA9	17824	27217380	27222380
NM_005523	chr7	-	27220775	27224835	HOXA11	4060	27222335	27227335
NR_002795	chr7	+	27225026	27228912	HOXA11-AS	3886	27222526	27227526
NM_000522	chr7	-	27236498	27239725	HOXA13	3227	27237225	27242225
NM_153631	chr7	-	27145808	27166639	HOXA3	20831	27164139	27169139
NM_019102	chr7	-	27180670	27183287	HOXA5	2617	27180787	27185787
NM_006896	chr7	-	27193337	27196296	HOXA7	2959	27193796	27198796
NM_152739	chr7	-	27202056	27205149	HOXA9	3093	27202649	27207649
NR_102279	chr17	+	46621712	46628603	HOXB-AS1	6891	46619212	46624212
NR_033201	chr17	+	46667781	46683774	HOXB-AS3	15993	46665281	46670281
NM_006361	chr17	-	46802126	46806111	HOXB13	3985	46803611	46808611
NM_001330322	chr17	-	46626231	46659984	HOXB3	33753	46657484	46662484
NM_024015	chr17	-	46652868	46655743	HOXB4	2875	46653243	46658243
NM_018952	chr17	-	46673098	46682334	HOXB6	9236	46679834	46684834
NM_004502	chr17	-	46684594	46688383	HOXB7	3789	46685883	46690883
NM_024016	chr17	-	46689707	46692301	HOXB8	2594	46689801	46694801
NM_024017	chr17	-	46698518	46703835	HOXB9	5317	46701335	46706335
NM_017409	chr12	+	54378945	54384062	HOXC10	5117	54376445	54381445
NM_014212	chr12	+	54366909	54370203	HOXC11	3294	54364409	54369409
NM_017410	chr12	+	54332575	54340328	HOXC13	7753	54330075	54335075
NR_047507	chr12	-	54329111	54333427	HOXC13-AS	4316	54330927	54335927
NM_014620	chr12	+	54410635	54449814	HOXC4	39179	54408135	54413135
NR_003084	chr12	+	54410635	54429144	HOXC5	18509	54408135	54413135
NM_153693	chr12	+	54410635	54424607	HOXC6	13972	54408135	54413135
NM_022658	chr12	+	54402889	54406545	HOXC8	3656	54400389	54405389
NM_006897	chr12	+	54393902	54397120	HOXC9	3218	54391402	54396402
NM_002148	chr2	+	176981491	176984670	HOXD10	3179	176978991	176983991
NM_000523	chr2	+	176957531	176960666	HOXD13	3135	176955031	176960031
NM_006898	chr2	+	177028804	177037826	HOXD3	9022	177026304	177031304
NM_001199747	chr2	+	176994421	176997423	HOXD8	3002	176991921	176996921
NM_005143	chr16	+	72088490	72094955	HP	6465	72085990	72090990
NR_110821	chr3	-	99535475	99542709	HP09053	7234	99540209	99545209
NM_016287	chr1	-	21069170	21113181	HP1BP3	44011	21110681	21115681
NM_002143	chr1	+	33352097	33360247	HPCA	8150	33349597	33354597
NM_002149	chr2	+	10443029	10567743	HPCAL1	124714	10440529	10445529
NM_016257	chr1	-	40144319	40157382	HPCAL4	13063	40154882	40159882
NM_001171993	chr12	-	122277432	122326517	HPD	49085	122324017	122329017
NM_017867	chr4	-	170650618	170679093	HPF1	28475	170676593	170681593
NM_001256306	chr4	-	175411327	175444049	HPGD	32722	175441549	175446549
NM_014485	chr4	-	95219706	95264027	HPGDS	44321	95261527	95266527
NM_002151	chr19	+	35531409	35557477	HPN	26068	35528909	35533909
NR_024562	chr19	-	35549962	35597208	HPN-AS1	47246	35594708	35599708
NM_020995	chr16	+	72097124	72111145	HPR	14021	72094624	72099624
NM_000194	chrX	+	133594174	133634698	HPRT1	40524	133591674	133596674
NM_001322483	chr10	-	100175954	100206720	HPS1	30766	100204220	100209220
NM_032383	chr3	+	148847370	148890983	HPS3	43613	148844870	148849870
NM_001349905	chr22	-	26839074	26879829	HPS4	40755	26877329	26882329
NM_181507	chr11	-	18300216	18343721	HPS5	43505	18341221	18346221
NM_024747	chr10	+	103825123	103827795	HPS6	2672	103822623	103827623
NM_006665	chr4	-	84213613	84256306	HPSE	42693	84253806	84258806
NM_001166246	chr10	-	100216833	100995632	HPSE2	778799	100993132	100998132
NM_000613	chr11	-	6452267	6462254	HPX	9987	6459754	6464754
NM_018411	chr8	-	21971931	21988565	HR	16634	21986065	21991065
NM_001130442	chr11	-	532241	535567	HRAS	3326	533067	538067
NM_020386	chr3	+	192958916	192988644	HRASLS	29728	192956416	192961416
NM_017878	chr11	-	63320241	63330855	HRASLS2	10614	63328355	63333355
NM_054108	chr11	-	63228875	63258680	HRASLS5	29805	63256180	63261180
NR_110844	chr6	+	123760748	123792901	HRAT13	32153	123758248	123763248
NR_110162	chr7	-	112594689	112635698	HRAT17	41009	112633198	112638198
NR_033963	chr7	+	560027	564869	HRAT92	4842	557527	562527
NM_002152	chr19	-	49654455	49658681	HRC	4226	49656181	49661181
NM_000412	chr3	+	186383740	186396029	HRG	12289	186381240	186386240
NM_001098213	chr3	+	11178778	11304939	HRH1	126161	11176278	11181278
NM_001131055	chr5	+	175085039	175113245	HRH2	28206	175082539	175087539
NM_007232	chr20	-	60790016	60795323	HRH3	5307	60792823	60797823
NM_001143828	chr18	+	22040592	22059921	HRH4	19329	22038092	22043092
NM_003806	chr12	-	117293948	117319232	HRK	25284	117316732	117321732
NM_001009931	chr1	-	152184551	152196672	HRNR	12121	152194172	152199172
NM_022460	chr2	-	20817563	20850864	HS1BP3	33301	20848364	20853364
NM_012262	chr1	+	87380334	87575681	HS2ST1	195347	87377834	87382834
NM_005114	chr4	-	11399987	11430537	HS3ST1	30550	11428037	11433037
NM_006043	chr16	+	22825859	22927659	HS3ST2	101800	22823359	22828359
NM_006042	chr17	-	13397348	13505259	HS3ST3A1	107911	13502759	13507759
NM_006041	chr17	+	14204366	14252721	HS3ST3B1	48355	14201866	14206866
NM_006040	chr16	+	25703346	26149009	HS3ST4	445663	25700846	25705846
NM_153612	chr6	-	114376749	114384041	HS3ST5	7292	114381541	114386541
NM_001009606	chr16	-	1961464	1968324	HS3ST6	6860	1965824	1970824
NM_004807	chr2	-	129023053	129076171	HS6ST1	53118	129073671	129078671
NM_147175	chrX	-	131760037	132095423	HS6ST2	335386	132092923	132097923
NM_153456	chr13	+	96743092	97491816	HS6ST3	748724	96740592	96745592
NM_001537	chr16	+	83841507	83846607	HSBP1	5100	83839007	83844007
NM_001136180	chr18	+	77724581	77730822	HSBP1L1	6241	77722081	77727081
NM_172002	chr22	+	29138019	29153506	HSCB	15487	29135519	29140519
NM_001206741	chr1	+	209859524	209908295	HSD11B1	48771	209857024	209862024
NM_198707	chr19	+	5680775	5688534	HSD11B1L	7759	5678275	5683275
NM_000196	chr16	+	67465035	67471454	HSD11B2	6419	67462535	67467535
NM_000413	chr17	+	40704575	40707232	HSD17B1	2657	40702075	40707075
NM_004493	chrX	-	53458205	53461323	HSD17B10	3118	53458823	53463823
NM_016245	chr4	-	88257676	88312455	HSD17B11	54779	88309955	88314955
NM_016142	chr11	+	43702142	43878169	HSD17B12	176027	43699642	43704642
NM_178135	chr4	-	88224940	88244058	HSD17B13	19118	88241558	88246558
NM_016246	chr19	-	49316273	49339934	HSD17B14	23661	49337434	49342434
NM_002153	chr16	+	82068857	82132139	HSD17B2	63282	82066357	82071357
NM_000197	chr9	-	98997588	99064434	HSD17B3	66846	99061934	99066934
NR_146524	chr9	+	99008744	99012543	HSD17B3-AS1	3799	99006244	99011244
NM_001199292	chr5	+	118788137	118878030	HSD17B4	89893	118785637	118790637
NM_003725	chr12	+	57157001	57181574	HSD17B6	24573	57154501	57159501
NM_016371	chr1	+	162760491	162782608	HSD17B7	22117	162757991	162762991
NR_003086	chr10	+	38645307	38667433	HSD17B7P2	22126	38642807	38647807
NM_001328615	chr1	+	120049825	120057681	HSD3B1	7856	120047325	120052325
NM_001166120	chr1	+	119957553	119965662	HSD3B2	8109	119955053	119960053
NM_001142777	chr16	+	30996518	31000473	HSD3B7	3955	30994018	30999018
NR_033781	chr1	+	120106502	120115199	HSD3BP4	8697	120104002	120109002
NR_027120	chr1	-	59597607	59612479	HSD52	14872	59609979	59614979
NM_031463	chr16	-	84155743	84178800	HSDL1	23057	84176300	84181300
NM_001195822	chr9	+	115142188	115234685	HSDL2	92497	115139688	115144688
NM_005526	chr8	+	145515250	145538389	HSF1	23139	145512750	145517750
NM_001135564	chr6	+	122720695	122754264	HSF2	33569	122718195	122723195
NM_007031	chr21	-	44949071	45079374	HSF2BP	130303	45076874	45081874
NM_001538	chr16	+	67197287	67203848	HSF4	6561	67194787	67199787
NM_001080439	chr17	-	56497527	56565762	HSF5	68235	56563262	56568262
NM_016153	chrX	-	148674182	148676974	HSFX1	2792	148674474	148679474
NM_001164415	chrX	-	148674171	148676970	HSFX2	2799	148674470	148679470
NR_003510	chrY	-	20893325	20935601	HSFY1	42276	20933101	20938101
NR_003509	chrY	-	20893325	20935621	HSFY2	42296	20933121	20938121
NM_032855	chr19	+	16244837	16269384	HSH2D	24547	16242337	16247337
NM_001017963	chr14	-	102547074	102606086	HSP90AA1	59012	102603586	102608586
NM_001271970	chr6	+	44213902	44221625	HSP90AB1	7723	44211402	44216402
NR_073415	chr15	-	58982671	58985806	HSP90AB4P	3135	58983306	58988306
NM_003299	chr12	+	104324111	104341708	HSP90B1	17597	104321611	104326611
NR_073383	chr15	+	99797729	99800481	HSP90B2P	2752	99795229	99800229
NM_001330164	chr10	-	118430702	118609288	HSPA12A	178586	118606788	118611788
NM_001197327	chr20	+	3713316	3733758	HSPA12B	20442	3710816	3715816
NM_006948	chr21	-	15743436	15755509	HSPA13	12073	15753009	15758009
NM_016299	chr10	+	14880158	14913740	HSPA14	33582	14877658	14882658
NM_005346	chr6_qbl_hap6	+	3089162	3091686	HSPA1B	2524	3086662	3091662
NM_005527	chr6	-	31777395	31782835	HSPA1L	5440	31780335	31785335
NM_021979	chr14	+	65007185	65009954	HSPA2	2769	65004685	65009685
NM_002154	chr5	+	132387661	132440709	HSPA4	53048	132385161	132390161
NM_001317381	chr4	+	128702975	128755228	HSPA4L	52253	128700475	128705475
NM_005347	chr9	-	127997126	128003666	HSPA5	6540	128001166	128006166
NM_153201	chr11	-	122928199	122933043	HSPA8	4844	122930543	122935543
NM_004134	chr5	-	137890570	137911318	HSPA9	20748	137908818	137913818
NM_001316935	chr1	-	54387233	54411981	HSPB11	24748	54409481	54414481
NR_037651	chr11	+	111783459	111797595	HSPB2-C11orf52	14136	111780959	111785959
NM_001349682	chr1	-	16340522	16346089	HSPB7	5567	16343589	16348589
NM_014365	chr12	+	119616594	119632551	HSPB8	15957	119614094	119619094
NM_001320728	chr3	-	122458843	122512674	HSPBAP1	53831	122510174	122515174
NM_012267	chr19	-	55773590	55791751	HSPBP1	18161	55789251	55794251
NR_135132	chr9	-	139543061	139554873	HSPC324	11812	139552373	139557373
NM_199440	chr2	-	198351307	198364998	HSPD1	13691	198362498	198367498
NM_002157	chr2	+	198364720	198368187	HSPE1	3467	198362220	198367220
NM_001202485	chr2	+	198364720	198418423	HSPE1-MOB4	53703	198362220	198367220
NM_001291860	chr1	-	22148724	22263790	HSPG2	115066	22261290	22266290
NM_001286505	chr13	-	31709110	31736525	HSPH1	27415	31734025	31739025
NM_006410	chr11	+	20385230	20405329	HTATIP2	20099	20382730	20387730
NM_001163280	chrX	+	135579237	135594503	HTATSF1	15266	135576737	135581737
NR_033884	chr6	-	3020389	3025005	HTATSF1P2	4616	3022505	3027505
NM_001348715	chr3	+	58291971	58305920	HTD2	13949	58289471	58294471
NM_002159	chr4	+	70916131	70924565	HTN1	8434	70913631	70918631
NM_000200	chr4	+	70894129	70902255	HTN3	8126	70891629	70896629
NM_000863	chr6	-	78170564	78173739	HTR1B	3175	78171239	78176239
NM_000864	chr1	-	23518387	23521222	HTR1D	2835	23518722	23523722
NM_000865	chr6	+	87647023	87726397	HTR1E	79374	87644523	87649523
NM_001322209	chr3	+	87841916	88042981	HTR1F	201065	87839416	87844416
NM_000621	chr13	-	47405676	47471211	HTR2A	65535	47468711	47473711
NR_103752	chr13	+	47426274	47430434	HTR2A-AS1	4160	47423774	47428774
NM_001320758	chr2	-	231972946	231989824	HTR2B	16878	231987324	231992324
NM_001256761	chrX	+	113818550	114144624	HTR2C	326074	113816050	113821050
NM_000869	chr11	+	113845796	113861034	HTR3A	15238	113843296	113848296
NM_006028	chr11	+	113775517	113817283	HTR3B	41766	113773017	113778017
NM_130770	chr3	+	183770834	183778461	HTR3C	7627	183768334	183773334
NM_182537	chr3	+	183749331	183757157	HTR3D	7826	183746831	183751831
NM_001256613	chr3	+	183814851	183824783	HTR3E	9932	183812351	183817351
NR_133658	chr3	-	183812905	183822966	HTR3E-AS1	10061	183820466	183825466
NM_199453	chr5	-	147830594	148016624	HTR4	186030	148014124	148019124
NM_024012	chr7	+	154862033	154879102	HTR5A	17069	154859533	154864533
NR_038945	chr7	-	154858778	154863267	HTR5A-AS1	4489	154860767	154865767
NM_000871	chr1	+	19991779	20007459	HTR6	15680	19989279	19994279
NM_019860	chr10	-	92500575	92617671	HTR7	117096	92615171	92620171
NR_002774	chr12	+	13153375	13157764	HTR7P1	4389	13150875	13155875
NM_002775	chr10	+	124221040	124274424	HTRA1	53384	124218540	124223540
NR_135770	chr2	+	74756531	74760683	HTRA2	4152	74754031	74759031
NM_053044	chr4	+	8271491	8308838	HTRA3	37347	8268991	8273991
NM_153692	chr8	+	38831667	38846181	HTRA4	14514	38829167	38834167
NM_002111	chr4	+	3076407	3245687	HTT	169280	3073907	3078907
NR_045414	chr4	-	3064972	3076241	HTT-AS	11269	3073741	3078741
NM_014586	chr21	+	33245627	33376377	HUNK	130750	33243127	33248127
NM_004507	chr7	-	48002884	48019222	HUS1	16338	48016722	48021722
NM_031407	chrX	-	53559056	53713674	HUWE1	154618	53711174	53716174
NM_001256413	chr12	-	111086490	111127617	HVCN1	41127	111125117	111130117
NM_153281	chr3	-	50337319	50349812	HYAL1	12493	50347312	50352312
NM_033158	chr3	-	50355220	50360281	HYAL2	5061	50357781	50362781
NM_003549	chr3	-	50330258	50336899	HYAL3	6641	50334399	50339399
NM_012269	chr7	+	123485222	123517531	HYAL4	32309	123482722	123487722
NR_002731	chr7	+	123454192	123459484	HYALP1	5292	123451692	123456692
NM_001270974	chr16	-	70835986	71264625	HYDIN	428639	71262125	71267125
NR_103556	chr1_gl000192_random	-	132568	468683	HYDIN2	336115	466183	471183
NM_031207	chr1	-	43916673	43919660	HYI	2987	43917160	43922160
NM_001083612	chr15	+	78799905	78829715	HYKK	29810	78797405	78802405
NM_145014	chr11	+	125753508	125770541	HYLS1	17033	125751008	125756008
NR_002768	chr6	-	144326052	144329867	HYMAI	3815	144327367	144332367
NM_006389	chr11	-	118914895	118927957	HYOU1	13062	118925457	118930457
NM_001320863	chr2	+	9614657	9628753	IAH1	14096	9612157	9617157
NM_001329201	chr12	+	21507893	21532914	IAPP	25021	21505393	21510393
NR_073446	chr9	-	94972489	95056038	IARS	83549	95053538	95058538
NM_018060	chr1	+	220267454	220321383	IARS2	53929	220264954	220269954
NM_001010867	chr1	+	228353508	228369958	IBA57	16450	228351008	228356008
NM_004967	chr4	+	88720701	88733601	IBSP	12900	88718201	88723201
NM_015525	chr6	-	82879703	82957471	IBTK	77768	82954971	82959971
NM_004968	chr7	-	8152814	8302242	ICA1	149428	8299742	8304742
NM_001288622	chr2	-	203637872	203736708	ICA1L	98836	203734208	203739208
NM_000201	chr19	+	10381516	10397291	ICAM1	15775	10379016	10384016
NM_001099788	chr17	-	62079954	62097994	ICAM2	18040	62095494	62100494
NM_001320606	chr19	-	10444451	10450510	ICAM3	6059	10448010	10453010
NM_003259	chr19	+	10400654	10407454	ICAM5	6800	10398154	10403154
NM_015325	chr5	+	5422785	5490347	ICE1	67562	5420285	5425285
NM_001018089	chr15	-	60711807	60771359	ICE2	59552	60768859	60773859
NM_014920	chr6	-	52866097	52926600	ICK	60503	52924100	52929100
NM_012405	chr1	-	6281252	6296044	ICMT	14792	6293544	6298544
NM_012092	chr2	+	204801470	204826298	ICOS	24828	204798970	204803970
NM_001283050	chr21	-	45642877	45660887	ICOSLG	18010	45658387	45663387
NR_110154	chr2	-	8811113	8821993	ID2-AS1	10880	8819493	8824493
NM_001546	chr6	+	19837600	19842431	ID4	4831	19835100	19840100
NM_001322793	chr10	-	94211440	94333852	IDE	122412	94331352	94336352
NM_005896	chr2	-	209100950	209119867	IDH1	18917	209117367	209122367
NM_002168	chr15	-	90627210	90645786	IDH2	18576	90643286	90648286
NM_005530	chr15	+	78441718	78462884	IDH3A	21166	78439218	78444218
NM_174855	chr20	-	2639035	2644869	IDH3B	5834	2642369	2647369
NM_174869	chrX	-	153051220	153059978	IDH3G	8758	153057478	153062478
NM_001317955	chr10	-	1085359	1102656	IDI1	17297	1100156	1105156
NM_033261	chr10	-	1064846	1071799	IDI2	6953	1069299	1074299
NR_027709	chr10	+	1068576	1090141	IDI2-AS1	21565	1066076	1071076
NM_001256915	chr9	+	86237963	86259045	IDNK	21082	86235463	86240463
NM_002164	chr8	+	39771327	39786309	IDO1	14982	39768827	39773827
NM_194294	chr8	+	39792473	39873910	IDO2	81437	39789973	39794973
NM_000202	chrX	-	148558520	148586884	IDS	28364	148584384	148589384
NR_110313	chr4	+	980784	998345	IDUA	17561	978284	983284
NM_004907	chr19	+	13261281	13265718	IER2	4437	13258781	13263781
NM_016097	chr18	-	44681389	44702745	IER3IP1	21356	44700245	44705245
NM_203434	chr9	-	131937830	131940540	IER5L	2710	131938040	131943040
NR_036467	chr12	-	6648693	6665249	IFFO1	16556	6662749	6667749
NM_001136265	chr1	-	19230773	19282826	IFFO2	52053	19280326	19285326
NM_001206567	chr1	+	158979681	159024945	IFI16	45264	158977181	158982181
NM_001288960	chr14	+	94577078	94583036	IFI27	5958	94574578	94579578
NM_206949	chr14	+	94547638	94569060	IFI27L1	21422	94545138	94550138
NM_006332	chr19	+	18284589	18288934	IFI30	4345	18282089	18287089
NM_005533	chr17	+	41158741	41166476	IFI35	7735	41156241	41161241
NR_135640	chr1	+	79115473	79129763	IFI44	14290	79112973	79117973
NM_006820	chr1	+	79086066	79111830	IFI44L	25764	79083566	79088566
NM_002038	chr1	-	27992571	27998724	IFI6	6153	27996224	28001224
NM_022168	chr2	-	163123588	163175218	IFIH1	51630	163172718	163177718
NM_001270929	chr10	+	91152302	91166244	IFIT1	13942	91149802	91154802
NM_001010987	chr10	+	91137812	91144962	IFIT1B	7150	91135312	91140312
NM_001547	chr10	+	91061705	91069033	IFIT2	7328	91059205	91064205
NM_001549	chr10	+	91087575	91100725	IFIT3	13150	91085075	91090075
NM_012420	chr10	+	91174324	91180759	IFIT5	6435	91171824	91176824
NM_001170820	chr11	-	1753639	1771824	IFITM10	18185	1769324	1774324
NM_000629	chr21	+	34697213	34732128	IFNAR1	34915	34694713	34699713
NM_001289126	chr21	+	34602199	34636818	IFNAR2	34619	34599699	34604699
NM_000619	chr12	-	68548549	68553521	IFNG	4972	68551021	68556021
NR_104124	chr12	+	68383224	68415107	IFNG-AS1	31883	68380724	68385724
NM_000416	chr6	-	137518620	137540567	IFNGR1	21947	137538067	137543067
NM_001329128	chr21	+	34775201	34809828	IFNGR2	34627	34772701	34777701
NM_001276254	chr19	-	39736953	39739496	IFNL4	2543	39736996	39741996
NM_173064	chr1	-	24480646	24513765	IFNLR1	33119	24511265	24516265
NM_001197080	chr7	+	112063198	112117258	IFRD1	54060	112060698	112065698
NM_006764	chr3	-	50325162	50330026	IFRD2	4864	50327526	50332526
NM_018262	chr3	+	129158878	129239350	IFT122	80472	129156378	129161378
NM_014714	chr16	-	1560427	1662109	IFT140	101682	1659609	1664609
NM_015662	chr2	-	27667239	27712678	IFT172	45439	27710178	27715178
NM_174887	chr17	-	26655350	26662515	IFT20	7165	26660015	26665015
NM_001287526	chr7	-	100956647	100965104	IFT22	8457	100962604	100967604
NM_001177701	chr22	-	37154245	37172177	IFT27	17932	37169677	37174677
NR_045665	chr14	+	76452095	76550416	IFT43	98321	76449595	76454595
NM_001168618	chr11	-	118415242	118436791	IFT46	21549	118434291	118439291
NM_001303459	chr20	+	42219252	42275936	IFT52	56684	42216752	42221752
NM_018010	chr3	-	107879658	107941417	IFT57	61759	107938917	107943917
NM_001099223	chr9	+	26946987	27066132	IFT74	119145	26944487	26949487
NM_020800	chr3	-	159974773	160117320	IFT80	142547	160114820	160119820
NM_001143779	chr12	+	110562139	110656600	IFT81	94461	110559639	110564639
NM_006531	chr13	+	21140954	21265576	IFT88	124622	21138454	21143454
NM_001551	chrX	+	69353317	69386173	IGBP1	32856	69350817	69355817
NM_004884	chr15	-	65619464	65670378	IGDCC3	50914	65667878	65672878
NM_020962	chr15	-	65673824	65715410	IGDCC4	41586	65712910	65717910
NM_000618	chr12	-	102789644	102874423	IGF1	84779	102871923	102876923
NM_001291858	chr15	+	99191767	99507759	IGF1R	315992	99189267	99194267
NM_001007139	chr11	-	2150341	2170833	IGF2	20492	2168333	2173333
NR_133657	chr11	+	2161741	2169896	IGF2-AS	8155	2159241	2164241
NM_006546	chr17	+	47074773	47133507	IGF2BP1	58734	47072273	47077273
NM_001291869	chr3	-	185360918	185542844	IGF2BP2	181926	185540344	185545344
NR_126326	chr3	+	185431039	185447575	IGF2BP2-AS1	16536	185428539	185433539
NM_006547	chr7	-	23349827	23509995	IGF2BP3	160168	23507495	23512495
NM_000876	chr6	+	160390130	160532534	IGF2R	142404	160387630	160392630
NR_027389	chr16	-	1840413	1844909	IGFALS	4496	1842409	1847409
NM_000596	chr7	+	45927958	45933267	IGFBP1	5309	45925458	45930458
NM_001313993	chr2	+	217497550	217529158	IGFBP2	31608	217495050	217500050
NM_000598	chr7	-	45951843	45960871	IGFBP3	9028	45958371	45963371
NM_001552	chr17	+	38599675	38613982	IGFBP4	14307	38597175	38602175
NM_000599	chr2	-	217536827	217560272	IGFBP5	23445	217557772	217562772
NM_002178	chr12	+	53491435	53496128	IGFBP6	4693	53488935	53493935
NM_001553	chr4	-	57897236	57976551	IGFBP7	79315	57974051	57979051
NR_034081	chr4	+	57975927	58071465	IGFBP7-AS1	95538	57973427	57978427
NM_001007563	chr9	-	38406524	38424444	IGFBPL1	17920	38421944	38426944
NM_001002915	chr19	+	46651038	46664561	IGFL2	13523	46648538	46653538
NR_135234	chr19	-	46692285	46706319	IGFL2-AS1	14034	46703819	46708819
NM_207393	chr19	-	46623327	46627931	IGFL3	4604	46625431	46630431
NM_001346003	chr19	-	36229702	36233351	IGFLR1	3649	36230851	36235851
NM_001164586	chr1	+	201159952	201198080	IGFN1	38128	201157452	201162452
NM_002180	chr11	+	68671318	68708069	IGHMBP2	36751	68668818	68673818
NM_001007189	chr5	+	139505520	139508391	IGIP	2871	139503020	139508020
NM_020070	chr22	-	23915312	23922495	IGLL1	7183	23919995	23924995
NM_001178126	chr22	+	23229959	23238013	IGLL5	8054	23227459	23232459
NM_001101372	chr19	+	51815101	51834102	IGLON5	19001	51812601	51817601
NM_001170961	chrX	-	130407482	130423403	IGSF1	15921	130420903	130425903
NM_178822	chr3	-	151153777	151176497	IGSF10	22720	151173997	151178997
NM_001353320	chr3	-	118619478	118864915	IGSF11	245437	118862415	118867415
NR_046230	chr3	+	118661922	118667088	IGSF11-AS1	5166	118659422	118664422
NM_032880	chr1	+	18434239	18704977	IGSF21	270738	18431739	18436739
NM_173588	chr11	-	18725851	18747777	IGSF22	21926	18745277	18750277
NM_001205280	chr19	+	45116939	45140081	IGSF23	23142	45114439	45119439
NM_001007237	chr1	-	117117019	117210377	IGSF3	93358	117207877	117212877
NM_001080444	chr21	+	41117333	41174023	IGSF5	56690	41114833	41119833
NM_005849	chr16	-	21652604	21663987	IGSF6	11383	21661487	21666487
NM_001206665	chr1	-	160061128	160068618	IGSF8	7490	160066118	160071118
NM_020789	chr1	-	159896828	159915386	IGSF9	18558	159912886	159917886
NM_001277285	chr11	-	133778519	133826649	IGSF9B	48130	133824149	133829149
NM_002181	chr2	-	219919141	219925238	IHH	6097	219922738	219927738
NM_006083	chr5	+	140027383	140042065	IK	14682	140024883	140029883
NM_201613	chr12	-	99007181	99038829	IKBIP	31648	99036329	99041329
NM_001242778	chr8	+	42128819	42190171	IKBKB	61352	42126319	42131319
NM_001193322	chr1	+	206643585	206670223	IKBKE	26638	206641085	206646085
NM_001099856	chrX	+	153770454	153793261	IKBKG	22807	153767954	153772954
NM_001291839	chr7	+	50343678	50472798	IKZF1	129120	50341178	50346178
NM_001079526	chr2	-	213864410	214016333	IKZF2	151923	214013833	214018833
NM_001257411	chr17	-	37913967	38020441	IKZF3	106474	38017941	38022941
NM_001351091	chr12	+	56401495	56432219	IKZF4	30724	56398995	56403995
NR_073479	chr10	-	124750321	124768366	IKZF5	18045	124765866	124770866
NM_000572	chr1	-	206940947	206945839	IL10	4892	206943339	206948339
NR_026691	chr11	+	117857105	117872199	IL10RA	15094	117854605	117859605
NM_000628	chr21	+	34638664	34669539	IL10RB	30875	34636164	34641164
NM_001267718	chr19	-	55875749	55881831	IL11	6082	55879331	55884331
NM_001142784	chr9	+	34652181	34661898	IL11RA	9717	34649681	34654681
NM_000882	chr3	+	159706622	159713806	IL12A	7184	159704122	159709122
NR_108088	chr3	-	159631189	159924879	IL12A-AS1	293690	159922379	159927379
NM_002187	chr5	-	158741790	158757481	IL12B	15691	158754981	158759981
NM_001290024	chr19	-	18169804	18209626	IL12RB1	39822	18207126	18212126
NR_047584	chr1	+	67773046	67862583	IL12RB2	89537	67770546	67775546
NM_002188	chr5	+	131993864	131996801	IL13	2937	131991364	131996364
NM_001560	chrX	+	117861558	117928496	IL13RA1	66938	117859058	117864058
NM_000640	chrX	-	114238537	114252207	IL13RA2	13670	114249707	114254707
NR_037840	chr4	+	142557748	142655140	IL15	97392	142555248	142560248
NM_001351095	chr10	-	5994333	6020704	IL15RA	26371	6018204	6023204
NM_001172128	chr15	+	81489218	81605104	IL16	115886	81486718	81491718
NM_002190	chr6	+	52051184	52055436	IL17A	4252	52048684	52053684
NM_001317987	chr5	-	148753829	148783765	IL17B	29936	148781265	148786265
NM_138284	chr13	+	21277481	21297237	IL17D	19756	21274981	21279981
NM_052872	chr6	-	52101483	52109298	IL17F	7815	52106798	52111798
NM_014339	chr22	+	17565848	17596584	IL17RA	30736	17563348	17568348
NM_018725	chr3	+	53880576	53899827	IL17RB	19251	53878076	53883076
NM_032732	chr3	+	9958757	9975305	IL17RC	16548	9956257	9961257
NM_001318864	chr3	-	57124009	57204345	IL17RD	80336	57201845	57206845
NM_153483	chr3	+	9944295	9958084	IL17RE	13789	9941795	9946795
NM_001001694	chr22	-	50432941	50451055	IL17REL	18114	50448555	50453555
NM_001562	chr11	-	112013973	112034840	IL18	20867	112032340	112037340
NM_173044	chr11	+	71709957	71713850	IL18BP	3893	71707457	71712457
NM_003855	chr2	+	102972742	103015235	IL18R1	42493	102970242	102975242
NM_003853	chr2	+	103035249	103069024	IL18RAP	33775	103032749	103037749
NM_153758	chr1	+	206972214	207016326	IL19	44112	206969714	206974714
NM_000575	chr2	-	113531491	113542975	IL1A	11484	113540475	113545475
NM_000576	chr2	-	113587336	113594356	IL1B	7020	113591856	113596856
NM_173161	chr2	+	113825546	113833427	IL1F10	7881	113823046	113828046
NM_001288706	chr2	+	102686835	102796334	IL1R1	109499	102684335	102689335
NM_004633	chr2	+	102608305	102644884	IL1R2	36579	102605805	102610805
NM_001167931	chr3	+	190231839	190374986	IL1RAP	143147	190229339	190234339
NM_014271	chrX	+	28605680	29974017	IL1RAPL1	1368337	28603180	28608180
NM_017416	chrX	+	103810995	105011822	IL1RAPL2	1200827	103808495	103813495
NM_016232	chr2	+	102927961	102968497	IL1RL1	40536	102925461	102930461
NM_001351447	chr2	+	102803432	102856461	IL1RL2	53029	102800932	102805932
NM_173841	chr2	+	113875469	113891593	IL1RN	16124	113872969	113877969
NM_000586	chr4	-	123372625	123377650	IL2	5025	123375150	123380150
NM_018724	chr1	+	207039153	207042568	IL20	3415	207036653	207041653
NM_014432	chr6	-	137321107	137366317	IL20RA	45210	137363817	137368817
NM_144717	chr3	+	136676706	136729926	IL20RB	53220	136674206	136679206
NM_021803	chr4	-	123533782	123542212	IL21	8430	123539712	123544712
NR_104126	chr4	+	123540137	123610311	IL21-AS1	70174	123537637	123542637
NM_181079	chr16	+	27413482	27463363	IL21R	49881	27410982	27415982
NR_037158	chr16	-	27458990	27464714	IL21R-AS1	5724	27462214	27467214
NM_020525	chr12	-	68642024	68647281	IL22	5257	68644781	68649781
NM_021258	chr1	-	24446260	24469775	IL22RA1	23515	24467275	24472275
NM_181309	chr6	-	137464956	137494785	IL22RA2	29829	137492285	137497285
NM_144701	chr1	+	67632168	67725650	IL23R	93482	67629668	67634668
NM_006850	chr1	+	207070787	207077484	IL24	6697	207068287	207073287
NM_172314	chr14	+	23842017	23845612	IL25	3595	23839517	23844517
NM_018402	chr12	-	68595128	68619571	IL26	24443	68617071	68622071
NM_145659	chr16	-	28510682	28518155	IL27	7473	28515655	28520655
NM_004843	chr19	+	14142551	14163717	IL27RA	21166	14140051	14145051
NM_001308242	chr10	-	6052656	6104333	IL2RA	51677	6101833	6106833
NM_001346222	chr22	-	37521879	37571158	IL2RB	49279	37568658	37573658
NM_000206	chrX	-	70327253	70331481	IL2RG	4228	70328981	70333981
NM_000588	chr5	+	131396346	131398896	IL3	2550	131393846	131398846
NM_001242637	chr5	+	55147206	55218682	IL31RA	71476	55144706	55149706
NM_004221	chr16	+	3115312	3119668	IL32	4356	3112812	3117812
NM_001314047	chr9	+	6215148	6257983	IL33	42835	6212648	6217648
NM_001172771	chr16	+	70613797	70694585	IL34	80788	70611297	70616297
NM_014440	chr2	+	113763037	113765621	IL36A	2584	113760537	113765537
NM_014438	chr2	-	113779667	113810444	IL36B	30777	113807944	113812944
NM_019618	chr2	+	113735595	113743249	IL36G	7654	113733095	113738095
NM_173170	chr2	+	113816214	113822320	IL36RN	6106	113813714	113818714
NM_173204	chr2	+	113670547	113676458	IL37	5911	113668047	113673047
NM_001267713	chrX	+	1455508	1501582	IL3RA	46074	1453008	1458008
NM_172348	chr5	+	132009677	132018370	IL4	8693	132007177	132012177
NM_001258018	chr19	-	50392912	50432796	IL4I1	39884	50430296	50435296
NM_001257997	chr16	+	27325229	27376099	IL4R	50870	27322729	27327729
NM_175726	chr3	-	3108007	3152058	IL5RA	44051	3149558	3154558
NM_000600	chr7	+	22766760	22771621	IL6	4861	22764260	22769260
NM_000565	chr1	+	154377668	154441926	IL6R	64258	154375168	154380168
NM_175767	chr5	-	55230924	55290821	IL6ST	59897	55288321	55293321
NM_000880	chr8	-	79645006	79717758	IL7	72752	79715258	79720258
NM_002185	chr5	+	35856950	35879705	IL7R	22755	35854450	35859450
NM_000590	chr5	-	135227934	135231516	IL9	3582	135229016	135234016
NM_002186	chrX	+	155227245	155240482	IL9R	13237	155224745	155229745
NM_175924	chr3	-	121706169	121741127	ILDR1	34958	121738627	121743627
NM_199351	chr1	-	166882440	166944561	ILDR2	62121	166942061	166947061
NM_004515	chr1	-	153634263	153643504	ILF2	9241	153641004	153646004
NM_012218	chr19	+	10764936	10803095	ILF3	38159	10762436	10767436
NM_001278441	chr11	+	6624937	6632105	ILK	7168	6622437	6627437
NM_030768	chr2	-	239079042	239112324	ILKAP	33282	239109824	239114824
NM_006844	chr19	-	15225784	15236610	ILVBL	10826	15234110	15239110
NM_001304274	chr11	-	31453945	31531175	IMMP1L	77230	31528675	31533675
NM_001244606	chr7	-	110303105	111202573	IMMP2L	899468	111200073	111205073
NM_006839	chr2	-	86371054	86422893	IMMT	51839	86420393	86425393
NM_001320311	chr2	+	131099797	131105534	IMP4	5737	131097297	131102297
NM_001144878	chr8	-	82569150	82598589	IMPA1	29439	82596089	82601089
NR_146081	chr8	-	82516118	82543512	IMPA1P1	27394	82541012	82546012
NM_014214	chr18	+	11981426	12030885	IMPA2	49459	11978926	11983926
NM_018439	chr18	+	22006608	22033494	IMPACT	26886	22004108	22009108
NM_017813	chr8	-	57870487	57906430	IMPAD1	35943	57903930	57908930
NM_001304521	chr7	-	128032330	128050041	IMPDH1	17711	128047541	128052541
NM_000884	chr3	-	49061761	49066875	IMPDH2	5114	49064375	49069375
NM_001563	chr6	-	76630830	76782395	IMPG1	151565	76779895	76784895
NM_016247	chr3	-	100941389	101039419	IMPG2	98030	101036919	101041919
NM_032727	chr10	+	105036919	105050108	INA	13189	105034419	105039419
NM_001301268	chr15	+	40616256	40618916	INAFM2	2660	40613756	40618756
NM_001167986	chr17	-	4891424	4900905	INCA1	9481	4898405	4903405
NM_001040694	chr11	+	61891444	61920635	INCENP	29191	61888944	61893944
NM_022489	chr14	+	105155942	105185947	INF2	30005	105153442	105158442
NM_198217	chr13	+	111364969	111373421	ING1	8452	111362469	111367469
NM_001564	chr4	+	184426202	184433581	ING2	7379	184423702	184428702
NM_019071	chr7	+	120590816	120615711	ING3	24895	120588316	120593316
NM_001127585	chr12	-	6759703	6772308	ING4	12605	6769808	6774808
NM_001330161	chr2	+	242626426	242661222	ING5	34796	242623926	242628926
NM_002191	chr2	+	220436953	220440435	INHA	3482	220434453	220439453
NM_002192	chr7	-	41724711	41742706	INHBA	17995	41740206	41745206
NR_027118	chr7	+	41733513	41818976	INHBA-AS1	85463	41731013	41736013
NM_002193	chr2	+	121103717	121109384	INHBB	5667	121101217	121106217
NM_005538	chr12	+	57828467	57845845	INHBC	17378	57825967	57830967
NM_031479	chr12	+	57849073	57851796	INHBE	2723	57846573	57851573
NM_021218	chr9	-	115446228	115480429	INIP	34201	115477929	115482929
NM_001199219	chr7	+	30791750	30797218	INMT	5468	30789250	30794250
NR_037598	chr7	+	30791750	30932002	INMT-MINDY4	140252	30789250	30794250
NM_017553	chr15	-	41271078	41408444	INO80	137366	41405944	41410944
NM_031288	chr2	+	74682149	74685087	INO80B	2938	74679649	74684649
NR_037849	chr2	+	74682149	74688018	INO80B-WBP1	5869	74679649	74684649
NM_001098817	chr18	-	33048290	33077955	INO80C	29665	33075455	33080455
NM_017759	chr2	-	206858444	206950906	INO80D	92462	206948406	206953406
NR_134855	chr16	+	30007529	30017115	INO80E	9586	30005029	30010029
NM_002194	chr2	+	191208195	191236391	INPP1	28196	191205695	191210695
NM_004027	chr2	+	99061320	99207496	INPP4A	146176	99058820	99063820
NM_001101669	chr4	-	142944312	143767688	INPP4B	823376	143765188	143770188
NM_005539	chr10	+	134351282	134596984	INPP5A	245702	134348782	134353782
NM_005540	chr1	-	38326368	38412729	INPP5B	86361	38410229	38415229
NM_005541	chr2	+	233924676	234116549	INPP5D	191873	233922176	233927176
NM_019892	chr9	-	139323066	139334274	INPP5E	11208	139331774	139336774
NM_014937	chr10	+	121485558	121588662	INPP5F	103104	121483058	121488058
NM_001284286	chr22	+	31518908	31530683	INPP5J	11775	31516408	31521408
NM_001135642	chr17	-	1397870	1420182	INPP5K	22312	1417682	1422682
NM_001567	chr11	+	71935881	71950188	INPPL1	14307	71933381	71938381
NR_003512	chr11	-	2150341	2182439	INS-IGF2	32098	2179939	2184939
NM_001031853	chr11	+	15133969	15268756	INSC	134787	15131469	15136469
NM_005542	chr7	+	155089481	155101945	INSIG1	12464	155086981	155091981
NM_001321333	chr2	+	118845993	118867607	INSIG2	21614	118843493	118848493
NM_001265587	chr19	-	17927321	17932383	INSL3	5062	17929883	17934883
NM_002195	chr9	+	5231418	5233967	INSL4	2549	5228918	5233918
NM_005478	chr1	-	67263423	67266942	INSL5	3519	67264442	67269442
NM_007179	chr9	-	5163862	5185618	INSL6	21756	5183118	5188118
NM_002196	chr20	+	20348764	20351592	INSM1	2828	20346264	20351264
NM_032594	chr14	+	36003247	36006260	INSM2	3013	36000747	36005747
NM_000208	chr19	-	7112265	7294313	INSR	182048	7291813	7296813
NM_014215	chr1	-	156810664	156828712	INSRR	18048	156826212	156831212
NM_001080453	chr7	-	1509912	1544018	INTS1	34106	1541518	1546518
NM_018142	chr8	+	19674917	19709586	INTS10	34669	19672417	19677417
NM_001256456	chr1	-	1246964	1260067	INTS11	13103	1257567	1262567
NM_001142471	chr4	-	106603784	106629881	INTS12	26097	106627381	106632381
NM_018164	chr12	-	27058111	27091254	INTS13	33143	27088754	27093754
NM_001207058	chr15	-	65871095	65903627	INTS14	32532	65901127	65906127
NM_001330417	chr17	-	59942727	60005393	INTS2	62666	60002893	60007893
NM_001324475	chr1	+	153700542	153747284	INTS3	46742	153698042	153703042
NM_033547	chr11	-	77589765	77705717	INTS4	115952	77703217	77708217
NR_146905	chr7	+	64601407	64694600	INTS4P1	93193	64598907	64603907
NR_027392	chr7	+	65112766	65183667	INTS4P2	70901	65110266	65115266
NM_030628	chr11	-	62414319	62420774	INTS5	6455	62418274	62423274
NM_012141	chr13	-	51935700	52027275	INTS6	91575	52024775	52029775
NM_182540	chrX	+	134654550	134716460	INTS6L	61910	134652050	134657050
NR_037667	chr1	-	212113740	212209002	INTS7	95262	212206502	212211502
NM_017864	chr8	+	95835517	95892721	INTS8	57204	95833017	95838017
NM_001145159	chr8	-	28625174	28747698	INTS9	122524	28745198	28750198
NM_015693	chr4	+	128554086	128637934	INTU	83848	128551586	128556586
NM_001318381	chr9	+	102861466	103064457	INVS	202991	102858966	102863966
NM_153273	chr3	-	49761727	49823973	IP6K1	62246	49821473	49826473
NM_016291	chr3	-	48725435	48754711	IP6K2	29276	48752211	48757211
NM_001142883	chr6	-	33689442	33714762	IP6K3	25320	33712262	33717262
NM_015553	chr6	-	154475617	154677900	IPCEF1	202283	154675400	154680400
NM_152230	chr10	-	59951277	60027694	IPMK	76417	60025194	60030194
NM_016338	chr5	+	61708572	61924416	IPO11	215844	61706072	61711072
NR_073584	chr5	+	61874561	61924416	IPO11-LRRC70	49855	61872061	61877061
NM_014652	chr1	+	44412477	44433694	IPO13	21217	44409977	44414977
NR_051979	chr14	-	24649424	24658124	IPO4	8700	24655624	24660624
NM_002271	chr13	+	98605928	98676550	IPO5	70622	98603428	98608428
NR_103742	chr19	-	23437855	23457053	IPO5P1	19198	23454553	23459553
NM_006391	chr11	+	9406168	9469674	IPO7	63506	9403668	9408668
NM_006390	chr12	-	30781914	30848929	IPO8	67015	30846429	30851429
NM_018085	chr1	+	201798287	201853422	IPO9	55135	201795787	201800787
NR_046696	chr1	-	201657383	201798687	IPO9-AS1	141304	201796187	201801187
NM_001145349	chr1	-	46159997	46216485	IPP	56488	46213985	46218985
NM_022755	chr9	-	95375465	95432547	IPPK	57082	95430047	95435047
NR_023915	chr15	+	25361691	25367623	IPW	5932	25359191	25364191
NR_073043	chr2	-	237232789	237416178	IQCA1	183389	237413678	237418678
NM_001304419	chr7	-	150887960	150902582	IQCA1L	14622	150900082	150905082
NM_001319107	chr3	-	121488607	121553926	IQCB1	65319	121551426	121556426
NM_001160042	chr1	+	32671235	32674288	IQCC	3053	32668735	32673735
NM_138451	chr12	-	113633245	113658899	IQCD	25654	113656399	113661399
NM_152558	chr7	+	2598605	2654368	IQCE	55763	2596105	2601105
NM_152397	chr3	-	51928891	51937386	IQCF1	8495	51934886	51939886
NM_001207023	chr3	+	51860898	51864874	IQCF3	3976	51858398	51863398
NM_001323028	chr3	-	197615945	197686890	IQCG	70945	197684390	197689390
NM_001322474	chr15	+	67547137	67794142	IQCH	247005	67544637	67549637
NR_040051	chr15	-	67695948	67814182	IQCH-AS1	118234	67811682	67816682
NM_001197100	chr3	+	158787040	158984096	IQCJ	197056	158784540	158789540
NM_001197114	chr3	+	158787040	159615155	IQCJ-SCHIP1	828115	158784540	158789540
NR_121669	chr3	-	159483170	159486401	IQCJ-SCHIP1-AS1	3231	159483901	159488901
NM_001305122	chr16	+	19727777	19869789	IQCK	142012	19725277	19730277
NM_003870	chr15	+	90931472	91045475	IQGAP1	114003	90928972	90933972
NM_006633	chr5	+	75699079	76003957	IQGAP2	304878	75696579	75701579
NM_178229	chr1	-	156495196	156542396	IQGAP3	47200	156539896	156544896
NM_001134382	chr3	-	12938541	13114617	IQSEC1	176076	13112117	13117117
NM_001111125	chrX	-	53262057	53350522	IQSEC2	88465	53348022	53353022
NM_001170738	chr12	+	176048	287625	IQSEC3	111577	173548	178548
NM_178827	chr7	-	123092235	123174718	IQUB	82483	123172218	123177218
NR_126453	chr15	-	99189094	99194450	IRAIN	5356	99191950	99196950
NM_001569	chrX	-	153275956	153285342	IRAK1	9386	153282842	153287842
NM_001010844	chr6	+	79577260	79610683	IRAK1BP1	33423	79574760	79579760
NM_001570	chr3	+	10206562	10285427	IRAK2	78865	10204062	10209062
NM_007199	chr12	+	66582977	66648394	IRAK3	65417	66580477	66585477
NM_016123	chr12	+	44152746	44183346	IRAK4	30600	44150246	44155246
NM_004136	chr15	+	78730517	78793798	IREB2	63281	78728017	78733017
NM_002198	chr5	-	131817300	131826465	IRF1	9165	131823965	131828965
NM_002199	chr4	-	185308875	185395726	IRF2	86851	185393226	185398226
NM_015649	chr19	-	46386864	46389428	IRF2BP1	2564	46386928	46391928
NM_182972	chr1	-	234740014	234745271	IRF2BP2	5257	234742771	234747771
NM_024496	chr14	-	77490885	77495042	IRF2BPL	4157	77492542	77497542
NM_001197125	chr19	-	50162825	50169132	IRF3	6307	50166632	50171632
NM_002460	chr6	+	391738	411443	IRF4	19705	389238	394238
NM_001347928	chr7	+	128577085	128590096	IRF5	13011	128574585	128579585
NM_006147	chr1	-	209958967	209979520	IRF6	20553	209977020	209982020
NM_004029	chr11	-	612554	615999	IRF7	3445	613499	618499
NM_002163	chr16	+	85932773	85956211	IRF8	23438	85930273	85935273
NM_006084	chr14	+	24630421	24635774	IRF9	5353	24627921	24632921
NM_019612	chr19	+	44220213	44224169	IRGC	3956	44217713	44222713
NM_001346557	chr5	+	150226084	150281964	IRGM	55880	150223584	150228584
NM_001007561	chr19	-	44088518	44100287	IRGQ	11769	44097787	44102787
NM_005544	chr2	-	227596032	227663506	IRS1	67474	227661006	227666006
NM_003749	chr13	-	110406183	110438914	IRS2	32731	110436414	110441414
NM_003604	chrX	-	107975726	107979607	IRS4	3881	107977107	107982107
NM_024337	chr5	+	3596167	3601517	IRX1	5350	3593667	3598667
NM_001134222	chr5	-	2746278	2751769	IRX2	5491	2749269	2754269
NM_024336	chr16	-	54317211	54320378	IRX3	3167	54317878	54322878
NM_001278633	chr5	-	1877540	1887293	IRX4	9753	1884793	1889793
NM_001252197	chr16	+	54965110	54968395	IRX5	3285	54962610	54967610
NM_024335	chr16	+	55358470	55364672	IRX6	6202	55355970	55360970
NM_030940	chr9	-	88879462	88897490	ISCA1	18028	88894990	88899990
NM_213595	chr12	+	108955238	108963160	ISCU	7922	108952738	108957738
NM_001303235	chr15	+	89178867	89199575	ISG20	20708	89176367	89181367
NM_001303095	chr1	-	156691682	156698231	ISG20L2	6549	156695731	156700731
NM_002202	chr5	+	50678957	50690563	ISL1	11606	50676457	50681457
NM_145805	chr15	+	76629064	76634816	ISL2	5752	76626564	76631564
NM_005545	chr15	+	74466086	74469212	ISLR	3126	74463586	74468586
NM_001130136	chr15	+	74421714	74429143	ISLR2	7429	74419214	74424214
NM_080826	chr20	+	13202417	13281297	ISM1	78880	13199917	13204917
NM_182509	chr14	-	77940737	77965210	ISM2	24473	77962710	77967710
NM_016048	chr5	+	128430441	128449719	ISOC1	19278	128427941	128432941
NM_024710	chr19	-	55964345	55973049	ISOC2	8704	55970549	55975549
NM_001101417	chr7	-	16127151	16460947	ISPD	333796	16458447	16463447
NR_038947	chr7	+	16250110	16310229	ISPD-AS1	60119	16247610	16252610
NM_001270976	chr16	+	71928310	71964540	IST1	36230	71925810	71930810
NM_001303508	chr22	+	35462128	35483380	ISX	21252	35459628	35464628
NR_138042	chr22	-	35152655	35393905	ISX-AS1	241250	35391405	35396405
NM_020701	chr3	-	128846258	128880073	ISY1	33815	128877573	128882573
NM_001204890	chr3	-	128806411	128880073	ISY1-RAB43	73662	128877573	128882573
NM_001170938	chr19	-	18545197	18549111	ISYNA1	3914	18546611	18551611
NM_001257138	chr20	+	32951040	33099578	ITCH	148538	32948540	32953540
NM_030790	chr16	-	47188298	47495185	ITFG1	306887	47492685	47497685
NR_110904	chr16	+	47177978	47196657	ITFG1-AS1	18679	47175478	47180478
NR_147202	chr12	+	2921787	2968961	ITFG2	47174	2919287	2924287
NR_146317	chr12	-	2851791	2922090	ITFG2-AS1	70299	2919590	2924590
NM_181501	chr5	+	52084135	52249485	ITGA1	165350	52081635	52086635
NM_001303041	chr1	+	145524890	145543868	ITGA10	18978	145522390	145527390
NM_001004439	chr15	-	68594041	68724492	ITGA11	130451	68721992	68726992
NM_002203	chr5	+	52285155	52390609	ITGA2	105454	52282655	52287655
NM_000419	chr17	-	42449548	42466969	ITGA2B	17421	42464469	42469469
NM_002204	chr17	+	48133331	48167849	ITGA3	34518	48130831	48135831
NM_000885	chr2	+	182321618	182403655	ITGA4	82037	182319118	182324118
NM_002205	chr12	-	54789044	54813050	ITGA5	24006	54810550	54815550
NM_001316306	chr2	+	173292081	173371183	ITGA6	79102	173289581	173294581
NM_001144997	chr12	-	56078353	56106089	ITGA7	27736	56103589	56108589
NM_003638	chr10	-	15555947	15762334	ITGA8	206387	15759834	15764834
NM_002207	chr3	+	37493812	37861281	ITGA9	367469	37491312	37496312
NR_110531	chr3	-	37795179	37903271	ITGA9-AS1	108092	37900771	37905771
NM_001318185	chr16	+	31404632	31437826	ITGAD	33194	31402132	31407132
NM_002208	chr17	-	3617918	3704537	ITGAE	86619	3702037	3707037
NM_002209	chr16	+	30483982	30534506	ITGAL	50524	30481482	30486482
NM_001145808	chr16	+	31271287	31344213	ITGAM	72926	31268787	31273787
NM_001145000	chr2	+	187454789	187545629	ITGAV	90840	187452289	187457289
NM_000887	chr16	+	31366454	31394318	ITGAX	27864	31363954	31368954
NM_002211	chr10	-	33189245	33247293	ITGB1	58048	33244793	33249793
NR_134957	chr2	-	9545809	9563698	ITGB1BP1	17889	9561198	9566198
NM_012278	chrX	+	70521583	70525221	ITGB1BP2	3638	70519083	70524083
NM_001127491	chr21	-	46305868	46348788	ITGB2	42920	46346288	46351288
NR_038311	chr21	+	46340949	46349595	ITGB2-AS1	8646	46338449	46343449
NM_000212	chr17	+	45331207	45390077	ITGB3	58870	45328707	45333707
NM_014288	chr1	-	63906440	63988944	ITGB3BP	82504	63986444	63991444
NM_000213	chr17	+	73717407	73753899	ITGB4	36492	73714907	73719907
NM_002213	chr3	-	124480794	124606152	ITGB5	125358	124603652	124608652
NM_001282355	chr2	-	160956176	161056824	ITGB6	100648	161054324	161059324
NM_000889	chr12	-	53585101	53601091	ITGB7	15990	53598591	53603591
NM_002214	chr7	+	20370724	20455382	ITGB8	84658	20368224	20373224
NM_001271754	chr13	+	102104943	102373207	ITGBL1	268264	102102443	102107443
NM_002215	chr3	+	52811601	52826084	ITIH1	14483	52809101	52814101
NM_002216	chr10	+	7745235	7791483	ITIH2	46248	7742735	7747735
NM_002217	chr3	+	52828783	52843025	ITIH3	14242	52826283	52831283
NM_002218	chr3	-	52847005	52864717	ITIH4	17712	52862217	52867217
NM_030569	chr10	-	7601231	7708961	ITIH5	107730	7706461	7711461
NM_198510	chrX	-	54775331	54824673	ITIH6	49342	54822173	54827173
NM_005546	chr5	+	156607906	156682109	ITK	74203	156605406	156610406
NM_017625	chr1	-	160846329	160854960	ITLN1	8631	160852460	160857460
NM_080878	chr1	-	160914815	160924589	ITLN2	9774	160922089	160927089
NM_004867	chrX	-	78615880	78623049	ITM2A	7169	78620549	78625549
NM_021999	chr13	+	48807273	48836232	ITM2B	28959	48804773	48809773
NM_001287241	chr2	+	231729312	231743969	ITM2C	14657	231726812	231731812
NM_001324240	chr20	+	3190005	3208095	ITPA	18090	3187505	3192505
NM_001142594	chr14	-	93403258	93582264	ITPK1	179006	93579764	93584764
NR_002808	chr14	+	93533796	93538478	ITPK1-AS1	4682	93531296	93536296
NM_002220	chr15	+	41786055	41795757	ITPKA	9702	41783555	41788555
NM_002221	chr1	-	226819390	226926876	ITPKB	107486	226924376	226929376
NR_103784	chr1	-	226843780	226862769	ITPKB-IT1	18989	226860269	226865269
NM_025194	chr19	+	41223007	41246765	ITPKC	23758	41220507	41225507
NM_001168272	chr3	+	4535031	4889524	ITPR1	354493	4532531	4537531
NR_108075	chr3	-	4532000	4534847	ITPR1-AS1	2847	4532347	4537347
NM_002223	chr12	-	26488269	26986131	ITPR2	497862	26983631	26988631
NM_002224	chr6	+	33589155	33664348	ITPR3	75193	33586655	33591655
NM_001272013	chr10	-	106069453	106098251	ITPRIP	28798	106095751	106100751
NM_001008949	chr2	+	96991061	96994091	ITPRIPL1	3030	96988561	96993561
NR_028028	chr16	+	19125253	19132952	ITPRIPL2	7699	19122753	19127753
NM_001331010	chr21	+	35014705	35261988	ITSN1	247283	35012205	35017205
NM_019595	chr2	-	24425734	24583397	ITSN2	157663	24580897	24585897
NM_001159508	chr15	+	40697685	40713512	IVD	15827	40695185	40700185
NM_005547	chr1	+	152881020	152884362	IVL	3342	152878520	152883520
NM_006469	chr1	-	185265521	185286461	IVNS1ABP	20940	185283961	185288961
NM_017969	chr2	-	128238382	128284087	IWS1	45705	128281587	128286587
NR_134655	chr6	+	150690027	150725765	IYD	35738	150687527	150692527
NM_001321864	chr19	-	49244144	49250166	IZUMO1	6022	49247666	49252666
NM_001321449	chr19	-	50655804	50666538	IZUMO2	10734	50664038	50669038
NM_001039846	chr19	+	2096867	2099583	IZUMO4	2716	2094367	2099367
NM_001287437	chr4	+	129730777	129796379	JADE1	65602	129728277	129733277
NM_001308143	chr5	+	133860065	133918920	JADE2	58855	133857565	133862565
NM_001077445	chrX	+	46771710	46920641	JADE3	148931	46769210	46774210
NM_000214	chr20	-	10618331	10654694	JAG1	36363	10652194	10657194
NM_145159	chr14	-	105607317	105635161	JAG2	27844	105632661	105637661
NM_032492	chr3	+	9932270	9936031	JAGN1	3761	9929770	9934770
NM_001321854	chr1	-	65298905	65533429	JAK1	234524	65530929	65535929
NM_001322194	chr9	+	4985085	5128183	JAK2	143098	4982585	4987585
NM_000215	chr19	-	17935592	17958841	JAK3	23249	17956341	17961341
NM_001099433	chr4	-	6027925	6202318	JAKMIP1	174393	6199818	6204818
NM_014790	chr5	-	146965003	147162411	JAKMIP2	197408	147159911	147164911
NR_038902	chr5	+	146939556	147041572	JAKMIP2-AS1	102016	146937056	146942056
NM_001105521	chr10	+	133879470	133998313	JAKMIP3	118843	133876970	133881970
NM_021219	chr21	+	27011593	27089874	JAM2	78281	27009093	27014093
NM_001205329	chr11	+	133938819	134021652	JAM3	82833	133936319	133941319
NM_001098526	chr11	-	118064441	118095809	JAML	31368	118093309	118098309
NM_004973	chr6	+	15246205	15522273	JARID2	276068	15243705	15248705
NM_175061	chr7	-	27870192	28220437	JAZF1	350245	28217937	28222937
NR_034097	chr7	+	28220075	28280996	JAZF1-AS1	60921	28217575	28222575
NM_001350022	chr10	-	30301728	30404423	JCAD	102695	30401923	30406923
NM_144646	chr4	-	71521257	71532348	JCHAIN	11091	71529848	71534848
NM_001135047	chr14	+	75894508	75939404	JDP2	44896	75892008	75897008
NM_001284202	chr14	+	59951160	59972124	JKAMP	20964	59948660	59953660
NM_001322258	chr10	-	64926980	65281835	JMJD1C	354855	65279335	65284335
NM_023007	chr1	-	227918889	227923112	JMJD4	4223	227920612	227925612
NM_001081461	chr17	-	74708913	74722881	JMJD6	13968	74720381	74725381
NM_001114632	chr15	+	42120282	42129785	JMJD7	9503	42117782	42122782
NM_005090	chr15	+	42120282	42140346	JMJD7-PLA2G4B	20064	42117782	42122782
NM_001323918	chr16	-	731665	734446	JMJD8	2781	731946	736946
NM_152405	chr5	+	78531924	78623038	JMY	91114	78529424	78534424
NM_014876	chr22	-	39081547	39096459	JOSD1	14912	39093959	39098959
NM_001270641	chr19	-	51009253	51014612	JOSD2	5359	51012112	51017112
NM_001317830	chr8	-	75146934	75233596	JPH1	86662	75231096	75236096
NM_020433	chr20	-	42740336	42816218	JPH2	75882	42813718	42818718
NR_073379	chr16	+	87635440	87731761	JPH3	96321	87632940	87637940
NM_001146028	chr14	-	24037243	24048009	JPH4	10766	24045509	24050509
NM_016185	chr17	-	73131337	73150778	JPT1	19441	73148278	73153278
NM_144570	chr16	+	1728277	1752073	JPT2	23796	1725777	1730777
NR_024582	chrX	+	73164158	73290217	JPX	126059	73161658	73166658
NM_003724	chr8	-	143738873	143751412	JRK	12539	143748912	143753912
NM_003772	chr11	+	96123157	96126727	JRKL	3570	96120657	96125657
NR_047481	chr11	-	96176445	96240041	JRKL-AS1	63596	96237541	96242541
NM_144616	chr19	-	2252249	2256422	JSRP1	4173	2253922	2258922
NM_006694	chr1	-	153946744	153950451	JTB	3707	153947951	153952951
NM_002228	chr1	-	59246462	59249785	JUN	3323	59247285	59252285
NM_001352773	chr17	-	39910858	39943020	JUP	32162	39940520	39945520
NM_001024660	chr3	+	123813527	124445172	KALRN	631645	123811027	123816027
NM_001256876	chr9	+	470293	746106	KANK1	275813	467793	472793
NM_001136191	chr19	-	11274942	11308243	KANK2	33301	11305743	11310743
NM_198471	chr19	-	8387467	8408146	KANK3	20679	8405646	8410646
NM_001320269	chr1	-	62701836	62785085	KANK4	83249	62782585	62787585
NM_001193465	chr17_ctg5_hap1	+	563497	760700	KANSL1	197203	560997	565997
NR_034172	chr17	+	44270938	44274089	KANSL1-AS1	3151	44268438	44273438
NM_001307976	chr2	-	210886144	211036094	KANSL1L	149950	211033594	211038594
NM_017822	chr12	-	49046994	49076035	KANSL2	29041	49073535	49078535
NM_001115016	chr2	-	97258891	97304116	KANSL3	45225	97301616	97306616
NR_110456	chrX	+	53123338	53177190	KANTR	53852	53120838	53125838
NM_005548	chr16	-	75661621	75681585	KARS	19964	75679085	75684085
NM_020536	chr20	+	18122867	18169031	KAT14	46164	18120367	18125367
NM_021078	chr17	-	40265128	40273382	KAT2A	8254	40270882	40275882
NM_003884	chr3	+	20081523	20195896	KAT2B	114373	20079023	20084023
NM_001206833	chr11	+	65479472	65487077	KAT5	7605	65476972	65481972
NM_006766	chr8	-	41786996	41909544	KAT6A	122548	41907044	41912044
NM_001256469	chr10	+	76586170	76792380	KAT6B	206210	76583670	76588670
NM_007067	chr17	+	47865980	47906458	KAT7	40478	47863480	47868480
NM_182958	chr16	+	31128984	31142714	KAT8	13730	31126484	31131484
NM_001204076	chr6	-	149916010	149969940	KATNA1	53930	149967440	149972440
NM_032116	chr13	-	30776766	30881624	KATNAL1	104858	30879124	30884124
NM_031303	chr18	+	44526786	44628614	KATNAL2	101828	44524286	44529286
NM_005886	chr16	+	57769659	57791162	KATNB1	21503	57767159	57772159
NM_024713	chr15	-	34432874	34502297	KATNBL1	69423	34499797	34504797
NR_135067	chr10	+	102820998	102827898	KAZALD1	6900	102818498	102823498
NM_201628	chr1	+	14925212	15444544	KAZN	519332	14922712	14927712
NM_014867	chr8	+	1922043	1955109	KBTBD11	33066	1919543	1924543
NR_126346	chr8	+	1919562	1924610	KBTBD11-OT1	5048	1917062	1922062
NM_207335	chr3	+	127641901	127706514	KBTBD12	64613	127639401	127644401
NM_001101362	chr15	+	65369153	65372276	KBTBD13	3123	65366653	65371653
NM_015483	chr7	-	32907777	32931468	KBTBD2	23691	32928968	32933968
NM_198439	chr11	-	105921824	105948465	KBTBD3	26641	105945965	105950965
NM_016506	chr11	-	47593748	47600567	KBTBD4	6819	47598067	47603067
NM_152903	chr13	-	41701708	41706936	KBTBD6	5228	41704436	41709436
NM_032138	chr13	-	41763969	41768720	KBTBD7	4751	41766220	41771220
NM_032505	chr3	+	67048726	67061632	KBTBD8	12906	67046226	67051226
NR_002838	chr18	-	39060235	39100561	KC6	40326	39098061	39103061
NR_131986	chr12	-	105698644	105720795	KCCAT198	22151	105718295	105723295
NR_110014	chr7	+	17414540	17506880	KCCAT333	92340	17412040	17417040
NM_020122	chr2	+	85198230	85286595	KCMF1	88365	85195730	85200730
NM_000217	chr12	+	5019072	5027422	KCNA1	8350	5016572	5021572
NM_001204269	chr1	-	111136201	111174096	KCNA2	37895	111171596	111176596
NR_109845	chr1	-	111196185	111216076	KCNA3	19891	111213576	111218576
NM_002233	chr11	-	30031287	30038577	KCNA4	7290	30036077	30041077
NM_002234	chr12	+	5153084	5155954	KCNA5	2870	5150584	5155584
NM_002235	chr12	+	4918341	4960278	KCNA6	41937	4915841	4920841
NM_031886	chr19	-	49570674	49576198	KCNA7	5524	49573698	49578698
NM_172160	chr3	+	155838336	156256927	KCNAB1	418591	155835836	155840836
NR_046618	chr3	-	156158945	156164725	KCNAB1-AS1	5780	156162225	156167225
NR_046617	chr3	-	155933348	155945672	KCNAB1-AS2	12324	155943172	155948172
NM_001199861	chr1	+	6052357	6161253	KCNAB2	108896	6049857	6054857
NM_004732	chr17	-	7825176	7832753	KCNAB3	7577	7830253	7835253
NM_004975	chr20	-	47980413	48099181	KCNB1	118768	48096681	48101681
NM_004770	chr8	+	73449625	73850584	KCNB2	400959	73447125	73452125
NM_001112741	chr11	+	17757494	17804602	KCNC1	47108	17754994	17759994
NM_153748	chr12	-	75433857	75603528	KCNC2	169671	75601028	75606028
NR_110912	chr19	-	50815198	50836772	KCNC3	21574	50834272	50839272
NM_004978	chr1	+	110753335	110776674	KCNC4	23339	110750835	110755835
NM_004979	chrX	-	48818638	48828251	KCND1	9613	48825751	48830751
NM_012281	chr7	+	119913721	120390387	KCND2	476666	119911221	119916221
NM_172198	chr1	-	112318453	112531777	KCND3	213324	112529277	112534277
NR_046783	chr1	-	112396383	112399527	KCND3-IT1	3144	112397027	112402027
NM_000219	chr21	-	35818985	35884573	KCNE1	65588	35882073	35887073
NM_001330065	chr21	-	35818987	35831942	KCNE1B	12955	35829442	35834442
NM_172201	chr21	+	35736322	35743440	KCNE2	7118	35733822	35738822
NM_005472	chr11	-	74165885	74178600	KCNE3	12715	74176100	74181100
NM_080671	chr2	+	223916647	223920357	KCNE4	3710	223914147	223919147
NM_002237	chr20	-	49620192	49639675	KCNG1	19483	49637175	49642175
NM_012283	chr18	+	77623667	77659816	KCNG2	36149	77621167	77626167
NM_133329	chr2	-	42669156	42721237	KCNG3	52081	42718737	42723737
NM_172347	chr16	-	84254740	84273356	KCNG4	18616	84270856	84275856
NM_172362	chr1	-	210851656	211307457	KCNH1	455801	211304957	211309957
NM_000238	chr7	-	150642043	150675402	KCNH2	33359	150672902	150677902
NM_001314030	chr12	+	49932939	49952095	KCNH3	19156	49930439	49935439
NM_012285	chr17	-	40308909	40333296	KCNH4	24387	40330796	40335796
NM_172375	chr14	-	63173290	63511956	KCNH5	338666	63509456	63514456
NM_173092	chr17	+	61600694	61626338	KCNH6	25644	61598194	61603194
NM_033272	chr2	-	163227916	163695257	KCNH7	467341	163692757	163697757
NM_144633	chr3	+	19190016	19577135	KCNH8	387119	19187516	19192516
NM_001034838	chr5	+	169780490	170163637	KCNIP1	383147	169777990	169782990
NM_173195	chr10	-	103585730	103603677	KCNIP2	17947	103601177	103606177
NR_045118	chr10	+	103578824	103588646	KCNIP2-AS1	9822	103576324	103581324
NM_013434	chr2	+	95963071	96051825	KCNIP3	88754	95960571	95965571
NM_147182	chr4	-	20730238	21950374	KCNIP4	1220136	21947874	21952874
NR_002813	chr4	-	21844963	21854811	KCNIP4-IT1	9848	21852311	21857311
NM_153766	chr11	-	128707908	128737268	KCNJ1	29360	128734768	128739768
NM_002241	chr1	-	160007256	160040051	KCNJ10	32795	160037551	160042551
NM_001166290	chr11	-	17406795	17410878	KCNJ11	4083	17408378	17413378
NM_021012	chr17	+	21279698	21323179	KCNJ12	43481	21277198	21282198
NM_002242	chr2	-	233630511	233641275	KCNJ13	10764	233638775	233643775
NM_013348	chr19	+	48958963	48969367	KCNJ14	10404	48956463	48961463
NM_001276437	chr21	+	39601836	39673746	KCNJ15	71910	39599336	39604336
NM_018658	chr17	+	68071365	68131746	KCNJ16	60381	68068865	68073865
NM_001194958	chr17	+	21308447	21320482	KCNJ18	12035	21305947	21310947
NM_000891	chr17	+	68165675	68176183	KCNJ2	10508	68163175	68168175
NM_001260508	chr2	+	155555092	155714864	KCNJ3	159772	155552592	155557592
NM_152868	chr22	-	38822332	38851205	KCNJ4	28873	38848705	38853705
NM_000890	chr11	+	128761312	128787951	KCNJ5	26639	128758812	128763812
NM_002240	chr21	-	38996524	39288741	KCNJ6	292217	39286241	39291241
NM_004982	chr12	-	21917888	21927755	KCNJ8	9867	21925255	21930255
NM_004983	chr1	+	160051359	160059212	KCNJ9	7853	160048859	160053859
NM_002245	chr1	+	233749749	233808258	KCNK1	58509	233747249	233752249
NM_021161	chr14	-	88646451	88793256	KCNK10	146805	88790756	88795756
NM_022055	chr2	-	47747914	47797470	KCNK12	49556	47794970	47799970
NM_022054	chr14	+	90528108	90652201	KCNK13	124093	90525608	90530608
NM_022358	chr20	+	43374487	43380954	KCNK15	6467	43371987	43376987
NR_132377	chr20	-	43340502	43374868	KCNK15-AS1	34366	43372368	43377368
NM_001135107	chr6	-	39282473	39290330	KCNK16	7857	39287830	39292830
NM_001135111	chr6	-	39266776	39282237	KCNK17	15461	39279737	39284737
NM_181840	chr10	+	118956999	118969810	KCNK18	12811	118954499	118959499
NM_001017424	chr1	+	215178884	215410436	KCNK2	231552	215176384	215181384
NM_002246	chr2	+	26915580	26954066	KCNK3	38486	26913080	26918080
NR_133660	chr11	+	64058773	64067500	KCNK4	8727	64056273	64061273
NR_133662	chr11	+	64059193	64072241	KCNK4-TEX40	13048	64056693	64061693
NM_003740	chr6	-	39156746	39197251	KCNK5	40505	39194751	39199751
NM_004823	chr19	+	38810483	38819649	KCNK6	9166	38807983	38812983
NM_005714	chr11	-	65360325	65363467	KCNK7	3142	65360967	65365967
NR_104210	chr8	-	140613080	140715299	KCNK9	102219	140712799	140717799
NM_001322835	chr10	-	78629358	79397577	KCNMA1	768219	79395077	79400077
NR_120655	chr10	+	78647801	78738351	KCNMA1-AS1	90550	78645301	78650301
NR_120654	chr10	+	78900588	78909858	KCNMA1-AS2	9270	78898088	78903088
NR_126365	chr10	+	79110629	79136371	KCNMA1-AS3	25742	79108129	79113129
NM_004137	chr5	-	169805164	169816681	KCNMB1	11517	169814181	169819181
NM_181361	chr3	+	178254085	178562217	KCNMB2	308132	178251585	178256585
NR_126560	chr3	-	178243254	178578193	KCNMB2-AS1	334939	178575693	178580693
NM_001163677	chr3	-	178957536	178984838	KCNMB3	27302	178982338	178987338
NM_014505	chr12	+	70760061	70828072	KCNMB4	68011	70757561	70762561
NM_002248	chr19	+	18062110	18109930	KCNN1	47820	18059610	18064610
NM_001278204	chr5	+	113698015	113832197	KCNN2	134182	113695515	113700515
NM_001204087	chr1	-	154669941	154842754	KCNN3	172813	154840254	154845254
NM_002250	chr19	-	44270684	44285409	KCNN4	14725	44282909	44287909
NM_000218	chr11	+	2466220	2870340	KCNQ1	404120	2463720	2468720
NR_130721	chr11	-	2861364	2882799	KCNQ1-AS1	21435	2880299	2885299
NR_002728	chr11	-	2629557	2721228	KCNQ1OT1	91671	2718728	2723728
NM_004518	chr20	-	62031566	62104030	KCNQ2	72464	62101530	62106530
NM_004519	chr8	-	133133104	133493004	KCNQ3	359900	133490504	133495504
NM_004700	chr1	+	41249683	41306124	KCNQ4	56441	41247183	41252183
NM_019842	chr6	+	73331570	73908573	KCNQ5	577003	73329070	73334070
NR_046621	chr6	-	73844525	73853237	KCNQ5-AS1	8712	73850737	73855737
NR_120503	chr6	+	73340222	73388282	KCNQ5-IT1	48060	73337722	73342722
NM_173605	chr13	+	50589389	50595058	KCNRG	5669	50586889	50591889
NM_001322799	chr20	-	43719854	43729753	KCNS1	9899	43727253	43732253
NM_020697	chr8	+	99439249	99443023	KCNS2	3774	99436749	99441749
NM_001282428	chr2	+	18059113	18114225	KCNS3	55112	18056613	18061613
NM_020822	chr9	+	138594030	138684993	KCNT1	90963	138591530	138596530
NM_001287820	chr1	-	196194909	196577706	KCNT2	382797	196575206	196580206
NR_134267	chr8	+	36641841	36793643	KCNU1	151802	36639341	36644341
NM_014379	chr8	-	110975873	110988076	KCNV1	12203	110985576	110990576
NM_133497	chr9	+	2717525	2730037	KCNV2	12512	2715025	2720025
NM_001135914	chr7	-	128516918	128550773	KCP	33855	128548273	128553273
NM_001258222	chr18	-	24034873	24237476	KCTD1	202603	24234976	24239976
NR_133897	chr12	-	109886459	109915349	KCTD10	28890	109912849	109917849
NM_001002914	chr17	+	7255207	7258262	KCTD11	3055	7252707	7257707
NM_138444	chr13	-	77454303	77460540	KCTD12	6237	77458040	77463040
NM_178863	chr16	-	29917656	29937553	KCTD13	19897	29935053	29940053
NM_001282406	chr11	-	77726760	77757237	KCTD14	30477	77754737	77759737
NM_001129995	chr19	+	34287750	34306666	KCTD15	18916	34285250	34290250
NM_020768	chr5	+	143550436	143856944	KCTD16	306508	143547936	143552936
NM_001282686	chr22	+	37447775	37459430	KCTD17	11655	37445275	37450275
NM_152387	chr2	-	201353674	201374817	KCTD18	21143	201372317	201377317
NM_001100915	chr16	-	67323334	67360674	KCTD19	37340	67358174	67363174
NR_110835	chr17	+	73028661	73061984	KCTD2	33323	73026161	73031161
NM_173562	chr6	+	36410543	36458920	KCTD20	48377	36408043	36413043
NM_001029859	chr11	-	77882289	77899675	KCTD21	17386	77897175	77902175
NR_102280	chr11	+	77850838	77885023	KCTD21-AS1	34185	77848338	77853338
NM_001319295	chr1	+	215740721	215795163	KCTD3	54442	215738221	215743221
NM_198404	chr13	-	45766987	45775175	KCTD4	8188	45772675	45777675
NM_018992	chr16	+	2732494	2759031	KCTD5	26537	2729994	2734994
NM_001128214	chr3	+	58477822	58488087	KCTD6	10265	58475322	58480322
NM_153033	chr7	+	66093867	66108216	KCTD7	14349	66091367	66096367
NM_198353	chr4	-	44175919	44450824	KCTD8	274905	44448324	44453324
NM_017634	chr8	-	25285363	25315984	KCTD9	30621	25313484	25318484
NM_001318732	chr13	-	103436630	103451404	KDELC1	14774	103448904	103453904
NM_153705	chr11	-	108342832	108369159	KDELC2	26327	108366659	108371659
NM_006801	chr19	-	48885826	48894810	KDELR1	8984	48892310	48897310
NM_006854	chr7	-	6500711	6523849	KDELR2	23138	6521349	6526349
NM_006855	chr22	+	38864066	38879452	KDELR3	15386	38861566	38866566
NM_152365	chr1	-	27276046	27286901	KDF1	10855	27284401	27289401
NM_015013	chr1	+	23345940	23410184	KDM1A	64244	23343440	23348440
NM_153042	chr6	+	18155618	18224084	KDM1B	68466	18153118	18158118
NM_012308	chr11	+	66886739	67025550	KDM2A	138811	66884239	66889239
NM_032590	chr12	-	121866899	122018920	KDM2B	152021	122016420	122021420
NM_018433	chr2	+	86668270	86719839	KDM3A	51569	86665770	86670770
NM_016604	chr5	+	137688284	137772716	KDM3B	84432	137685784	137690784
NM_014663	chr1	+	44115796	44171189	KDM4A	55393	44113296	44118296
NR_033827	chr1	-	44165408	44173012	KDM4A-AS1	7604	44170512	44175512
NM_015015	chr19	+	4969123	5153608	KDM4B	184485	4966623	4971623
NM_001304339	chr9	+	6757640	7175648	KDM4C	418008	6755140	6760140
NM_018039	chr11	+	94706844	94732676	KDM4D	25832	94704344	94709344
NM_001042603	chr12	-	389222	498621	KDM5A	109399	496121	501121
NM_006618	chr1	-	202694312	202778598	KDM5B	84286	202776098	202781098
NM_001146702	chrX	-	53220502	53254604	KDM5C	34102	53252104	53257104
NM_001146705	chrY	-	21867300	21906825	KDM5D	39525	21904325	21909325
NM_001291418	chrX	+	44732420	44971857	KDM6A	239437	44729920	44734920
NM_001348716	chr17	+	7743223	7758108	KDM6B	14885	7740723	7745723
NM_030647	chr7	-	139784545	139876741	KDM7A	92196	139874241	139879241
NM_024773	chr16	+	27214806	27233089	KDM8	18283	27212306	27217306
NM_002253	chr4	-	55944425	55991762	KDR	47337	55989262	55994262
NM_002035	chr18	-	60994970	61034506	KDSR	39536	61032006	61037006
NM_203500	chr19	-	10596795	10614054	KEAP1	17259	10611554	10616554
NM_000420	chr7	-	142638200	142659503	KEL	21303	142657003	142662003
NM_007035	chr12	-	91444270	91452131	KERA	7861	91449631	91454631
NM_001251874	chr6	-	73951037	74019938	KHDC1	68901	74017438	74022438
NR_073499	chr1	+	32479294	32526460	KHDRBS1	47166	32476794	32481794
NR_146870	chr6	-	62252601	62996132	KHDRBS2	743531	62993632	62998632
NM_006558	chr8	+	136469707	136659852	KHDRBS3	190145	136467207	136472207
NM_006488	chr2	+	27309610	27323619	KHK	14009	27307110	27312110
NM_001290256	chr14	+	24898491	24910547	KHNYN	12056	24895991	24900991
NM_003685	chr19	-	6413118	6424822	KHSRP	11704	6422322	6427322
NM_001319230	chr1	-	175126122	175162229	KIAA0040	36107	175159729	175164729
NR_022006	chr7	-	26572739	26578444	KIAA0087	5705	26575944	26580944
NM_014680	chr17	-	26941457	26972177	KIAA0100	30720	26969677	26974677
NM_014773	chr5	+	141303384	141321612	KIAA0141	18228	141300884	141305884
NM_001100590	chr4	+	6784458	6885899	KIAA0232	101441	6781958	6786958
NM_014809	chr6	-	24544331	24646383	KIAA0319	102052	24643883	24648883
NM_024874	chr1	-	35899090	36023037	KIAA0319L	123947	36020537	36025537
NM_014686	chr19	+	34745455	34846471	KIAA0355	101016	34742955	34747955
NM_001080398	chr9	-	114122972	114247025	KIAA0368	124053	114244525	114249525
NM_014672	chr14	+	35591526	35743284	KIAA0391	151758	35589026	35594026
NM_014702	chr6	-	127759550	127780535	KIAA0408	20985	127778035	127783035
NM_014732	chr16	+	85061356	85127828	KIAA0513	66472	85058856	85063856
NM_015202	chr16	+	27561467	27791692	KIAA0556	230225	27558967	27563967
NM_001244190	chr14	+	58894102	59015549	KIAA0586	121447	58891602	58896602
NM_014804	chr17	-	6481644	6544247	KIAA0753	62603	6541747	6546747
NM_015038	chr1	+	39875175	39882154	KIAA0754	6979	39872675	39877675
NM_001145678	chr5	-	93486555	93954309	KIAA0825	467754	93951809	93956809
NM_001100425	chr7	-	36363758	36429734	KIAA0895	65976	36427234	36432234
NM_001040715	chr16	-	67209504	67217883	KIAA0895L	8379	67215383	67220383
NM_014949	chr1	-	155882833	155904233	KIAA0907	21400	155901733	155906733
NM_001009880	chr22	-	45588122	45636650	KIAA0930	48528	45634150	45639150
NM_015206	chr15	+	79724857	79764642	KIAA1024	39785	79722357	79727357
NM_001257308	chr5	+	129083883	129100756	KIAA1024L	16873	129081383	129086383
NM_015237	chr1	+	92634414	92650282	KIAA1107	15868	92631914	92636914
NM_015312	chr4	+	123091757	123283914	KIAA1109	192157	123089257	123094257
NM_020696	chr3	-	44790235	44803173	KIAA1143	12938	44800673	44805673
NM_001080392	chr7	-	141356527	141401953	KIAA1147	45426	141399453	141404453
NM_020702	chr9	-	34366663	34376894	KIAA1161	10231	34374394	34379394
NR_109798	chr5	-	175773063	175788810	KIAA1191	15747	175786310	175791310
NM_020721	chrX	-	118212597	118284542	KIAA1210	71945	118282042	118287042
NM_020722	chr4	+	57036360	57196890	KIAA1211	160530	57033860	57038860
NM_207362	chr2	-	99410308	99552684	KIAA1211L	142376	99550184	99555184
NM_001098500	chr10	+	23983674	24836777	KIAA1217	853103	23981174	23986174
NM_001348521	chr3	-	128628708	128722773	KIAA1257	94065	128720273	128725273
NM_020775	chr1	+	109656584	109749403	KIAA1324	92819	109654084	109659084
NM_001142749	chr7	-	86506222	86689014	KIAA1324L	182792	86686514	86691514
NR_136303	chr18	+	34409068	34812090	KIAA1328	403022	34406568	34411568
NM_020844	chr8	+	12803182	12887284	KIAA1456	84102	12800682	12805682
NM_001346235	chr18	+	59854523	59974355	KIAA1468	119832	59852023	59857023
NM_020888	chr1	+	33207511	33240571	KIAA1522	33060	33205011	33210011
NM_001164665	chr7	-	138516126	138666064	KIAA1549	149938	138663564	138668564
NM_012194	chr11	+	33563876	33695646	KIAA1549L	131770	33561376	33566376
NM_018169	chr12	+	32112352	32146043	KIAA1551	33691	32109852	32114852
NM_020931	chr6	+	56911329	56920037	KIAA1586	8708	56908829	56913829
NM_020950	chr1	+	180882312	180915239	KIAA1614	32927	180879812	180884812
NR_145481	chr1	-	180918826	180924023	KIAA1614-AS1	5197	180921523	180926523
NM_001099294	chr22	-	44639556	44708731	KIAA1644	69175	44706231	44711231
NR_046312	chr22	-	30764799	30773894	KIAA1656	9095	30771394	30776394
NM_001145206	chr22	+	25423940	25593415	KIAA1671	169475	25421440	25426440
NM_001145305	chr19	-	18367905	18385319	KIAA1683	17414	18382819	18387819
NM_001348708	chr20	-	36838906	36889174	KIAA1755	50268	36886674	36891674
NM_001330433	chr2	+	61293004	61365169	KIAA1841	72165	61290504	61295504
NM_001287038	chr9	+	115249247	115427591	KIAA1958	178344	115246747	115251747
NM_001277372	chr2	+	202937975	203069924	KIAA2012	131949	202935475	202940475
NM_138346	chr1	-	11979644	11986485	KIAA2013	6841	11983985	11988985
NM_001017969	chr9	-	5919007	6008003	KIAA2026	88996	6005503	6010503
NM_001348738	chr2	-	8861263	8977769	KIDINS220	116506	8975269	8980269
NM_004523	chr10	+	94352824	94415152	KIF11	62328	94350324	94355324
NM_138424	chr9	-	116853917	116861337	KIF12	7420	116858837	116863837
NM_001105568	chr6	-	17759413	17987854	KIF13A	228441	17985354	17990354
NM_015254	chr8	-	28924794	29120610	KIF13B	195816	29118110	29123110
NM_014875	chr1	-	200520624	200589862	KIF14	69238	200587362	200592362
NM_020242	chr3	+	44803208	44894748	KIF15	91540	44800708	44805708
NM_001199865	chr20	-	16252748	16554079	KIF16B	301331	16551579	16556579
NM_001287212	chr1	-	20990506	21044510	KIF17	54004	21042010	21047010
NM_031217	chr11	-	28042162	28129746	KIF18A	87584	28127246	28132246
NM_001264573	chr17	-	43002078	43025079	KIF18B	23001	43022579	43027579
NM_153209	chr17	+	72322350	72351959	KIF19	29609	72319850	72324850
NM_001244008	chr2	-	241653180	241759725	KIF1A	106545	241757225	241762225
NM_015074	chr1	+	10270763	10441661	KIF1B	170898	10268263	10273263
NM_015634	chr10	+	70748476	70776739	KIF1BP	28263	70745976	70750976
NM_006612	chr17	+	4901242	4931694	KIF1C	30452	4898742	4903742
NM_005733	chr5	+	137514416	137523404	KIF20A	8988	137511916	137516916
NM_001284259	chr10	+	91461346	91534700	KIF20B	73354	91458846	91463846
NM_001173463	chr12	-	39687029	39837192	KIF21A	150163	39834692	39839692
NM_001252102	chr1	-	200938513	200992828	KIF21B	54315	200990328	200995328
NM_001256269	chr16	+	29802033	29816706	KIF22	14673	29799533	29804533
NM_001281301	chr15	+	69706584	69740766	KIF23	34182	69704084	69709084
NM_194313	chr9	-	34252377	34329247	KIF24	76870	34326747	34331747
NM_030615	chr6	+	168418552	168445769	KIF25	27217	168416052	168421052
NR_103750	chr6	-	168394866	168397757	KIF25-AS1	2891	168395257	168400257
NM_015656	chr14	+	104605059	104647235	KIF26A	42176	104602559	104607559
NM_018012	chr1	+	245318286	245872734	KIF26B	554448	245315786	245320786
NM_001271927	chr9	-	86451614	86536380	KIF27	84766	86533880	86538880
NM_001243953	chr5	+	61601988	61683011	KIF2A	81023	61599488	61604488
NM_001297655	chr1	+	45205489	45233438	KIF2C	27949	45202989	45207989
NM_001300792	chr5	-	132028318	132073270	KIF3A	44952	132070770	132075770
NM_004798	chr20	+	30865453	30922811	KIF3B	57358	30862953	30867953
NM_002254	chr2	-	26149454	26205443	KIF3C	55989	26202943	26207943
NM_012310	chrX	+	69509878	69640774	KIF4A	130896	69507378	69512378
NM_001099293	chr5	+	154393314	154397692	KIF4B	4378	154390814	154395814
NM_004984	chr12	+	57943846	57978554	KIF5A	34708	57941346	57946346
NM_004521	chr10	-	32297937	32345371	KIF5B	47434	32342871	32347871
NM_004522	chr2	+	149632791	149883273	KIF5C	250482	149630291	149635291
NM_145027	chr6	-	39297765	39693199	KIF6	395434	39690699	39695699
NM_198525	chr15	-	90171200	90198682	KIF7	27482	90196182	90201182
NM_001134878	chr3	-	47269515	47324337	KIF9	54822	47321837	47326837
NR_033373	chr3	+	47205859	47285606	KIF9-AS1	79747	47203359	47208359
NM_001204514	chr1	-	169890469	170043879	KIFAP3	153410	170041379	170046379
NM_002263	chr6_ssto_hap7	+	4839528	4857918	KIFC1	18390	4837028	4842028
NM_145754	chr8	+	145691719	145699499	KIFC2	7780	145689219	145694219
NM_001318710	chr16	-	57792128	57836936	KIFC3	44808	57834436	57839436
NR_045609	chr10	-	7792924	7829990	KIN	37066	7827490	7832490
NM_014218	chr19	+	55281264	55295778	KIR2DL1	14514	55278764	55283764
NM_014219	chr19_gl000209_random	+	21910	36449	KIR2DL2	14539	19410	24410
NM_015868	chr19	+	55249973	55264504	KIR2DL3	14531	55247473	55252473
NM_002255	chr19_gl000209_random	+	57208	68123	KIR2DL4	10915	54708	59708
NM_020535	chr19_gl000209_random	+	86690	96155	KIR2DL5A	9465	84190	89190
NM_001018081	chr19_gl000209_random	+	86745	96246	KIR2DL5B	9501	84245	89245
NM_014512	chr19_gl000209_random	+	115098	129113	KIR2DS1	14015	112598	117598
NM_001291700	chr19_gl000209_random	+	21904	129563	KIR2DS2	107659	19404	24404
NM_012313	chr19_gl000209_random	+	98134	112667	KIR2DS3	14533	95634	100634
NM_012314	chr19	+	55344130	55360024	KIR2DS4	15894	55341630	55346630
NM_014513	chr19_gl000209_random	+	98111	113132	KIR2DS5	15021	95611	100611
NM_013289	chr19	+	55327892	55342233	KIR3DL1	14341	55325392	55330392
NM_006737	chr19	+	55361897	55378670	KIR3DL2	16773	55359397	55364397
NM_153443	chr19	+	55235951	55248003	KIR3DL3	12052	55233451	55238451
NM_001282170	chr19_gl000209_random	+	70070	84658	KIR3DS1	14588	67570	72570
NR_026716	chr19	+	55043908	55057024	KIR3DX1	13116	55041408	55046408
NM_001286349	chr1	+	157963062	158070052	KIRREL1	106990	157960562	157965562
NR_145471	chr1	+	157995339	158001888	KIRREL1-IT1	6549	157992839	157997839
NM_199180	chr19	+	36347809	36358048	KIRREL2	10239	36345309	36350309
NM_001301097	chr11	-	126293395	126870766	KIRREL3	577371	126868266	126873266
NR_046986	chr11	+	126810641	126814986	KIRREL3-AS2	4345	126808141	126813141
NR_040078	chr11	+	126872804	126875953	KIRREL3-AS3	3149	126870304	126875304
NM_002256	chr1	-	204159468	204165619	KISS1	6151	204163119	204168119
NM_032551	chr19	+	917341	921015	KISS1R	3674	914841	919841
NM_000222	chr4	+	55524094	55606881	KIT	82787	55521594	55526594
NM_003994	chr12	-	88886569	88974250	KITLG	87681	88971750	88976750
NM_018474	chr20	+	21106615	21227258	KIZ	120643	21104115	21109115
NR_109956	chr20	-	21175043	21198927	KIZ-AS1	23884	21196427	21201427
NM_004795	chr13	+	33590570	33640282	KL	49712	33588070	33593070
NM_175737	chr4	+	39408472	39453153	KLB	44681	39405972	39410972
NM_001130107	chr14	+	104095524	104167888	KLC1	72364	104093024	104098024
NM_001134775	chr11	+	66024764	66035331	KLC2	10567	66022264	66027264
NM_177417	chr19	+	45843997	45854778	KLC3	10781	45841497	45846497
NM_001289035	chr6	+	43027331	43042837	KLC4	15506	43024831	43029831
NM_006563	chr19	-	12995235	12998017	KLF1	2782	12995517	13000517
NM_005655	chr8	-	103661004	103668130	KLF10	7126	103665630	103670630
NM_003597	chr2	+	10183681	10194963	KLF11	11282	10181181	10186181
NM_007249	chr13	-	74260148	74708066	KLF12	447918	74705566	74710566
NM_001302461	chr15	+	31619057	31727868	KLF13	108811	31616557	31621557
NM_014079	chr3	-	126061477	126076236	KLF15	14759	126073736	126078736
NM_031918	chr19	-	1852397	1863564	KLF16	11167	1861064	1866064
NM_173484	chr1	+	44584521	44600809	KLF17	16288	44582021	44587021
NM_016270	chr19	+	16435636	16439473	KLF2	3837	16433136	16438136
NM_016531	chr4	+	38665789	38703129	KLF3	37340	38663289	38668289
NR_026804	chr4	-	38614321	38666249	KLF3-AS1	51928	38663749	38668749
NM_004235	chr9	-	110247132	110252001	KLF4	4869	110249501	110254501
NM_001286818	chr13	+	73629113	73651680	KLF5	22567	73626613	73631613
NM_001160125	chr10	-	3818187	3827473	KLF6	9286	3824973	3829973
NM_001270943	chr2	-	207938861	208031970	KLF7	93109	208029470	208034470
NM_001324105	chrX	+	55934555	56317963	KLF8	383408	55932055	55937055
NM_001206	chr9	-	72999512	73029573	KLF9	30061	73027073	73032073
NM_172193	chr14	+	50159822	50219870	KLHDC1	60048	50157322	50162322
NM_014997	chr7	+	129710348	129775560	KLHDC10	65212	129707848	129712848
NM_014315	chr14	+	50234786	50249856	KLHDC2	15070	50232286	50237286
NM_057161	chr6	+	42981840	42989036	KLHDC3	7196	42979340	42984340
NM_001184854	chr16	-	87741417	87799598	KLHDC4	58181	87797098	87802098
NM_152375	chr1	+	18807423	18812480	KLHDC7A	5057	18804923	18809923
NM_138433	chr22	+	50986461	50989452	KLHDC7B	2991	50983961	50988961
NM_001271864	chr1	-	205305192	205326218	KLHDC8A	21026	205323718	205328718
NM_173546	chr3	+	49209017	49213919	KLHDC8B	4902	49206517	49211517
NM_020866	chr13	-	70274724	70682625	KLHL1	407901	70680125	70685125
NM_001329595	chr17	+	39991936	40004615	KLHL10	12679	39989436	39994436
NM_018143	chr17	-	40004770	40021684	KLHL11	16914	40019184	40024184
NM_001303051	chr1	-	202860223	202897772	KLHL12	37549	202895272	202900272
NM_001168301	chrX	-	117031775	117251303	KLHL13	219528	117248803	117253803
NM_020805	chr18	-	30252635	30352974	KLHL14	100339	30350474	30355474
NM_030624	chrX	-	24001832	24045303	KLHL15	43471	24042803	24047803
NM_198317	chr1	+	895966	901099	KLHL17	5133	893466	898466
NM_025010	chr3	+	47324329	47388306	KLHL18	63977	47321829	47326829
NM_007246	chr4	+	166128769	166244308	KLHL2	115539	166126269	166131269
NM_014458	chr1	+	173684079	173755840	KLHL20	71761	173681579	173686579
NM_014851	chr1	-	6650783	6662958	KLHL21	12175	6660458	6665458
NM_032775	chr22	-	20795805	20850170	KLHL22	54365	20847670	20852670
NM_144711	chr2	+	170590355	170608396	KLHL23	18041	170587855	170592855
NM_001349417	chr3	+	183353410	183402304	KLHL24	48894	183350910	183355910
NM_022480	chr15	-	86302558	86338189	KLHL25	35631	86335689	86340689
NM_018316	chr19	+	18747774	18781309	KLHL26	33535	18745274	18750274
NM_017658	chr14	-	45393512	45431179	KLHL28	37667	45428679	45433679
NM_052920	chr2	+	23608297	23931483	KLHL29	323186	23605797	23610797
NM_017415	chr5	-	136953188	137071779	KLHL3	118591	137069279	137074279
NM_198582	chr2	+	239047362	239061547	KLHL30	14185	239044862	239049862
NM_001003760	chr6	-	53512698	53530506	KLHL31	17808	53528006	53533006
NM_001323258	chr6	+	97345958	97562618	KLHL32	216660	97343458	97348458
NM_001109997	chr14	-	20896969	20903801	KLHL33	6832	20901301	20906301
NM_153270	chrX	-	21673466	21676505	KLHL34	3039	21674005	21679005
NM_001039548	chr11	-	75133437	75141674	KLHL35	8237	75139174	75144174
NM_001303451	chr16	+	84682116	84701292	KLHL36	19176	84679616	84684616
NM_001081675	chr8	-	124657914	124665190	KLHL38	7276	124662690	124667690
NM_019117	chrX	+	86772714	86925050	KLHL4	152336	86770214	86775214
NM_152393	chr3	+	42727010	42733938	KLHL40	6928	42724510	42729510
NM_006063	chr2	+	170366211	170382772	KLHL41	16561	170363711	170368711
NM_020782	chr12	+	27933186	27955973	KLHL42	22787	27930686	27935686
NM_001171654	chr4	+	39046450	39127853	KLHL5	81403	39043950	39048950
NM_130446	chr3	-	183205315	183273500	KLHL6	68185	183271e3	183276e3
NR_046687	chr3	+	183266522	183270114	KLHL6-AS1	3592	183264022	183269022
NR_033328	chr7	+	23145352	23215038	KLHL7	69686	23142852	23147852
NR_046220	chr7	-	23140846	23145322	KLHL7-AS1	4476	23142822	23147822
NM_020803	chr4	-	88081255	88141760	KLHL8	60505	88139260	88144260
NM_018847	chr9	-	21329669	21335431	KLHL9	5762	21332931	21337931
NM_002257	chr19	-	51322401	51327043	KLK1	4642	51324543	51329543
NM_001077500	chr19	-	51515999	51523431	KLK10	7432	51520931	51525931
NM_001167605	chr19	-	51525486	51531290	KLK11	5804	51528790	51533790
NM_019598	chr19	-	51532347	51538148	KLK12	5801	51535648	51540648
NM_015596	chr19	-	51558882	51568367	KLK13	9485	51565867	51570867
NM_001311182	chr19	-	51580751	51587467	KLK14	6716	51584967	51589967
NM_001277081	chr19	-	51328544	51334779	KLK15	6235	51332279	51337279
NM_001256080	chr19	+	51376688	51383823	KLK2	7135	51374188	51379188
NM_001030047	chr19	+	51358170	51364020	KLK3	5850	51355670	51360670
NM_004917	chr19	-	51409607	51413994	KLK4	4387	51411494	51416494
NM_012427	chr19	-	51446558	51456344	KLK5	9786	51453844	51458844
NM_001319948	chr19	-	51461886	51472929	KLK6	11043	51470429	51475429
NM_001207053	chr19	-	51479734	51487320	KLK7	7586	51484820	51489820
NM_144507	chr19	-	51499263	51504958	KLK8	5695	51502458	51507458
NM_012315	chr19	-	51505768	51512890	KLK9	7122	51510390	51515390
NM_000892	chr4	+	187148624	187179628	KLKB1	31004	187146124	187151124
NR_002948	chr19	-	51385351	51399654	KLKP1	14303	51397154	51402154
NM_001126049	chr10	-	89618917	89623194	KLLN	4277	89620694	89625694
NR_028045	chr12	-	10741076	10752434	KLRA1P	11358	10749934	10754934
NM_002258	chr12	-	9747869	9760497	KLRB1	12628	9757997	9762997
NM_001304448	chr12	-	10594862	10607284	KLRC1	12422	10604784	10609784
NM_002260	chr12	-	10583205	10588592	KLRC2	5387	10586092	10591092
NM_002261	chr12	-	10564913	10573194	KLRC3	8281	10570694	10575694
NM_001199805	chr12	-	10524951	10562745	KLRC4-KLRK1	37794	10560245	10565245
NM_001351060	chr12	+	10391559	10469850	KLRD1	78291	10389059	10394059
NM_016523	chr12	+	9980076	9997603	KLRF1	17527	9977576	9982576
NM_001190765	chr12	+	10034087	10048432	KLRF2	14345	10031587	10036587
NM_001329102	chr12	+	9102639	9163340	KLRG1	60701	9100139	9105139
NM_198508	chr7	-	139138087	139168457	KLRG2	30370	139165957	139170957
NM_007360	chr12	-	10524951	10542653	KLRK1	17702	10540153	10545153
NM_003679	chr1	+	241695433	241758949	KMO	63516	241692933	241697933
NM_005933	chr11	+	118307204	118397539	KMT2A	90335	118304704	118309704
NM_014727	chr19	+	36208920	36229781	KMT2B	20861	36206420	36211420
NM_170606	chr7	-	151832009	152133090	KMT2C	301081	152130590	152135590
NM_003482	chr12	-	49412757	49449107	KMT2D	36350	49446607	49451607
NM_018682	chr7	+	104654636	104754532	KMT2E	99896	104652136	104657136
NR_024586	chr7	-	104650988	104654588	KMT2E-AS1	3600	104652088	104657088
NM_001324504	chr12	+	123868662	123893900	KMT5A	25238	123866162	123871162
NM_001300908	chr11	-	67922329	67981239	KMT5B	58910	67978739	67983739
NM_032701	chr19	+	55851220	55859489	KMT5C	8269	55848720	55853720
NM_001322255	chr1	-	47011309	47017329	KNCN	6020	47014829	47019829
NM_152643	chr10	+	134973957	135039916	KNDC1	65959	134971457	134976457
NM_000893	chr3	+	186435097	186462199	KNG1	27102	186432597	186437597
NM_144508	chr15	+	40886446	40954881	KNL1	68435	40883946	40888946
NM_001348533	chr16	-	19717673	19729492	KNOP1	11819	19726992	19731992
NM_033286	chr15	+	40674921	40686489	KNSTRN	11568	40672421	40677421
NM_014708	chr12	+	123011792	123110946	KNTC1	99154	123009292	123014292
NR_026698	chr3	-	122140747	122233786	KPNA1	93039	122231286	122236286
NM_002266	chr17	+	66031717	66042975	KPNA2	11258	66029217	66034217
NM_002267	chr13	-	50273442	50367057	KPNA3	93615	50364557	50369557
NM_002268	chr3	-	160212782	160283376	KPNA4	70594	160280876	160285876
NM_002269	chr6	+	117002366	117063030	KPNA5	60664	116999866	117004866
NM_012316	chr1	+	32573643	32642168	KPNA6	68525	32571143	32576143
NM_001145715	chr7	-	98771196	98805112	KPNA7	33916	98802612	98807612
NM_002265	chr17	+	45727203	45761004	KPNB1	33801	45724703	45729703
NM_001025231	chr1	+	152730505	152734529	KPRP	4024	152728005	152733005
NM_007059	chr19	-	47978397	47987521	KPTN	9124	47985021	47990021
NM_004985	chr12	-	25357722	25403865	KRAS	46143	25401365	25406365
NM_001290187	chr7	+	149412101	149431664	KRBA1	19563	149409601	149414601
NM_001304947	chr17	-	8271970	8280029	KRBA2	8059	8277529	8282529
NM_001205272	chr3	+	42977833	42984283	KRBOX1	6450	42975333	42980333
NR_122033	chr3	-	42975735	42978277	KRBOX1-AS1	2542	42975777	42980777
NM_001129900	chrX	+	46306623	46334074	KRBOX4	27451	46304123	46309123
NM_016618	chr2	-	88326721	88355320	KRCC1	28599	88352820	88357820
NM_032045	chr22	+	29469065	29564321	KREMEN1	95256	29466565	29471565
NM_001253725	chr16	+	3014216	3018384	KREMEN2	4168	3011716	3016716
NM_023008	chr19	-	10663760	10676702	KRI1	12942	10674202	10679202
NM_194456	chr7	-	91828282	91875414	KRIT1	47132	91872914	91877914
NM_007043	chr12	-	75891418	75905418	KRR1	14000	75902918	75907918
NM_006121	chr12	-	53068519	53074191	KRT1	5672	53071691	53076691
NM_000421	chr17	-	38974368	38978863	KRT10	4495	38976363	38981363
NM_000223	chr17	-	39017429	39023462	KRT12	6033	39020962	39025962
NM_153490	chr17	-	39657232	39661865	KRT13	4633	39659365	39664365
NM_000526	chr17	-	39738530	39743147	KRT14	4617	39740647	39745647
NM_002275	chr17	-	39669996	39675270	KRT15	5274	39672770	39677770
NM_005557	chr17	-	39766030	39769079	KRT16	3049	39766579	39771579
NR_073414	chr17	+	18343221	18346208	KRT16P1	2987	18340721	18345721
NR_029393	chr17	-	20404826	20407811	KRT16P3	2985	20405311	20410311
NM_000422	chr17	-	39775691	39780882	KRT17	5191	39778382	39783382
NR_146392	chr17	-	16744100	16749186	KRT17P1	5086	16746686	16751686
NR_146075	chr17	+	18330174	18335240	KRT17P2	5066	18327674	18332674
NR_001443	chr17	+	18325494	18328647	KRT17P5	3153	18322994	18327994
NM_199187	chr12	+	53342654	53346685	KRT18	4031	53340154	53345154
NR_028334	chr17	-	26603011	26634408	KRT18P55	31397	26631908	26636908
NM_002276	chr17	-	39679868	39684641	KRT19	4773	39682141	39687141
NM_000423	chr12	-	53038341	53045959	KRT2	7618	53043459	53048459
NM_019010	chr17	-	39032140	39041495	KRT20	9355	39038995	39043995
NM_152349	chr17	-	38811871	38821416	KRT222	9545	38818916	38823916
NM_001282433	chr17	-	39078947	39093895	KRT23	14948	39091395	39096395
NM_019016	chr17	-	38854242	38860002	KRT24	5760	38857502	38862502
NM_181534	chr17	-	38904272	38911584	KRT25	7312	38909084	38914084
NM_181539	chr17	-	38922489	38928411	KRT26	5922	38925911	38930911
NM_181537	chr17	-	38933059	38938786	KRT27	5727	38936286	38941286
NM_181535	chr17	-	38948447	38956211	KRT28	7764	38953711	38958711
NM_057088	chr12	-	53183468	53189892	KRT3	6424	53187392	53192392
NM_002277	chr17	-	39549976	39553844	KRT31	3868	39551344	39556344
NM_002278	chr17	-	39615764	39623638	KRT32	7874	39621138	39626138
NM_004138	chr17	-	39502344	39507064	KRT33A	4720	39504564	39509564
NM_002279	chr17	-	39519745	39526052	KRT33B	6307	39523552	39528552
NM_021013	chr17	-	39533920	39538636	KRT34	4716	39536136	39541136
NM_002280	chr17	-	39632940	39637392	KRT35	4452	39634892	39639892
NM_003771	chr17	-	39642387	39646116	KRT36	3729	39643616	39648616
NM_003770	chr17	-	39576808	39580822	KRT37	4014	39578322	39583322
NM_006771	chr17	-	39592620	39597596	KRT38	4976	39595096	39600096
NM_213656	chr17	-	39114668	39123144	KRT39	8476	39120644	39125644
NM_002272	chr12	-	53200326	53207900	KRT4	7574	53205400	53210400
NM_182497	chr17	-	39133967	39143387	KRT40	9420	39140887	39145887
NR_033415	chr17	-	39782578	39796451	KRT42P	13873	39793951	39798951
NM_000424	chr12	-	52908358	52914243	KRT5	5885	52911743	52916743
NM_005554	chr12	-	52880957	52887181	KRT6A	6224	52884681	52889681
NM_005555	chr12	-	52840434	52845910	KRT6B	5476	52843410	52848410
NM_173086	chr12	-	52862299	52867569	KRT6C	5270	52865069	52870069
NM_005556	chr12	+	52626953	52642709	KRT7	15756	52624453	52629453
NM_033448	chr12	-	52937692	52946931	KRT71	9239	52944431	52949431
NM_001146225	chr12	-	52979372	52995322	KRT72	15950	52992822	52997822
NM_175068	chr12	-	53001353	53012343	KRT73	10990	53009843	53014843
NR_126005	chr12	+	53003634	53009089	KRT73-AS1	5455	53001134	53006134
NM_175053	chr12	-	52959602	52967609	KRT74	8007	52965109	52970109
NM_004693	chr12	-	52817853	52828110	KRT75	10257	52825610	52830610
NM_015848	chr12	-	53161938	53171129	KRT76	9191	53168629	53173629
NM_175078	chr12	-	53083410	53097247	KRT77	13837	53094747	53099747
NM_173352	chr12	-	53231587	53242778	KRT78	11191	53240278	53245278
NM_175834	chr12	-	53215230	53228077	KRT79	12847	53225577	53230577
NR_045962	chr12	-	53290970	53343650	KRT8	52680	53341150	53346150
NM_182507	chr12	-	52562779	52585784	KRT80	23005	52583284	52588284
NM_002281	chr12	-	52679696	52685299	KRT81	5603	52682799	52687799
NM_033033	chr12	-	52787734	52800176	KRT82	12442	52797676	52802676
NM_002282	chr12	-	52708084	52715182	KRT83	7098	52712682	52717682
NM_033045	chr12	-	52771595	52779417	KRT84	7822	52776917	52781917
NM_002283	chr12	-	52753789	52761309	KRT85	7520	52758809	52763809
NM_001320198	chr12	+	52668428	52702947	KRT86	34519	52665928	52670928
NR_146088	chr12	-	52644327	52652292	KRT87P	7965	52649792	52654792
NM_000226	chr17	-	39722093	39728310	KRT9	6217	39725810	39730810
NM_001322457	chr17	-	39253233	39274600	KRTAP4-8	21367	39272100	39277100
NR_021489	chr11	+	1593970	1620414	KRTAP5-AS1	26444	1591470	1596470
NM_001318227	chr17	+	39388751	39412616	KRTAP9-9	23865	39386251	39391251
NM_173852	chr1	-	155141883	155145804	KRTCAP2	3921	155143304	155148304
NM_001168364	chr2	+	27665232	27669348	KRTCAP3	4116	27662732	27667732
NM_001244847	chr19	-	35978225	35981433	KRTDAP	3208	35978933	35983933
NM_014238	chr17	+	25799035	25950718	KSR1	151683	25796535	25801535
NM_173598	chr12	-	117890816	118406028	KSR2	515212	118403528	118408528
NM_001079521	chr14	+	56046924	56151302	KTN1	104378	56044424	56049424
NR_027123	chr14	-	56042874	56046810	KTN1-AS1	3936	56044310	56049310
NM_024069	chr19	+	18668571	18680197	KXD1	11626	18666071	18671071
NM_001350859	chr3	-	134318764	134369887	KY	51123	134367387	134372387
NM_001352988	chr9	-	131595391	131644802	KYAT1	49411	131642302	131647302
NR_146183	chr1	-	89386726	89458431	KYAT3	71705	89455931	89460931
NM_001199241	chr2	+	143635194	143799885	KYNU	164691	143632694	143637694
NM_001278116	chrX	-	153126968	153151628	L1CAM	24660	153149128	153154128
NM_001164835	chr1	+	62660473	62678001	L1TD1	17528	62657973	62662973
NM_024884	chr14	-	50709151	50778947	L2HGDH	69796	50776447	50781447
NM_144581	chr14	-	59939405	59951073	L3HYPDH	11668	59948573	59953573
NM_032107	chr20	+	42136319	42170535	L3MBTL1	34216	42133819	42138819
NM_031488	chr22	+	41601312	41627275	L3MBTL2	25963	41598812	41603812
NM_032438	chr6	+	130339513	130462594	L3MBTL3	123081	130337013	130342013
NM_001330559	chr18	-	5954704	6414918	L3MBTL4	460214	6412418	6417418
NR_110765	chr18	+	6256742	6260933	L3MBTL4-AS1	4191	6254242	6259242
NM_001128303	chr13	+	44453313	44468068	LACC1	14755	44450813	44455813
NM_033277	chr12	-	55024622	55028663	LACRT	4041	55026163	55031163
NM_032857	chr15	+	63413998	63434264	LACTB	20266	63411498	63416498
NM_016027	chr8	-	71549500	71581447	LACTB2	31947	71578947	71583947
NR_038881	chr8	+	71520811	71575513	LACTB2-AS1	54702	71518311	71523311
NM_001289974	chr1	-	23279535	23291923	LACTBL1	12388	23289423	23294423
NM_005558	chr1	-	201349965	201368669	LAD1	18704	201366169	201371169
NM_002286	chr12	+	6881669	6887621	LAG3	5952	6879169	6884169
NM_001289027	chr19	-	54865232	54882163	LAIR1	16931	54879663	54884663
NM_002288	chr19	+	55014012	55021900	LAIR2	7888	55011512	55016512
NM_005559	chr18	-	6941742	7117813	LAMA1	176071	7115313	7120313
NM_000426	chr6	+	129204285	129837710	LAMA2	633425	129201785	129206785
NM_198129	chr18	+	21269406	21535029	LAMA3	265623	21266906	21271906
NM_002290	chr6	-	112429133	112575917	LAMA4	146784	112573417	112578417
NM_005560	chr20	-	60884115	60942368	LAMA5	58253	60939868	60944868
NR_109923	chr20	+	60928065	60931534	LAMA5-AS1	3469	60925565	60930565
NM_002291	chr7	-	107564245	107643804	LAMB1	79559	107641304	107646304
NM_002292	chr3	-	49158546	49170599	LAMB2	12053	49168099	49173099
NM_000228	chr1	-	209788217	209825820	LAMB3	37603	209823320	209828320
NM_001318046	chr7	-	107663995	107770801	LAMB4	106806	107768301	107773301
NM_002293	chr1	+	182992594	183114727	LAMC1	122133	182990094	182995094
NM_005562	chr1	+	183155173	183214262	LAMC2	59089	183152673	183157673
NM_006059	chr9	+	133884503	133968446	LAMC3	83943	133882003	133887003
NM_005561	chr13	+	113951468	113977741	LAMP1	26273	113948968	113953968
NM_002294	chrX	-	119560002	119603204	LAMP2	43202	119600704	119605704
NM_014398	chr3	-	182840002	182880667	LAMP3	40665	182878167	182883167
NM_001199897	chr20	+	9495004	9511171	LAMP5	16167	9492504	9497504
NR_109957	chr20	-	9485826	9495645	LAMP5-AS1	9819	9493145	9498145
NM_017907	chr11	-	71808337	71814433	LAMTOR1	6096	71811933	71816933
NM_001145264	chr1	+	156024516	156028301	LAMTOR2	3785	156022016	156027016
NM_001243736	chr4	-	100799494	100815703	LAMTOR3	16209	100813203	100818203
NM_001318237	chr7	+	99746521	99751835	LAMTOR4	5314	99744021	99749021
NM_006402	chr1	-	110943876	110950546	LAMTOR5	6670	110948046	110953046
NR_102697	chr1	+	110950430	110958896	LAMTOR5-AS1	8466	110947930	110952930
NM_001136575	chr2	-	211295972	211341499	LANCL1	45527	211338999	211343999
NR_110604	chr2	+	211189435	211335057	LANCL1-AS1	145622	211186935	211191935
NM_018697	chr7	+	55433140	55501435	LANCL2	68295	55430640	55435640
NM_001170331	chrX	+	37430821	37536750	LANCL3	105929	37428321	37433321
NM_015907	chr4	+	17578926	17609590	LAP3	30664	17576426	17581426
NM_014713	chr2	-	20232410	20251789	LAPTM4A	19379	20249289	20254289
NM_018407	chr8	+	98787808	98864830	LAPTM4B	77022	98785308	98790308
NM_006762	chr1	-	31205314	31230683	LAPTM5	25369	31228183	31233183
NR_038950	chr22	+	34120971	34146803	LARGE-AS1	25832	34118471	34123471
NM_004737	chr22	-	33668846	34316410	LARGE1	647564	34313910	34318910
NM_001300722	chr11	+	45943171	45950647	LARGE2	7476	45940671	45945671
NM_015315	chr5	+	154092461	154197167	LARP1	104706	154089961	154094961
NR_146772	chr4	+	128982420	129144086	LARP1B	161666	128979920	128984920
NM_199190	chr12	+	50794591	50873788	LARP4	79197	50792091	50797091
NM_015155	chr10	-	852853	977645	LARP4B	124792	975145	980145
NM_018357	chr15	-	71123862	71146604	LARP6	22742	71144104	71149104
NR_049768	chr4	+	113558119	113578748	LARP7	20629	113555619	113560619
NM_001317965	chr5	-	145492588	145562350	LARS	69762	145559850	145564850
NM_015340	chr3	+	45430074	45590328	LARS2	160254	45427574	45432574
NR_048543	chr3	-	45524186	45551037	LARS2-AS1	26851	45548537	45553537
NM_001170649	chrX	-	64732461	64754686	LAS1L	22225	64752186	64757186
NM_001271608	chr17	+	37026111	37078023	LASP1	51912	37023611	37028611
NM_001014989	chr16	+	28996146	29002104	LAT	5958	28993646	28998646
NM_014146	chr7	+	73624086	73644164	LAT2	20078	73621586	73626586
NM_004690	chr6	-	149979288	150039392	LATS1	60104	150036892	150041892
NM_014572	chr13	-	21547175	21635722	LATS2	88547	21633222	21638222
NM_001136190	chr1	+	203734283	203745480	LAX1	11197	203731783	203736783
NM_001318799	chr11	+	111411004	111432470	LAYN	21466	111408504	111413504
NM_030915	chr2	+	30454396	30482899	LBH	28503	30451896	30456896
NM_024099	chr11	-	62430288	62439241	LBHD1	8953	62436741	62441741
NM_004139	chr20	+	36974813	37005653	LBP	30840	36972313	36977313
NM_194442	chr1	-	225589203	225616557	LBR	27354	225614057	225619057
NR_029380	chr10	+	102989350	102998616	LBX1-AS1	9266	102986850	102991850
NM_001009812	chr2	-	74724643	74730443	LBX2	5800	74727943	74732943
NR_130768	chrX	+	153146126	153154427	LCA10	8301	153143626	153148626
NM_181714	chr6	-	80194707	80247147	LCA5	52440	80244647	80249647
NM_152505	chr21	-	40777769	40816128	LCA5L	38359	40813628	40818628
NR_130915	chr6	-	80017385	80023101	LCAL1	5716	80020601	80025601
NM_000229	chr16	-	67973786	67978015	LCAT	4229	67975515	67980515
NM_005356	chr1	+	32716839	32751768	LCK	34929	32714339	32719339
NM_001002257	chr2	+	30670091	30867091	LCLAT1	197000	30667591	30672591
NM_016309	chr16	+	25123046	25189551	LCMT1	66505	25120546	25125546
NR_120306	chr16	-	25111884	25122876	LCMT1-AS1	10992	25120376	25125376
NR_039998	chr16	-	25151891	25160353	LCMT1-AS2	8462	25157853	25162853
NM_014793	chr15	-	43619973	43622820	LCMT2	2847	43620320	43625320
NM_001252619	chr9	+	138413283	138418386	LCN1	5103	138410783	138415783
NM_001001712	chr9	-	139632618	139637411	LCN10	4793	139634911	139639911
NM_178536	chr9	+	139846767	139849949	LCN12	3182	139844267	139849267
NM_203347	chr9	-	139654085	139658965	LCN15	4880	139656465	139661465
NM_005564	chr9	+	130911708	130915734	LCN2	4026	130909208	130914208
NM_198946	chr9	-	139638468	139642980	LCN6	4512	139640480	139645480
NM_001345934	chr9	-	139648839	139652995	LCN8	4156	139650495	139655495
NM_001001676	chr9	+	138555167	138557755	LCN9	2588	138552667	138557667
NM_207510	chr9	+	139877444	139880210	LCNL1	2766	139874944	139879944
NM_001346516	chr10	+	98592016	98745969	LCOR	153953	98589516	98594516
NR_136669	chr4	-	17842821	18023498	LCORL	180677	18020998	18025998
NM_002298	chr13	-	46700057	46756459	LCP1	56402	46753959	46758959
NM_005565	chr5	-	169673236	169724846	LCP2	51610	169722346	169727346
NM_002299	chr2	-	136545409	136594750	LCT	49341	136592250	136597250
NR_103739	chr15	-	66839805	66858317	LCTL	18512	66855817	66860817
NM_001282721	chr2	-	20883773	21022890	LDAH	139117	21020390	21025390
NM_001321612	chr10	-	103866248	103880230	LDB1	13982	103877730	103882730
NM_001304435	chr4	-	16503156	16900432	LDB2	397276	16897932	16902932
NM_001171610	chr10	+	88428205	88495824	LDB3	67619	88425705	88430705
NM_001135239	chr11	+	18415935	18429765	LDHA	13830	18413435	18418435
NM_001144071	chr11	+	18477373	18501147	LDHAL6A	23774	18474873	18479873
NM_002300	chr12	-	21788275	21810789	LDHB	22514	21808289	21813289
NM_017448	chr11	+	18433852	18472793	LDHC	38941	18431352	18436352
NM_153486	chr16	-	75145757	75150670	LDHD	4913	75148170	75153170
NM_001195803	chr19	+	11200037	11244505	LDLR	44468	11197537	11202537
NM_001276392	chr1	-	54472970	54483859	LDLRAD1	10889	54481359	54486359
NM_001013693	chr1	+	22138757	22151714	LDLRAD2	12957	22136257	22141257
NM_001304264	chr11	+	35965530	36253686	LDLRAD3	288156	35963030	35968030
NM_181482	chr18	+	13218728	13652753	LDLRAD4	434025	13216228	13221228
NR_040031	chr18	-	13419497	13427533	LDLRAD4-AS1	8036	13425033	13430033
NM_015627	chr1	+	25870075	25895377	LDLRAP1	25302	25867575	25872575
NM_002302	chr5	-	135282599	135290723	LECT2	8124	135288223	135293223
NM_001130713	chr4	-	108968700	109090112	LEF1	121412	109087612	109092612
NR_029374	chr4	+	109088680	109097586	LEF1-AS1	8906	109086180	109091180
NM_020997	chr1	-	226073981	226076846	LEFTY1	2865	226074346	226079346
NM_001172425	chr1	-	226124297	226129192	LEFTY2	4895	226126692	226131692
NM_001004316	chr3	+	156544095	156763918	LEKR1	219823	156541595	156546595
NM_001001552	chr1	-	205350505	205391214	LEMD1	40709	205388714	205393714
NR_038425	chr1	+	205342379	205356568	LEMD1-AS1	14189	205339879	205344879
NM_181336	chr6	-	33738989	33756906	LEMD2	17917	33754406	33759406
NM_014319	chr12	+	65563350	65642141	LEMD3	78791	65560850	65565850
NM_024316	chr19	-	54659377	54663481	LENG1	4104	54660981	54665981
NM_052925	chr19	+	54960339	54973226	LENG8	12887	54957839	54962839
NR_126418	chr19	-	54955993	54960216	LENG8-AS1	4223	54957716	54962716
NM_138792	chr15	-	52230221	52263998	LEO1	33777	52261498	52266498
NM_000230	chr7	+	127881330	127897682	LEP	16352	127878830	127883830
NM_002303	chr1	+	65886334	66103176	LEPR	216842	65883834	65888834
NM_017526	chr1	+	65886130	65901690	LEPROT	15560	65883630	65888630
NM_001128208	chr8	+	29952921	29995222	LEPROTL1	42301	29950421	29955421
NM_012318	chr4	-	1813205	1857974	LETM1	44769	1855474	1860474
NM_001199659	chr8	+	38243958	38267042	LETM2	23084	38241458	38246458
NR_045020	chr12	+	51442081	51462721	LETMD1	20640	51439581	51444581
NM_001143832	chr19	+	40267233	40276775	LEUTX	9542	40264733	40269733
NM_152607	chr1	+	55271735	55307937	LEXM	36202	55269235	55274235
NM_001166355	chr7	+	2552162	2568063	LFNG	15901	2549662	2554662
NM_002305	chr22	+	38071612	38075809	LGALS1	4197	38069112	38074112
NM_033101	chr11	+	63273523	63284246	LGALS12	10723	63271023	63276023
NM_013268	chr19	+	40093168	40098114	LGALS13	4946	40090668	40095668
NM_020129	chr19	+	40194945	40200088	LGALS14	5143	40192445	40197445
NM_001190441	chr19	+	40146533	40151287	LGALS16	4754	40144033	40149033
NR_034156	chr19	+	40170013	40177013	LGALS17A	7000	40167513	40172513
NM_006498	chr22	-	37966252	37976024	LGALS2	9772	37973524	37978524
NM_002306	chr14	+	55595934	55612148	LGALS3	16214	55593434	55598434
NM_005567	chr17	-	76967334	76976061	LGALS3BP	8727	76973561	76978561
NM_006149	chr19	-	39292310	39303740	LGALS4	11430	39301240	39306240
NM_002307	chr19	-	39261607	39264157	LGALS7	2550	39261657	39266657
NM_001042507	chr19	+	39279849	39282394	LGALS7B	2545	39277349	39282349
NM_201545	chr1	+	236681513	236716279	LGALS8	34766	236679013	236684013
NR_024043	chr17	+	25958173	25976586	LGALS9	18413	25955673	25960673
NM_001042685	chr17	-	20353175	20370848	LGALS9B	17673	20368348	20373348
NM_001040078	chr17	+	18380098	18398259	LGALS9C	18161	18377598	18382598
NM_014181	chr2	+	64681326	64688517	LGALSL	7191	64678826	64683826
NM_001308276	chr10	+	95517565	95557931	LGI1	40366	95515065	95520065
NM_018176	chr4	-	25000470	25032414	LGI2	31944	25029914	25034914
NM_139278	chr8	-	22004342	22014344	LGI3	10002	22011844	22016844
NM_139284	chr19	-	35615416	35626178	LGI4	10762	35623678	35628678
NM_005606	chr14	-	93170151	93215047	LGMN	44896	93212547	93217547
NM_018490	chr11	-	27387507	27494322	LGR4	106815	27491822	27496822
NM_003667	chr12	+	71833549	71980088	LGR5	146539	71831049	71836049
NM_001017403	chr1	+	202163117	202288889	LGR6	125772	202160617	202165617
NM_001143940	chr6	-	63985855	64029882	LGSN	44027	64027382	64032382
NM_000233	chr2	-	48913912	48982880	LHCGR	68968	48980380	48985380
NM_178175	chrX	-	111873878	111923375	LHFPL1	49497	111920875	111925875
NM_005779	chr5	-	77781037	77944648	LHFPL2	163611	77942148	77947148
NM_199000	chr7	+	103969103	104549003	LHFPL3	579900	103966603	103971603
NR_034141	chr7	-	104436953	104444539	LHFPL3-AS1	7586	104442039	104447039
NR_027374	chr7	-	104535074	104567092	LHFPL3-AS2	32018	104564592	104569592
NM_198560	chr3	-	9540044	9595486	LHFPL4	55442	9592986	9597986
NM_182548	chr6	+	35773070	35791852	LHFPL5	18782	35770570	35775570
NM_005780	chr13	-	39917028	40177356	LHFPL6	260328	40174856	40179856
NM_001318331	chr10	+	126150340	126302710	LHPP	152370	126147840	126152840
NM_005568	chr17	+	35294771	35301915	LHX1	7144	35292271	35297271
NM_004789	chr9	+	126773888	126795442	LHX2	21554	126771388	126776388
NM_178138	chr9	-	139088095	139096975	LHX3	8880	139094475	139099475
NM_033343	chr1	+	180199432	180244188	LHX4	44756	180196932	180201932
NR_037642	chr1	-	180238797	180243816	LHX4-AS1	5019	180241316	180246316
NM_022363	chr12	-	113900693	113909877	LHX5	9184	113907377	113912377
NR_126425	chr12	+	113909807	113918286	LHX5-AS1	8479	113907307	113912307
NM_014368	chr9	-	124964855	124991091	LHX6	26236	124988591	124993591
NM_001001933	chr1	+	75594118	75627218	LHX8	33100	75591618	75596618
NM_001014434	chr1	+	197881634	197899273	LHX9	17639	197879134	197884134
NM_001278590	chr4	+	39460643	39479271	LIAS	18628	39458143	39463143
NM_001257135	chr22	-	30636435	30642840	LIF	6405	30640340	30645340
NM_002310	chr5	-	38475064	38595507	LIFR	120443	38593007	38598007
NR_103554	chr5	+	38556887	38671318	LIFR-AS1	114431	38554387	38559387
NM_000234	chr19	-	48618701	48673860	LIG1	55159	48671360	48676360
NM_013975	chr17	+	33307516	33332088	LIG3	24572	33305016	33310016
NM_001352598	chr13	-	108859790	108870716	LIG4	10926	108868216	108873216
NR_103501	chr19	+	55105040	55113846	LILRA1	8806	55102540	55107540
NM_001290271	chr19	+	55084463	55099028	LILRA2	14565	55081963	55086963
NM_006865	chr19	-	54799849	54804265	LILRA3	4416	54801765	54806765
NM_012276	chr19	-	54844455	54850440	LILRA4	5985	54847940	54852940
NM_181985	chr19	-	54818352	54824409	LILRA5	6057	54821909	54826909
NR_104098	chr19	-	54740467	54746617	LILRA6	6150	54744117	54749117
NM_006669	chr19	+	55128383	55148981	LILRB1	20598	55125883	55130883
NM_001278404	chr19	-	54777674	54785033	LILRB2	7359	54782533	54787533
NM_006864	chr19	-	54720146	54746711	LILRB3	26565	54744211	54749211
NM_001278427	chr19	+	55174270	55181810	LILRB4	7540	55171770	55176770
NM_001304457	chr19	-	54754268	54761171	LILRB5	6903	54758671	54763671
NR_003061	chr19	+	55219699	55224955	LILRP2	5256	55217199	55222199
NM_001161748	chr19	-	51883162	51891210	LIM2	8048	51888710	51893710
NM_001113546	chr12	-	50569562	50677353	LIMA1	107791	50674853	50679853
NM_001289124	chr4	+	41361623	41702061	LIMCH1	340438	41359123	41364123
NM_014240	chr3	+	45636322	45722755	LIMD1	86433	45633822	45638822
NR_033947	chr3	-	45719656	45730374	LIMD1-AS1	10718	45727874	45732874
NM_030576	chr17	-	61773248	61777519	LIMD2	4271	61775019	61780019
NM_001305654	chr20	+	62367052	62370460	LIME1	3408	62364552	62369552
NM_002314	chr7	+	73498106	73536855	LIMK1	38749	73495606	73500606
NM_005569	chr22	+	31608249	31676066	LIMK2	67817	31605749	31610749
NM_001193483	chr2	+	109150810	109303702	LIMS1	152892	109148310	109153310
NM_001161404	chr2	-	128395995	128439360	LIMS2	43365	128436860	128441860
NR_027467	chr2	+	110656008	110683202	LIMS3	27194	110653508	110658508
NR_027145	chr2	-	111160495	111230652	LIMS3-LOC440895	70157	111228152	111233152
NR_038099	chr2	+	110656008	110683202	LIMS4	27194	110653508	110658508
NM_024674	chr1	+	26737258	26756219	LIN28A	18961	26734758	26739758
NM_001004317	chr6	+	105404922	105531207	LIN28B	126285	105402422	105407422
NR_046407	chr6	-	105384168	105388402	LIN28B-AS1	4234	105385902	105390902
NM_019104	chr19	+	36239261	36245420	LIN37	6159	36236761	36241761
NM_001024674	chr14	+	74551655	74667117	LIN52	115462	74549155	74554155
NM_001115007	chr4	-	83845756	83934094	LIN54	88338	83931594	83936594
NR_136888	chr12	-	81186299	81331694	LIN7A	145395	81329194	81334194
NM_001308419	chr19	+	49617617	49621717	LIN7B	4100	49615117	49620117
NM_018362	chr11	-	27515964	27528326	LIN7C	12362	27525826	27530826
NM_001270410	chr1	-	226418849	226497449	LIN9	78600	226494949	226499949
NR_109855	chr7	-	130626518	130794675	LINC-PINT	168157	130792175	130797175
NR_048536	chr18	-	54721803	54739350	LINC-ROR	17547	54736850	54741850
NR_028295	chr20	-	61665568	61668380	LINC00029	2812	61665880	61670880
NR_026679	chr9	-	27245681	27282791	LINC00032	37110	27280291	27285291
NR_024378	chr8	+	143279716	143290364	LINC00051	10648	143277216	143282216
NR_026869	chr15	+	88120159	88122917	LINC00052	2758	88117659	88122659
NR_015427	chr9	+	136890560	136896719	LINC00094	6159	136888060	136893060
NR_024367	chr21	+	43099461	43117496	LINC00111	18035	43096961	43101961
NR_024357	chr21	+	29094697	29123552	LINC00113	28855	29092197	29097197
NR_027065	chr21	-	40110948	40145401	LINC00114	34453	40142901	40147901
NR_027063	chr2	-	110969105	110980517	LINC00116	11412	110978017	110983017
NR_024027	chr21	-	26758132	26804013	LINC00158	45881	26801513	26806513
NR_038033	chr21	-	33452793	33458608	LINC00159	5815	33456108	33461108
NR_024351	chr21	-	36096104	36109479	LINC00160	13375	36106979	36111979
NR_033840	chr21	-	46409778	46414001	LINC00163	4223	46411501	46416501
NR_024233	chr11	+	129872518	129875381	LINC00167	2863	129870018	129875018
NR_027346	chr12	+	116971239	116974318	LINC00173	3079	116968739	116973739
NR_026873	chr7	-	65841030	65865395	LINC00174	24365	65862895	65867895
NR_033927	chr1	+	234765056	234770526	LINC00184	5470	234762556	234767556
NR_027072	chr21	+	30565814	30660526	LINC00189	94712	30563314	30568314
NR_015376	chr10	+	1205707	1210612	LINC00200	4905	1203207	1208207
NR_028409	chr22	+	44965219	44968329	LINC00207	3110	44962719	44967719
NR_040035	chr8	+	11434043	11438850	LINC00208	4807	11431543	11436543
NR_048550	chr1	+	218066241	218094146	LINC00210	27905	218063741	218068741
NR_110012	chr2	-	38053389	38103006	LINC00211	49617	38100506	38105506
NR_027457	chr14	+	106938444	106951529	LINC00221	13085	106935944	106940944
NR_033376	chr6	+	109072856	109091145	LINC00222	18289	109070356	109075356
NR_044991	chr22	-	45002207	45021299	LINC00229	19092	45018799	45023799
NR_147212	chr20	-	21068244	21086999	LINC00237	18755	21084499	21089499
NR_026775	chr6	+	26924771	26991753	LINC00240	66982	26922271	26927271
NR_026781	chr6	-	170188885	170198921	LINC00242	10036	170196421	170201421
NR_130726	chr6_cox_hap2	-	2292696	2310496	LINC00243	17800	2307996	2312996
NR_147207	chr4	-	6689174	6692246	LINC002481	3072	6689746	6694746
NR_038901	chr8	-	66073379	66092575	LINC00251	19196	66090075	66095075
NR_033914	chr16	-	1928285	1934232	LINC00254	5947	1931732	1936732
NR_001558	chr20	-	22541191	22559280	LINC00261	18089	22556780	22561780
NR_026999	chr7	+	39773166	39834222	LINC00265	61056	39770666	39775666
NR_040415	chr20	+	62921737	62934707	LINC00266-1	12970	62919237	62924237
NR_109817	chrUn_gl000227	-	66129	74245	LINC00266-3	8116	71745	76745
NR_103715	chrX	+	68399399	68429767	LINC00269	30368	68396899	68401899
NR_026805	chr6	+	135818938	136011976	LINC00271	193038	135816438	135821438
NR_034131	chr1	+	182376755	182383948	LINC00272	7193	182374255	182379255
NR_103814	chr2	-	14368997	14541082	LINC00276	172085	14538582	14543582
NR_046502	chrY	+	2871036	2970313	LINC00278	99277	2868536	2873536
NR_138045	chrY	+	8506334	8513170	LINC00279	6836	8503834	8508834
NR_046505	chrY	-	6225259	6229454	LINC00280	4195	6226954	6231954
NM_001351003	chr13	-	52387482	52419288	LINC00282	31806	52416788	52421788
NR_026955	chr13	+	44596470	44604599	LINC00284	8129	44593970	44598970
NR_033918	chr4	-	181985242	182080302	LINC00290	95060	182077802	182082802
NR_027012	chr8	+	47752507	47767407	LINC00293	14900	47750007	47755007
NR_015451	chr11	+	33097695	33101000	LINC00294	3305	33095195	33100195
NR_046510	chr13	-	30446749	30462542	LINC00297	15793	30460042	30465042
NR_015405	chr2	-	8062555	8116945	LINC00298	54390	8114445	8119445
NR_034135	chr2	-	8147900	8468549	LINC00299	320649	8466049	8471049
NR_026946	chr11	+	60383223	60454621	LINC00301	71398	60380723	60385723
NR_027902	chr1	-	204001574	204010392	LINC00303	8818	204007892	204012892
NR_024347	chr16	+	89225627	89230083	LINC00304	4456	89223127	89228127
NR_027245	chr18	-	61747242	61816260	LINC00305	69018	61813760	61818760
NR_038855	chr21	-	31581468	31584101	LINC00307	2633	31581601	31586601
NR_038400	chr21	+	23470935	23488847	LINC00308	17912	23468435	23473435
NR_033837	chr2	-	64412212	64432619	LINC00309	20407	64430119	64435119
NR_027266	chr21	+	35552977	35562220	LINC00310	9243	35550477	35555477
NR_038859	chr16	+	85316563	85321685	LINC00311	5122	85314063	85319063
NR_024065	chr3	+	8613467	8616354	LINC00312	2887	8610967	8615967
NR_026863	chr21	-	44881973	44898103	LINC00313	16130	44895603	44900603
NR_027246	chr21	+	29385681	29395528	LINC00314	9847	29383181	29388181
NR_103811	chr21	-	46758504	46761905	LINC00316	3401	46759405	46764405
NR_038872	chr21	-	23095612	23109639	LINC00317	14027	23107139	23112139
NR_026960	chr21	+	44869903	44873771	LINC00319	3868	44867403	44872403
NR_024090	chr21	-	22114907	22175426	LINC00320	60519	22172926	22177926
NR_103713	chr21	-	44742088	44751919	LINC00322	9831	44749419	44754419
NR_024100	chr21	-	42513426	42519991	LINC00323	6565	42517491	42522491
NR_026951	chr17	-	8123947	8127361	LINC00324	3414	8124861	8129861
NR_026969	chr6	+	133409218	133427717	LINC00326	18499	133406718	133411718
NR_038995	chr13	+	24043650	24061603	LINC00327	17953	24041150	24046150
NR_038433	chr13	-	45373639	45383766	LINC00330	10127	45381266	45386266
NR_046869	chr13	-	79361453	79414185	LINC00331	52732	79411685	79416685
NR_046870	chr13	+	40755945	40763167	LINC00332	7222	40753445	40758445
NR_046871	chr13	+	84714736	85180903	LINC00333	466167	84712236	84717236
NR_135279	chr21	+	46654254	46678645	LINC00334	24391	46651754	46656754
NR_027908	chr6	-	33553882	33561115	LINC00336	7233	33558615	33563615
NR_103534	chr1	+	6296299	6299502	LINC00337	3203	6293799	6298799
NR_023918	chr1	+	22351683	22357717	LINC00339	6034	22349183	22354183
NR_103734	chr2	-	96472799	96492729	LINC00342	19930	96490229	96495229
NR_046391	chr13	+	106359178	106414145	LINC00343	54967	106356678	106361678
NR_027701	chr13	-	111516333	111522655	LINC00346	6322	111520155	111525155
NR_034025	chr13	+	75126979	75131257	LINC00347	4278	75124479	75129479
NR_047699	chr13	+	71589272	71742549	LINC00348	153277	71586772	71591772
NR_046989	chr13	+	85937737	86118797	LINC00351	181060	85935237	85940237
NR_046991	chr13	-	90201047	90216667	LINC00353	15620	90214167	90219167
NR_046992	chr13	+	112547691	112555490	LINC00354	7799	112545191	112550191
NR_145420	chr13	-	64560503	64650144	LINC00355	89641	64647644	64652644
NR_046995	chr13	-	62577657	62603681	LINC00358	26024	62601181	62606181
NR_051966	chr13	-	97593534	97636426	LINC00359	42892	97633926	97638926
NR_126360	chr13	+	93697593	93710179	LINC00363	12586	93695093	93700093
NR_130792	chr13	+	67946518	67954126	LINC00364	7608	67944018	67949018
NR_046998	chr13	-	30677314	30683012	LINC00365	5698	30680512	30685512
NR_046999	chr13	+	39141860	39153653	LINC00366	11793	39139360	39144360
NR_104058	chr13	-	21512702	21523567	LINC00367	10865	21521067	21526067
NR_120415	chr13	+	111748184	111758237	LINC00368	10053	111745684	111750684
NR_132367	chr13	-	58785830	58807251	LINC00374	21421	58804751	58809751
NR_126383	chr13	-	85639221	85722192	LINC00375	82971	85719692	85724692
NR_126409	chr13	-	63757234	63902227	LINC00376	144993	63899727	63904727
NR_125770	chr13	+	81592525	81618577	LINC00377	26052	81590025	81595025
NR_047003	chr13	+	61247088	61269934	LINC00378	22846	61244588	61249588
NR_047004	chr13	-	91779866	91863952	LINC00379	84086	91861452	91866452
NR_104057	chr13	-	91739508	91743693	LINC00380	4185	91741193	91746193
NR_047005	chr13	+	74993309	75009296	LINC00381	15987	74990809	74995809
NR_120413	chr13	+	80446720	80492171	LINC00382	45451	80444220	80449220
NR_125752	chr13	+	69796477	69896231	LINC00383	99754	69793977	69798977
NR_132368	chr13	-	44680226	44721871	LINC00390	41645	44719371	44724371
NR_047009	chr13	+	74138380	74162016	LINC00392	23636	74135880	74140880
NR_047011	chr13	-	64241814	64312151	LINC00395	70337	64309651	64314651
NR_104059	chr13	-	88453297	88462775	LINC00397	9478	88460275	88465275
NR_047012	chr13	+	31377342	31384782	LINC00398	7440	31374842	31379842
NR_047013	chr13	+	43687300	43733602	LINC00400	46302	43684800	43689800
NR_144451	chr13	+	74805580	74834113	LINC00402	28533	74803080	74808080
NR_104118	chr13	+	19479578	19500881	LINC00408	21303	19477078	19482078
NR_027039	chr13	-	91543207	91578851	LINC00410	35644	91576351	91581351
NR_047015	chr13	-	101591774	101596618	LINC00411	4844	101594118	101599118
NR_146971	chr13	-	26626413	26633660	LINC00415	7247	26631160	26636160
NR_047020	chr13	-	33383327	33485790	LINC00423	102463	33483290	33488290
NR_047040	chr13	-	22446934	22452299	LINC00424	5365	22449799	22454799
NR_024464	chr13	-	30914402	30948051	LINC00426	33649	30945551	30950551
NR_126389	chr13	-	43416547	43446880	LINC00428	30333	43444380	43449380
NR_132371	chr13	+	87564174	87589062	LINC00430	24888	87561674	87566674
NR_126378	chr13	+	111618373	111642949	LINC00431	24576	111615873	111620873
NR_047021	chr13	+	89193083	89197764	LINC00433	4681	89190583	89195583
NR_047022	chr13	-	60788480	60842238	LINC00434	53758	60839738	60844738
NR_126377	chr13	-	39106136	39260812	LINC00437	154676	39258312	39263312
NR_047025	chr13	+	89887544	89932494	LINC00440	44950	89885044	89890044
NR_046414	chr13	-	48870648	48877797	LINC00441	7149	48875297	48880297
NR_026852	chr13	+	19582398	19586774	LINC00442	4376	19579898	19584898
NR_047026	chr13	+	107306227	107324528	LINC00443	18301	107303727	107308727
NR_047028	chr13	+	78587017	78627730	LINC00446	40713	78584517	78589517
NR_047029	chr13	-	63246417	63370825	LINC00448	124408	63368325	63373325
NM_001278674	chr13	+	114598075	114624290	LINC00452	26215	114595575	114600575
NR_047035	chr13	-	114581600	114586459	LINC00454	4859	114583959	114588959
NR_125725	chr13	-	97824635	97831876	LINC00456	7241	97829376	97834376
NR_047036	chr13	-	35009590	35214822	LINC00457	205232	35212322	35217322
NR_108062	chr13	-	54698458	54707006	LINC00458	8548	54704506	54709506
NR_047038	chr13	+	62897789	62902968	LINC00459	5179	62895289	62900289
NR_015436	chr5	-	87836596	87980620	LINC00461	144024	87978120	87983120
NR_051983	chr13	-	49151109	49155037	LINC00462	3928	49152537	49157537
NR_120428	chr13	-	25746961	25754139	LINC00463	7178	25751639	25756639
NR_038252	chr1	-	63624753	63782928	LINC00466	158175	63780428	63785428
NR_026761	chr1	+	211556096	211605877	LINC00467	49781	211553596	211558596
NR_027146	chr17	-	71745408	71824676	LINC00469	79268	71822176	71827176
NR_023927	chr18	-	1268311	1359630	LINC00470	91319	1357130	1362130
NR_024079	chr2	-	232373136	232379050	LINC00471	5914	232376550	232381550
NR_121614	chr6	-	72117566	72130448	LINC00472	12882	72127948	72132948
NR_026861	chr6	-	166337535	166401527	LINC00473	63992	166399027	166404027
NR_024032	chr9	-	118650543	118687377	LINC00474	36834	118684877	118689877
NR_027341	chr9	+	94903748	94921890	LINC00475	18142	94901248	94906248
NR_023390	chr9	-	98568369	98638259	LINC00476	69890	98635759	98640759
NR_029451	chr12	-	24719897	24737102	LINC00477	17205	24734602	24739602
NR_027272	chr21	-	43131679	43135935	LINC00479	4256	43133435	43138435
NR_038080	chr17	-	79276623	79283048	LINC00482	6425	79280548	79285548
NR_073199	chr17	-	48838394	48844876	LINC00483	6482	48842376	48847376
NR_135306	chr9	+	93881343	93945044	LINC00484	63701	93878843	93883843
NR_033855	chr12	-	103203060	103218177	LINC00485	15117	103215677	103220677
NR_027098	chr2	+	33050509	33154206	LINC00486	103697	33048009	33053009
NR_038369	chr2	-	6869299	6910442	LINC00487	41143	6907942	6912942
NR_026767	chr3	+	108897011	108904108	LINC00488	7097	108894511	108899511
NR_047461	chr20	-	36247699	36251521	LINC00489	3822	36249021	36254021
NR_103754	chr5	-	101944195	102007168	LINC00491	62973	102004668	102009668
NR_047462	chr5	+	101917071	101953291	LINC00492	36220	101914571	101919571
NR_026958	chr20	+	46988653	46999381	LINC00494	10728	46986153	46991153
NR_051987	chr4	+	139230864	139345498	LINC00499	114634	139228364	139233364
NR_047465	chr3	+	177012229	177041223	LINC00501	28994	177009729	177014729
NR_047467	chr10	+	92805564	92821916	LINC00502	16352	92803064	92808064
NR_126435	chr4	-	14472089	14889793	LINC00504	417704	14887293	14892293
NR_104153	chr3	+	87138429	87206219	LINC00506	67790	87135929	87140929
NR_046392	chr12	+	128399954	128436097	LINC00507	36143	128397454	128402454
NR_126452	chr12	-	128368534	128468436	LINC00508	99902	128465936	128470936
NR_033876	chr17	-	70594179	70636611	LINC00511	42432	70634111	70639111
NR_109780	chr7	+	130598222	130606705	LINC00513	8483	130595722	130600722
NR_033861	chr16	+	3039054	3044510	LINC00514	5456	3036554	3041554
NR_135286	chr14	-	38365264	38371329	LINC00517	6065	38368829	38373829
NR_027793	chr6	-	10428017	10435055	LINC00518	7038	10432555	10437555
NR_145423	chr14	-	51771028	51795103	LINC00519	24075	51792603	51797603
NR_026797	chr14	-	56247852	56263392	LINC00520	15540	56260892	56265892
NR_024096	chr14	+	101123604	101139081	LINC00523	15477	101121104	101126104
NR_038407	chr7	+	47801073	47806370	LINC00525	5297	47798573	47803573
NR_135285	chr6_cox_hap2	-	138229	144420	LINC00533	6191	141920	146920
NR_051989	chr8	+	91233715	91400187	LINC00534	166472	91231215	91236215
NR_033858	chr8	-	94358694	94712661	LINC00535	353967	94710161	94715161
NR_046215	chr8	-	116962735	117337297	LINC00536	374562	117334797	117339797
NR_146625	chr9	+	68408674	68414763	LINC00537	6089	68406174	68411174
NR_103841	chr13	-	21877650	21918998	LINC00539	41348	21916498	21921498
NR_103810	chr13	+	22784423	22850659	LINC00540	66236	22781923	22786923
NR_033889	chr13	+	30510667	30524625	LINC00544	13958	30508167	30513167
NR_040244	chr13	+	38109076	38125673	LINC00547	16597	38106576	38111576
NR_033877	chr13	-	40768645	40794639	LINC00548	25994	40792139	40797139
NR_038878	chr13	-	69435416	69459457	LINC00550	24041	69456957	69461957
NR_051977	chr13	+	107270157	107284006	LINC00551	13849	107267657	107272657
NR_028064	chr13	-	114451483	114454062	LINC00552	2579	114451562	114456562
NR_047483	chr13	-	100647153	100650163	LINC00554	3010	100647663	100652663
NR_047488	chr13	+	54389553	54450254	LINC00558	60701	54387053	54392053
NR_047489	chr13	-	90712500	90771971	LINC00559	59471	90769471	90774471
NR_047490	chr13	+	89279106	89282651	LINC00560	3545	89276606	89281606
NR_047491	chr13	-	76506533	76509268	LINC00561	2735	76506768	76511768
NR_131903	chr13	+	24905587	24911258	LINC00566	5671	24903087	24908087
NR_135280	chr13	-	111462022	111465431	LINC00567	3409	111462931	111467931
NR_047499	chr2	+	11534106	11543203	LINC00570	9097	11531606	11536606
NR_047500	chr13	-	38624953	38717369	LINC00571	92416	38714869	38719869
NR_047501	chr13	-	30492783	30500788	LINC00572	8005	30498288	30503288
NR_026780	chr6	+	170190168	170202969	LINC00574	12801	170187668	170192668
NR_024087	chr4	-	83534265	83542590	LINC00575	8325	83540090	83545090
NR_047568	chr3	+	177159708	177470492	LINC00578	310784	177157208	177162208
NR_103790	chr6	-	21486291	21512123	LINC00581	25832	21509623	21514623
NR_034037	chr1	-	231727037	231747836	LINC00582	20799	231745336	231750336
NR_038194	chr9	+	13927969	13945606	LINC00583	17637	13925469	13930469
NR_103830	chr9	+	105281918	105419791	LINC00587	137873	105279418	105284418
NR_026772	chr8	+	58192101	58197290	LINC00588	5189	58189601	58194601
NR_026765	chr8	-	29578775	29605625	LINC00589	26850	29603125	29608125
NR_027358	chr12	+	52604713	52617665	LINC00592	12952	52602213	52607213
NR_026764	chr15	+	70127572	70135306	LINC00593	7734	70125072	70130072
NR_073447	chr10	+	80027084	80039970	LINC00595	12886	80024584	80029584
NR_024507	chr13	-	40921270	41055143	LINC00598	133873	41052643	41057643
NR_024281	chr8	-	9757573	9760839	LINC00599	3266	9758339	9763339
NR_073453	chr10	-	128102437	128110448	LINC00601	8011	128107948	128112948
NR_027102	chr3	-	10801168	10805877	LINC00606	4709	10803377	10808377
NR_037195	chr2	-	216476285	216708259	LINC00607	231974	216705759	216710759
NR_073454	chr14	+	36539632	36634494	LINC00609	94862	36537132	36542132
NR_034140	chr12	-	9208184	9217666	LINC00612	9482	9215166	9220166
NR_103763	chr4	-	136788137	136834835	LINC00613	46698	136832335	136837335
NR_038868	chr12	+	91311799	91342446	LINC00615	30647	91309299	91314299
NR_037866	chr4	-	138948576	139051839	LINC00616	103263	139049339	139054339
NR_033923	chr10	+	44340753	44346070	LINC00619	5317	44338253	44343253
NR_027103	chr3	+	13692220	13788132	LINC00620	95912	13689720	13694720
NR_138043	chr13	-	23450530	23490508	LINC00621	39978	23488008	23493008
NR_024584	chr1	+	149575481	149619134	LINC00623	43653	149572981	149577981
NR_038423	chr1	-	146853913	146989699	LINC00624	135786	146987199	146992199
NR_024160	chr1	+	168756178	168762126	LINC00626	5948	168753678	168758678
NR_038998	chrX	+	133684053	133694428	LINC00629	10375	133681553	133686553
NR_146589	chrX	+	102024080	102219450	LINC00630	195370	102021580	102026580
NR_104228	chrX	+	139791923	139854841	LINC00632	62918	139789423	139794423
NR_024355	chr22	+	42348190	42354946	LINC00634	6756	42345690	42350690
NR_015414	chr3	-	107560508	107596915	LINC00635	36407	107594415	107599415
NR_015394	chr3	+	107602051	107647753	LINC00636	45702	107599551	107604551
NR_038436	chr14	+	104314057	104324386	LINC00637	10329	104311557	104316557
NR_024396	chr14	+	105287537	105290055	LINC00638	2518	105285037	105290037
NR_039982	chr14	-	39218542	39386086	LINC00639	167544	39383586	39388586
NR_038358	chr14	+	51800110	51832275	LINC00640	32165	51797610	51802610
NR_038971	chr14	-	21668237	21675059	LINC00641	6822	21672559	21677559
NR_033986	chr14	+	90921573	90925249	LINC00642	3676	90919073	90924073
NR_015358	chr14	+	62584074	62600903	LINC00643	16829	62581574	62586574
NR_104063	chr14	-	62600867	62606691	LINC00644	5824	62604191	62609191
NR_039992	chr14	+	28081793	28108842	LINC00645	27049	28079293	28084293
NR_039996	chr14	-	48234155	48264217	LINC00648	30062	48261717	48266717
NR_038883	chr21	+	35303425	35343487	LINC00649	40062	35300925	35305925
NR_026883	chr20	-	18768614	18775228	LINC00652	6614	18772728	18777728
NR_015406	chr20	-	5476712	5485242	LINC00654	8530	5482742	5487742
NR_034149	chr20	-	23105704	23113273	LINC00656	7569	23110773	23115773
NR_038240	chr20	-	5412602	5426394	LINC00658	13792	5423894	5428894
NR_046225	chr20	-	61405472	61408208	LINC00659	2736	61405708	61410708
NR_026828	chr19	+	16126443	16138272	LINC00661	11829	16123943	16128943
NR_027301	chr19	-	28281400	28284848	LINC00662	3448	28282348	28287348
NR_026956	chr19	-	19867180	19887222	LINC00663	20042	19884722	19889722
NR_037194	chr19	+	21666516	21686040	LINC00664	19524	21664016	21669016
NR_038279	chr19	-	36803962	36822620	LINC00665	18658	36820120	36825120
NR_015389	chr18	+	5238098	5246505	LINC00667	8407	5235598	5240598
NR_034100	chr18	-	6925472	6929868	LINC00668	4396	6927368	6932368
NR_034145	chr17	+	12453284	12540504	LINC00670	87220	12450784	12455784
NR_027254	chr17	-	41026690	41050751	LINC00671	24061	41048251	41053251
NR_038847	chr17	+	37081420	37085637	LINC00672	4217	37078920	37083920
NR_036488	chr17	-	70399462	70588943	LINC00673	189481	70586443	70591443
NR_027418	chr17	+	66097695	66132070	LINC00674	34375	66095195	66100195
NR_036581	chr17	-	10698229	10707416	LINC00675	9187	10704916	10709916
NR_102708	chr11	-	27639172	27656174	LINC00678	17002	27653674	27658674
NR_125727	chr6	-	58272111	58287724	LINC00680	15613	58285224	58290224
NR_132997	chr6	-	58246158	58287724	LINC00680-GUSBP4	41566	58285224	58290224
NR_102423	chr8	+	12651748	12675800	LINC00681	24052	12649248	12654248
NR_104143	chr4	-	41881538	41884628	LINC00682	3090	41882128	41887128
NR_120419	chr18	+	74331733	74335516	LINC00683	3783	74329233	74334233
NR_110635	chr20	-	11790634	11851363	LINC00687	60729	11848863	11853863
NR_024394	chr7	+	158801044	158818929	LINC00689	17885	158798544	158803544
NR_103843	chr3	+	16577824	16582880	LINC00690	5056	16575324	16580324
NR_026834	chr3	-	24141464	24144738	LINC00691	3274	24142238	24147238
NR_034055	chr3	-	25900022	25915186	LINC00692	15164	25912686	25917686
NR_038840	chr3	+	28616768	28799828	LINC00693	183060	28614268	28619268
NR_134943	chr3	-	44462623	44465517	LINC00694	2894	44463017	44468017
NR_027331	chr3	-	52096109	52099128	LINC00696	3019	52096628	52101628
NR_027104	chr3	+	63088363	63110737	LINC00698	22374	63085863	63090863
NR_040253	chr10	-	2047666	2056542	LINC00700	8876	2054042	2059042
NR_038884	chr10	-	2342512	2357268	LINC00701	14756	2354768	2359768
NR_108040	chr10	-	4249067	4286104	LINC00702	37037	4283604	4288604
NR_108054	chr10	+	4426437	4452804	LINC00703	26367	4423937	4428937
NR_024475	chr10	-	4692376	4720262	LINC00704	27886	4717762	4722762
NR_015425	chr10	+	4698347	4704606	LINC00705	6259	4695847	4700847
NR_108074	chr10	-	6816264	6821142	LINC00706	4878	6818642	6823642
NR_038291	chr10	+	6821559	6884868	LINC00707	63309	6819059	6824059
NR_108058	chr10	-	8301294	8310268	LINC00708	8974	8307768	8312768
NR_108039	chr10	+	9317575	9329019	LINC00709	11444	9315075	9320075
NR_015413	chr10	-	10976902	10994126	LINC00710	17224	10991626	10996626
NR_121672	chr8	-	129417515	129576925	LINC00824	159410	129574425	129579425
NR_108067	chr10	+	25940640	26021864	LINC00836	81224	25938140	25943140
NR_038376	chr10	-	29078239	29084979	LINC00837	6740	29082479	29087479
NR_038932	chr10	-	34048640	34061608	LINC00838	12968	34059108	34064108
NR_026827	chr10	+	42970938	42990785	LINC00839	19847	42968438	42973438
NR_038268	chr10	+	44354858	44390881	LINC00840	36023	44352358	44357358
NR_136147	chr10	+	44404743	44476713	LINC00841	71970	44402243	44407243
NR_033957	chr10	-	47096453	47151400	LINC00842	54947	47148900	47153900
NR_108052	chr10	+	62776032	62786175	LINC00845	10143	62773532	62778532
NR_045679	chr5	+	180257956	180262726	LINC00847	4770	180255456	180260456
NR_109813	chrX	+	148958632	149008599	LINC00850	49967	148956132	148961132
NR_047479	chr17	-	41373436	41381062	LINC00854	7626	41378562	41383562
NR_038985	chr10	+	80008381	80012402	LINC00856	4021	80005881	80010881
NR_038464	chr10	+	81967465	81979413	LINC00857	11948	81964965	81969965
NR_038220	chr10	+	86039735	86054415	LINC00858	14680	86037235	86042235
NR_038447	chr8	-	126934766	126963441	LINC00861	28675	126960941	126965941
NR_040064	chr1	-	200311671	200342920	LINC00862	31249	200340420	200345420
NR_135292	chr10	+	89102492	89117059	LINC00863	14567	89099992	89104992
NR_046091	chr10	-	89156330	89167457	LINC00864	11127	89164957	89169957
NR_038382	chr10	+	91589249	91600618	LINC00865	11369	91586749	91591749
NR_108035	chr10	-	99588234	99609555	LINC00866	21321	99607055	99612055
NR_135283	chr17	+	74852247	74857918	LINC00868	5671	74849747	74854747
NR_111950	chr1	+	149576160	149651107	LINC00869	74947	149573660	149578660
NR_038221	chr3	+	72200407	72223490	LINC00870	23083	72197907	72202907
NR_102701	chr14	+	46533361	46971104	LINC00871	437743	46530861	46535861
NR_104116	chr3	-	72084669	72149606	LINC00877	64937	72147106	72152106
NR_015400	chr3	+	94657106	94710169	LINC00879	53063	94654606	94659606
NR_034007	chr3	-	156799455	156840791	LINC00880	41336	156838291	156843291
NR_034008	chr3	+	156807669	156818924	LINC00881	11255	156805169	156810169
NR_028303	chr3	-	106828636	106959485	LINC00882	130849	106956985	106961985
NR_034088	chr3	+	195869506	195887761	LINC00885	18255	195867006	195872006
NR_038387	chr3	-	156465131	156534851	LINC00886	69720	156532351	156537351
NR_024480	chr3	-	194018988	194030593	LINC00887	11605	194028093	194033093
NR_038302	chr3	+	183165395	183173800	LINC00888	8405	183162895	183167895
NR_026935	chrX	-	137696891	137699799	LINC00889	2908	137697299	137702299
NR_033974	chrX	+	110754889	110765627	LINC00890	10738	110752389	110757389
NR_034005	chrX	+	70917045	70923256	LINC00891	6211	70914545	70919545
NR_038461	chrX	+	135721701	135724588	LINC00892	2887	135719201	135724201
NR_027455	chrX	-	148609131	148621312	LINC00893	12181	148618812	148623812
NR_027456	chrX	+	149106765	149185018	LINC00894	78253	149104265	149109265
NR_033377	chr22	-	48016791	48027318	LINC00898	10527	48024818	48029818
NR_027036	chr22	-	46435786	46440748	LINC00899	4962	46438248	46443248
NR_034148	chr11	-	115626050	115630918	LINC00900	4868	115628418	115633418
NR_121607	chr3	+	116640277	116651085	LINC00901	10808	116637777	116642777
NR_046624	chr3	+	116271319	116287288	LINC00903	15969	116268819	116273819
NR_046222	chr19	-	35382932	35389847	LINC00904	6915	35387347	35392347
NR_024335	chr19	+	16144522	16152945	LINC00905	8423	16142022	16147022
NR_027318	chr19	+	29456037	29460055	LINC00906	4018	29453537	29458537
NR_046174	chr18	+	39766632	40271389	LINC00907	504757	39764132	39769132
NR_015417	chr18	+	74240611	74271784	LINC00908	31173	74238111	74243111
NR_024484	chr18	-	72259009	72265071	LINC00909	6062	72262571	72267571
NR_027412	chr17	-	41447212	41466266	LINC00910	19054	41463766	41468766
NR_102737	chr14	+	85860222	85886418	LINC00911	26196	85857722	85862722
NR_024406	chr16	-	86365455	86379285	LINC00917	13830	86376785	86381785
NR_033904	chr16	+	3313767	3317566	LINC00921	3799	3311267	3316267
NR_027755	chr16	-	65318401	65610203	LINC00922	291802	65607703	65612703
NR_024172	chr15	-	98285845	98417659	LINC00923	131814	98415159	98420159
NR_027133	chr15	+	95976321	96051076	LINC00924	74755	95973821	95978821
NR_024433	chr15	+	57592562	57599967	LINC00926	7405	57590062	57595062
NR_033833	chr15	-	80555409	80634147	LINC00927	78738	80631647	80636647
NR_027074	chr15	-	90048160	90067265	LINC00928	19105	90064765	90069765
NR_038852	chr15	+	26360959	26378184	LINC00929	17225	26358459	26363459
NR_021493	chr15	-	93111047	93115493	LINC00930	4446	93112993	93117993
NR_038274	chr15	+	85113879	85123412	LINC00933	9533	85111379	85116379
NR_024246	chr12	-	119721629	119741185	LINC00934	19556	119738685	119743685
NR_024420	chr12	-	8509559	8543348	LINC00937	33789	8540848	8545848
NR_034132	chr12	-	126443233	126467920	LINC00939	24687	126465420	126470420
NR_036546	chr12	-	2038367	2045742	LINC00940	7375	2043242	2048242
NR_040245	chr12	+	30948614	30955645	LINC00941	7031	30946114	30951114
NR_028415	chr12	+	1609656	1613590	LINC00942	3934	1607156	1612156
NR_038256	chr12	+	127221552	127230800	LINC00943	9248	127219052	127224052
NR_033878	chr12	-	127215246	127256808	LINC00944	41562	127254308	127259308
NR_104056	chr21	+	34430134	34437385	LINC00945	7251	34427634	34432634
NR_024006	chr9	+	35860270	35865515	LINC00950	5245	35857770	35862770
NR_038887	chr6	-	40312083	40323745	LINC00951	11662	40321245	40326245
NR_033875	chr2	+	20068614	20084808	LINC00954	16194	20066114	20071114
NR_040045	chr4	+	3578595	3592712	LINC00955	14117	3576095	3581095
NR_072982	chr7	+	44078647	44083895	LINC00957	5248	44076147	44081147
NR_038904	chr11	-	13001080	13011095	LINC00958	10015	13008595	13013595
NR_034125	chr10	-	131862161	131909081	LINC00959	46920	131906581	131911581
NR_040005	chr3	+	75721431	75728454	LINC00960	7023	75718931	75723931
NR_038955	chr9	+	132250938	132275965	LINC00963	25027	132248438	132253438
NR_027321	chr8	+	125954249	125963337	LINC00964	9088	125951749	125956749
NR_027000	chr8	-	7118140	7121014	LINC00965	2874	7118514	7123514
NR_039979	chr8	+	67104348	67109554	LINC00967	5206	67101848	67106848
NR_038236	chr8	-	57430877	57472382	LINC00968	41505	57469882	57474882
NR_122105	chr3	+	195415368	195438746	LINC00969	23378	195412868	195417868
NR_104091	chr1	-	168873142	169056243	LINC00970	183101	169053743	169058743
NR_033860	chr3	-	84687555	84918726	LINC00971	231171	84916226	84921226
NR_134240	chr7	+	85050437	85118654	LINC00972	68217	85047937	85052937
NR_038442	chr17	-	39705857	39710747	LINC00974	4890	39708247	39713247
NR_145483	chr8	-	129965124	129978247	LINC00976	13123	129975747	129980747
NR_033916	chr8	-	130228712	130253486	LINC00977	24774	130250986	130255986
NR_015440	chr1	-	2976180	2984289	LINC00982	8109	2981789	2986789
NR_137429	chr12	+	9392598	9415473	LINC00987	22875	9390098	9395098
NR_038826	chr4	+	80413746	80497614	LINC00989	83868	80411246	80416246
NR_046089	chr5	+	116751207	116915439	LINC00992	164232	116748707	116753707
NR_104061	chr10	+	37598113	37635956	LINC00993	37843	37595613	37600613
NR_033978	chr3	-	64064036	64073039	LINC00994	9003	64070539	64075539
NR_034033	chr7	+	150130741	150145228	LINC00996	14487	150128241	150133241
NR_036501	chr7	+	32797897	32802536	LINC00997	4639	32795397	32800397
NR_024497	chr10	+	38717073	38741081	LINC00999	24008	38714573	38719573
NR_024368	chr7	+	128281294	128301052	LINC01000	19758	128278794	128283794
NR_146389	chr11	-	127133	139117	LINC01001	11984	136617	141617
NR_028324	chr19	-	197015	202209	LINC01002	5194	199709	204709
NR_039981	chr7	-	104622193	104631612	LINC01004	9419	104629112	104634112
NR_039987	chr7	-	63484795	63490480	LINC01005	5685	63487980	63492980
NR_103858	chr7	-	156264792	156395889	LINC01006	131097	156393389	156398389
NR_103749	chr7	-	101206034	101212286	LINC01007	6252	101209786	101214786
NR_038217	chr6	+	134758853	134825158	LINC01010	66305	134756353	134761353
NR_026856	chr6	+	2988200	2991405	LINC01011	3205	2985700	2990700
NR_038293	chr6	+	27661813	27678001	LINC01012	16188	27659313	27664313
NR_038981	chr6	+	132455117	132490514	LINC01013	35397	132452617	132457617
NR_046786	chr3	+	178136988	178175093	LINC01014	38105	178134488	178139488
NR_037181	chr6	+	29497182	29501345	LINC01015	4163	29494682	29499682
NR_038989	chr6	-	33857287	33864684	LINC01016	7397	33862184	33867184
NR_104618	chr5	-	3496485	3504118	LINC01017	7633	3501618	3506618
NR_024423	chr5	+	6582248	6588613	LINC01018	6365	6579748	6584748
NR_033898	chr5	-	3417265	3536208	LINC01019	118943	3533708	3538708
NR_026994	chr5	+	5034471	5070115	LINC01020	35644	5031971	5036971
NR_038848	chr5	+	27472398	27496508	LINC01021	24110	27469898	27474898
NR_102741	chr5	-	139482506	139487597	LINC01024	5091	139485097	139490097
NR_104129	chr17	+	68047411	68064236	LINC01028	16825	68044911	68049911
NR_104127	chr18	-	75683252	75705683	LINC01029	22431	75703183	75708183
NR_104062	chr8	-	91605002	91618291	LINC01030	13289	91615791	91620791
NR_125789	chr1	+	193273874	193335083	LINC01031	61209	193271374	193276374
NR_126003	chr1	-	192904873	192917387	LINC01032	12514	192914887	192919887
NR_126379	chr5	+	53616773	53710955	LINC01033	94182	53614273	53619273
NR_126347	chr1	+	187061973	187329376	LINC01036	267403	187059473	187064473
NR_132374	chr1	+	187412759	187446354	LINC01037	33595	187410259	187415259
NR_126390	chr13	+	100229365	100238233	LINC01039	8868	100226865	100231865
NR_131228	chr13	-	90129860	90152763	LINC01040	22903	90150263	90155263
NR_135321	chr13	+	112967780	112976080	LINC01043	8300	112965280	112970280
NR_126345	chr13	-	112976880	112985539	LINC01044	8659	112983039	112988039
NR_131229	chr13	-	89867101	89889144	LINC01047	22043	89886644	89891644
NR_125762	chr13	-	38055600	38058921	LINC01048	3321	38056421	38061421
NR_120414	chr13	+	91145541	91187595	LINC01049	42054	91143041	91148041
NR_132362	chr13	+	66440178	66452351	LINC01052	12173	66437678	66442678
NR_120427	chr13	+	25755469	25764795	LINC01053	9326	25752969	25757969
NR_126391	chr13	-	115095231	115099423	LINC01054	4192	115096923	115101923
NR_125786	chr13	-	46255333	46275319	LINC01055	19986	46272819	46277819
NR_033369	chr20	+	61669362	61685215	LINC01056	15853	61666862	61671862
NR_125771	chr13	-	30993575	30996381	LINC01058	2806	30993881	30998881
NR_033869	chr4	+	189376731	189523062	LINC01060	146331	189374231	189379231
NR_037596	chr4	-	120326677	120331815	LINC01061	5138	120329315	120334315
NR_125788	chr13	-	53705880	53726035	LINC01065	20155	53723535	53728535
NR_125772	chr13	+	80140861	80145581	LINC01068	4720	80138361	80143361
NR_108076	chr13	-	78553900	78568908	LINC01069	15008	78566408	78571408
NR_108094	chr13	+	112851646	112855316	LINC01070	3670	112849146	112854146
NR_125787	chr13	+	62786414	62824084	LINC01075	37670	62783914	62788914
NR_132375	chr13	+	75814723	75826148	LINC01078	11425	75812223	75817223
NR_104138	chr13	+	80585211	80600798	LINC01080	15587	80582711	80587711
NR_104139	chr16	-	86259185	86319853	LINC01081	60668	86317353	86322353
NR_103859	chr16	+	86229786	86233324	LINC01082	3538	86227286	86232286
NR_033931	chr4	+	14113591	14141676	LINC01085	28085	14111091	14116091
NR_108087	chr2	+	132394597	132407188	LINC01087	12591	132392097	132397097
NR_038342	chr4	+	79892901	80229953	LINC01088	337052	79890401	79895401
NR_002809	chr12	-	122233172	122241390	LINC01089	8218	122238890	122243890
NR_126396	chr2	-	188900322	189152418	LINC01090	252096	189149918	189154918
NR_027105	chr4	+	124573939	124851518	LINC01091	277579	124571439	124576439
NR_039976	chr4	-	185814153	185820615	LINC01093	6462	185818115	185823115
NR_038305	chr4	+	79567147	79605655	LINC01094	38508	79564647	79569647
NR_038331	chr4	-	147030606	147043065	LINC01095	12459	147040565	147045565
NR_034054	chr4	-	13527942	13533041	LINC01097	5099	13530541	13535541
NR_028342	chr4	+	178649910	178911904	LINC01098	261994	178647410	178652410
NR_108092	chr4	-	178733199	178829090	LINC01099	95891	178826590	178831590
NR_104132	chr3	+	159738435	159749210	LINC01100	10775	159735935	159740935
NR_015399	chr2	+	105050804	105129215	LINC01102	78411	105048304	105053304
NR_110113	chr2	-	105104913	105126967	LINC01103	22054	105124467	105129467
NR_103730	chr2	+	100824715	100867946	LINC01104	43231	100822215	100827215
NR_026832	chr2	+	6072818	6120350	LINC01105	47532	6070318	6075318
NR_027244	chr2	-	111132685	111142113	LINC01106	9428	111139613	111144613
NR_037809	chr2	-	239419330	239464140	LINC01107	44810	239461640	239466640
NR_108097	chr6	-	14280357	14285685	LINC01108	5328	14283185	14288185
NR_105006	chr8	+	77318888	77436567	LINC01111	117679	77316388	77321388
NR_038231	chr2	-	105363094	105374177	LINC01114	11083	105371677	105376677
NR_033880	chr2	-	779836	864112	LINC01115	84276	861612	866612
NR_040001	chr2	-	177494308	177502302	LINC01116	7994	177499802	177504802
NR_110599	chr2	+	177502481	177520686	LINC01117	18205	177499981	177504981
NR_034099	chr2	+	47043806	47049799	LINC01118	5993	47041306	47046306
NR_024452	chr2	+	47055002	47086145	LINC01119	31143	47052502	47057502
NR_036499	chr2	+	132160473	132165801	LINC01120	5328	132157973	132162973
NR_033831	chr2	-	45401479	45482080	LINC01121	80601	45479580	45484580
NR_033873	chr2	+	58747887	59290901	LINC01122	543014	58745387	58750387
NR_046110	chr2	-	111133764	111142102	LINC01123	8338	111139602	111144602
NR_038386	chr2	+	98286205	98319529	LINC01125	33324	98283705	98288705
NR_047519	chr1	+	762970	794826	LINC01128	31856	760470	765470
NR_038856	chr1	+	234859788	234867390	LINC01132	7602	234857288	234862288
NR_038849	chr1	+	159931013	159948876	LINC01133	17863	159928513	159933513
NR_024455	chr1	+	3816967	3832011	LINC01134	15044	3814467	3819467
NR_034015	chr1	+	59250822	59365384	LINC01135	114562	59248322	59253322
NR_034150	chr1	-	203267885	203274453	LINC01136	6568	203271953	203276953
NR_038842	chr1	-	37920479	37940044	LINC01137	19565	37937544	37942544
NR_104014	chr1	-	143717587	143744519	LINC01138	26932	143742019	143747019
NR_015407	chr1	-	238643683	238649317	LINC01139	5634	238646817	238651817
NR_026989	chr1	+	87595447	87634886	LINC01140	39439	87592947	87597947
NR_033887	chr1	-	20686293	20755287	LINC01141	68994	20752787	20757787
NR_026957	chr1	-	170240545	170253349	LINC01142	12804	170250849	170255849
NR_046094	chr14	+	88490893	88553688	LINC01146	62795	88488393	88493393
NR_038445	chr14	+	87372121	87389099	LINC01148	16978	87369621	87374621
NR_144465	chr6	+	31409443	31414750	LINC01149	5307	31406943	31411943
NR_120534	chr11	+	1917988	1929589	LINC01150	11601	1915488	1920488
NR_126348	chr8	-	123682623	123706345	LINC01151	23722	123703845	123708845
NR_110132	chr17	+	70026794	70037438	LINC01152	10644	70024294	70029294
NR_037883	chr2	-	105421882	105467934	LINC01158	46052	105465434	105470434
NR_110373	chr2	-	105481954	105489053	LINC01159	7099	105486553	105491553
NR_034126	chr1	-	112141628	112150940	LINC01160	9312	112148440	112153440
NR_126381	chr7	+	20875049	21061771	LINC01162	186722	20872549	20877549
NR_120619	chr10	+	130084213	130115990	LINC01163	31777	130081713	130086713
NR_038365	chr10	-	133604733	133622535	LINC01164	17802	133620035	133625035
NR_120627	chr10	-	134757470	134778793	LINC01166	21323	134776293	134781293
NR_046231	chr10	+	134779037	134790001	LINC01168	10964	134776537	134781537
NR_110372	chr15	+	66874527	66978136	LINC01169	103609	66872027	66877027
NR_125774	chr5	-	123395486	123774213	LINC01170	378727	123771713	123776713
NR_132376	chr2	+	235591311	235626408	LINC01173	35097	235588811	235593811
NR_108081	chr7	+	30430500	30443670	LINC01176	13170	30428e3	30433e3
NR_126397	chr16	-	9535150	9538842	LINC01177	3692	9536342	9541342
NR_121676	chr4	+	166605790	166683930	LINC01179	78140	166603290	166608290
NR_110661	chr17	-	42723731	42727717	LINC01180	3986	42725217	42730217
NR_145429	chr8	+	104133259	104152583	LINC01181	19324	104130759	104135759
NR_121681	chr4	+	13656802	13932852	LINC01182	276050	13654302	13659302
NR_015360	chr5	-	127357243	127418766	LINC01184	61523	127416266	127421266
NR_033980	chr2	-	61074894	61108449	LINC01185	33555	61105949	61110949
NR_108022	chr5	-	169618650	169626145	LINC01187	7495	169623645	169628645
NR_046203	chr9	+	46763790	46833319	LINC01189	69529	46761290	46766290
NR_034128	chr2	+	114737145	114764887	LINC01191	27742	114734645	114739645
NR_033945	chr3	-	162895030	163021089	LINC01192	126059	163018589	163023589
NR_040094	chr15	+	21145766	21198633	LINC01193	52867	21143266	21148266
NR_033383	chr5	+	12574968	12805295	LINC01194	230327	12572468	12577468
NR_126349	chr16	-	9539869	9549362	LINC01195	9493	9546862	9551862
NR_034095	chr15	-	95822518	95870329	LINC01197	47811	95867829	95872829
NR_120426	chr13	-	47029338	47040911	LINC01198	11573	47038411	47043411
NR_126350	chrX	-	130150442	130192120	LINC01201	41678	130189620	130194620
NR_126372	chr5	-	161337467	161428202	LINC01202	90735	161425702	161430702
NR_045260	chrX	+	13353359	13359944	LINC01203	6585	13350859	13355859
NR_104644	chrX	+	45364632	45386484	LINC01204	21852	45362132	45367132
NR_109841	chr3	+	109128836	109214014	LINC01205	85178	109126336	109131336
NR_104146	chr3	+	181670151	181728464	LINC01206	58313	181667651	181672651
NR_038834	chr4	+	165675282	165724947	LINC01207	49665	165672782	165677782
NR_109968	chr3	-	176321935	176353320	LINC01208	31385	176350820	176355820
NR_110819	chr3	-	176531943	176534789	LINC01209	2846	176532289	176537289
NR_109987	chr3	+	137490752	137499719	LINC01210	8967	137488252	137493252
NR_110186	chr3	-	149983193	150041534	LINC01214	58341	150039034	150044034
NR_110030	chr3	+	107843910	107857457	LINC01215	13547	107841410	107846410
NR_046811	chr4	-	101581435	101596270	LINC01216	14835	101593770	101598770
NR_126351	chr1	+	198985261	199045864	LINC01221	60603	198982761	198987761
NR_110525	chr1	-	198961717	198988093	LINC01222	26376	198985593	198990593
NR_126448	chr19	-	23582035	23598876	LINC01224	16841	23596376	23601376
NR_027085	chr1	+	31984035	31989846	LINC01226	5811	31981535	31986535
NR_104666	chr16	-	80600999	80606705	LINC01227	5706	80604205	80609205
NR_104660	chr16	+	79804367	79835240	LINC01229	30873	79801867	79806867
NR_121585	chr9	+	3181588	3200500	LINC01231	18912	3179088	3184088
NR_110731	chr13	-	100139215	100151560	LINC01232	12345	100149060	100154060
NR_110025	chr12	-	114182381	114211488	LINC01234	29107	114208988	114213988
NR_110220	chr2	+	242823513	243020873	LINC01237	197360	242821013	242826013
NR_110592	chr2	+	242912833	242919427	LINC01238	6594	242910333	242915333
NR_038977	chr9	+	22646198	22824212	LINC01239	178014	22643698	22648698
NR_121604	chr9	+	25780053	25812966	LINC01241	32913	25777553	25782553
NR_046204	chr9	-	30388932	30408452	LINC01242	19520	30405952	30410952
NR_135134	chr9	-	31371608	31381488	LINC01243	9880	31378988	31383988
NR_110498	chr2	-	6766240	6774838	LINC01246	8598	6772338	6777338
NR_110251	chr2	-	6506141	6515554	LINC01247	9413	6513054	6518054
NR_110580	chr2	-	5774272	5831250	LINC01248	56978	5828750	5833750
NR_034134	chr2	-	4675807	4703812	LINC01249	28005	4701312	4706312
NR_110228	chr2	-	2898819	3129798	LINC01250	230979	3127298	3132298
NR_109755	chr9	-	33732972	33738414	LINC01251	5442	33735914	33740914
NR_033890	chr12	+	11700963	11717335	LINC01252	16372	11698463	11703463
NR_110775	chr18	-	10405129	10414367	LINC01254	9238	10411867	10416867
NR_110779	chr18	+	11488568	11506982	LINC01255	18414	11486068	11491068
NR_126401	chr4	+	133512243	133599655	LINC01256	87412	133509743	133514743
NR_026670	chr12	+	131649555	131697476	LINC01257	47921	131647055	131652055
NR_110951	chr4	-	38422282	38524801	LINC01258	102519	38522301	38527301
NR_034104	chr20	-	43285091	43300380	LINC01260	15289	43297880	43302880
NR_104631	chr5	-	38710468	38720375	LINC01265	9907	38717875	38722875
NR_110118	chr3	+	633787	887698	LINC01266	253911	631287	636287
NR_110135	chr3	-	14389950	14394068	LINC01267	4118	14391568	14396568
NR_038863	chr6	-	114189178	114194512	LINC01268	5334	114192012	114197012
NR_125769	chr14	+	71165414	71178870	LINC01269	13456	71162914	71167914
NR_034124	chr20	+	48909256	48931456	LINC01270	22200	48906756	48911756
NR_109950	chr20	-	48927247	48937879	LINC01271	10632	48935379	48940379
NR_109943	chr20	+	48789106	48793208	LINC01273	4102	48786606	48791606
NR_120347	chr6	+	41470181	41487590	LINC01276	17409	41467681	41472681
NR_038987	chr6	-	143287558	143358719	LINC01277	71161	143356219	143361219
NR_015353	chrX	-	62646438	62780873	LINC01278	134435	62778373	62783373
NR_109779	chr3	-	112315640	112320816	LINC01279	5176	112318316	112323316
NR_110392	chr2	-	217454715	217471661	LINC01280	16946	217469161	217474161
NR_038968	chrX	-	39164209	39186616	LINC01281	22407	39184116	39189116
NR_110385	chrX	-	39226538	39251028	LINC01282	24490	39248528	39253528
NR_110382	chrX	-	50838681	50914232	LINC01284	75551	50911732	50916732
NR_110393	chrX	+	117973518	118015977	LINC01285	42459	117971018	117976018
NR_125776	chr7	-	153097003	153109319	LINC01287	12316	153106819	153111819
NR_125746	chr8	+	34641438	34722316	LINC01288	80878	34638938	34643938
NR_038875	chr8	+	64681987	64698054	LINC01289	16067	64679487	64684487
NR_125792	chr2	+	75136257	75165545	LINC01291	29288	75133757	75138757
NR_122111	chr14	-	19880208	19925329	LINC01296	45121	19922829	19927829
NR_132385	chr22	-	16199673	16231289	LINC01297	31616	16228789	16233789
NR_046232	chr8	-	96219234	96228602	LINC01298	9368	96226102	96231102
NR_033893	chr8	-	66439242	66474901	LINC01299	35659	66472401	66477401
NR_024441	chr8	+	142350647	142354720	LINC01300	4073	142348147	142353147
NR_103854	chr8	-	61314729	61326377	LINC01301	11648	61323877	61328877
NR_037881	chr2	-	4005244	4021622	LINC01304	16378	4019122	4024122
NR_038897	chr2	+	175190754	175195370	LINC01305	4616	175188254	175193254
NR_126402	chr1	+	101789392	101842869	LINC01307	53477	101786892	101791892
NR_038944	chr22	+	49262581	49294198	LINC01310	31617	49260081	49265081
NR_027030	chr6	+	134142284	134175130	LINC01312	32846	134139784	134144784
NR_120317	chr15	-	80487820	80544603	LINC01314	56783	80542103	80547103
NR_120596	chr22	-	42760405	42765214	LINC01315	4809	42762714	42767714
NR_126403	chr2	+	33931952	34522813	LINC01317	590861	33929452	33934452
NR_126404	chr2	+	34902623	34947630	LINC01320	45007	34900123	34905123
NR_125764	chr3	+	164924747	165231516	LINC01322	306769	164922247	164927247
NR_126405	chr3	-	164431882	164549268	LINC01324	117386	164546768	164551768
NR_126353	chr3	+	167110583	167126307	LINC01327	15724	167108083	167113083
NR_126354	chr5	-	73665200	73832801	LINC01331	167601	73830301	73835301
NR_105010	chr5	+	73618310	73624182	LINC01333	5872	73615810	73620810
NR_126375	chr5	-	74343543	74348468	LINC01336	4925	74345968	74350968
NR_125754	chr5	-	79904439	79918343	LINC01337	13904	79915843	79920843
NR_105016	chr5	-	82146683	82155655	LINC01338	8972	82153155	82158155
NR_120601	chr5	-	89454155	89585888	LINC01339	131733	89583388	89588388
NR_105028	chr5	+	96840399	97006755	LINC01340	166356	96837899	96842899
NR_038869	chr1	+	1072396	1079434	LINC01342	7038	1069896	1074896
NR_038928	chr1	-	38674705	38680439	LINC01343	5734	38677939	38682939
NR_104175	chr1	-	182173079	182283196	LINC01344	110117	182280696	182285696
NR_040065	chr1	+	4000671	4012643	LINC01346	11972	3998171	4003171
NR_029401	chr1	-	243219615	243265046	LINC01347	45431	243262546	243267546
NR_038914	chr1	-	101092605	101112560	LINC01349	19955	101110060	101115060
NR_110793	chr1	-	185527511	185597620	LINC01350	70109	185595120	185600120
NR_110716	chr1	+	190447389	190450524	LINC01351	3135	190444889	190449889
NR_110797	chr1	+	221002596	221005770	LINC01352	3174	221000096	221005096
NR_038426	chr1	-	234663636	234667525	LINC01354	3889	234665025	234670025
NR_110616	chr1	-	23607801	23612011	LINC01355	4210	23609511	23614511
NR_103746	chr1	-	113362790	113393265	LINC01356	30475	113390765	113395765
NR_110626	chr1	+	59486147	59553919	LINC01358	67772	59483647	59488647
NR_119383	chr1	-	65445259	65468159	LINC01359	22900	65465659	65470659
NR_110676	chr1	+	73771852	73804560	LINC01360	32708	73769352	73774352
NR_110633	chr1	-	83439565	83451891	LINC01361	12326	83449391	83454391
NR_147074	chr1	+	83368865	83632498	LINC01362	263633	83366365	83371365
NR_110811	chr1	-	167144598	167165042	LINC01363	20444	167162542	167167542
NR_038324	chr1	-	87819209	87837338	LINC01364	18129	87834838	87839838
NR_110660	chr4	-	120720260	120725670	LINC01365	5410	120723170	120728170
NR_108025	chr5	+	169758396	169762104	LINC01366	3708	169755896	169760896
NR_109937	chr20	+	38633102	38637171	LINC01370	4069	38630602	38635602
NR_108104	chr7	+	66800962	66805012	LINC01372	4050	66798462	66803462
NR_110655	chr10	-	91675245	91717130	LINC01375	41885	91714630	91719630
NR_135287	chr2	-	19167728	19226726	LINC01376	58998	19224226	19229226
NR_104617	chr5	+	3177948	3181346	LINC01377	3398	3175448	3180448
NR_125757	chr4	+	118349553	118610258	LINC01378	260705	118347053	118352053
NR_132378	chr2	+	25427181	25432071	LINC01381	4890	25424681	25429681
NR_109883	chr20	-	22568159	22588155	LINC01384	19996	22585655	22590655
NR_126410	chr5	-	72750014	72768791	LINC01386	18777	72766291	72771291
NR_120518	chr18	+	6511414	6590652	LINC01387	79238	6508914	6513914
NR_126355	chr1	-	47846467	47902989	LINC01389	56522	47900489	47905489
NR_121649	chr3	-	138654030	138662862	LINC01391	8832	138660362	138665362
NR_126407	chr7	-	114763652	114871409	LINC01392	107757	114868909	114873909
NR_120521	chr7	+	114719011	114766368	LINC01393	47357	114716511	114721511
NR_120582	chr11	-	129482015	129487164	LINC01395	5149	129484664	129489664
NR_125765	chr4	+	4846163	4852554	LINC01396	6391	4843663	4848663
NR_126382	chr1	+	110625309	110652341	LINC01397	27032	110622809	110627809
NR_121680	chr1	-	46912344	46915376	LINC01398	3032	46912876	46917876
NR_126356	chr22	-	35515816	35627049	LINC01399	111233	35624549	35629549
NR_121647	chr9	+	66457288	66469310	LINC01410	12022	66454788	66459788
NR_125806	chr5	+	173763356	173954142	LINC01411	190786	173760856	173765856
NR_110570	chr2	+	145279434	145337001	LINC01412	57567	145276934	145281934
NR_120337	chr15	+	57611335	57617237	LINC01413	5902	57608835	57613835
NR_145452	chr18	-	53441831	53448956	LINC01415	7125	53446456	53451456
NR_110755	chr18	-	53548918	53587430	LINC01416	38512	53584930	53589930
NR_122034	chr8	+	84315992	84321132	LINC01419	5140	84313492	84318492
NR_110540	chr22	+	27299254	27316573	LINC01422	17319	27296754	27301754
NR_110545	chr21	-	39698280	39717998	LINC01423	19718	39715498	39720498
NR_109958	chr21	+	23119304	23169735	LINC01425	50431	23116804	23121804
NR_038885	chr21	+	36118121	36157168	LINC01426	39047	36115621	36120621
NR_110615	chr20	-	22260865	22263439	LINC01427	2574	22260939	22265939
NR_110609	chr20	-	7127113	7234849	LINC01428	107736	7232349	7237349
NR_110016	chr20	-	50448335	50479452	LINC01429	31117	50476952	50481952
NR_038394	chr20	+	22034727	22055292	LINC01432	20565	22032227	22037227
NR_033917	chr20	+	4173736	4176600	LINC01433	2864	4171236	4176236
NR_125760	chr10	-	109631334	109829051	LINC01435	197717	109826551	109831551
NR_110419	chr21	+	37377617	37380593	LINC01436	2976	37375117	37380117
NR_110629	chr20	+	54039580	54043329	LINC01440	3749	54037080	54042080
NR_110064	chr20	-	54036873	54043735	LINC01441	6862	54041235	54046235
NR_104164	chr18	+	14946265	14973755	LINC01443	27490	14943765	14948765
NR_120515	chr7	+	54398389	54417538	LINC01445	19149	54395889	54400889
NR_038371	chr7	-	53723201	53879624	LINC01446	156423	53877124	53882124
NR_108090	chr7	+	47661536	47669491	LINC01447	7955	47659036	47664036
NR_110833	chr7	-	42701325	42746046	LINC01448	44721	42743546	42748546
NR_110832	chr7	+	41141201	41173099	LINC01449	31898	41138701	41143701
NR_110831	chr7	-	41004276	41019537	LINC01450	15261	41017037	41022037
NR_135288	chr9	-	139506479	139511633	LINC01451	5154	139509133	139514133
NR_131226	chr5	+	79232401	79263449	LINC01455	31048	79229901	79234901
NR_133641	chrX	-	17988292	18122764	LINC01456	134472	18120264	18125264
NR_135200	chr2	-	27928652	27938599	LINC01460	9947	27936099	27941099
NR_125761	chr1	-	85063646	85086714	LINC01461	23068	85084214	85089214
NR_110074	chr14	-	82071690	82089405	LINC01467	17715	82086905	82091905
NR_120641	chr10	-	54210636	54230293	LINC01468	19657	54227793	54232793
NR_109877	chr5	-	151998524	152351909	LINC01470	353385	152349409	152354409
NR_125397	chr3	-	127216443	127256623	LINC01471	40180	127254123	127259123
NR_110218	chr2	-	186898260	186951044	LINC01473	52784	186948544	186953544
NR_120618	chr10	-	101286106	101290934	LINC01475	4828	101288434	101293434
NR_110813	chr17	-	57508229	57604218	LINC01476	95989	57601718	57606718
NR_110791	chr18	+	37646249	37679197	LINC01477	32948	37643749	37648749
NR_110792	chr18	-	41903399	42111662	LINC01478	208263	42109162	42114162
NR_120456	chr12	+	68323014	68363797	LINC01479	40783	68320514	68325514
NR_120460	chr12	-	70615969	70637140	LINC01481	21171	70634640	70639640
NR_110825	chr17	+	66624294	66675747	LINC01482	51453	66621794	66626794
NR_109971	chr17	+	67590127	67899141	LINC01483	309014	67587627	67592627
NR_108027	chr5	-	173134601	173173212	LINC01484	38611	173170712	173175712
NR_108028	chr5	-	173213792	173217945	LINC01485	4153	173215445	173220445
NR_120462	chr12	-	109791991	109797293	LINC01486	5302	109794793	109799793
NR_120542	chr11	+	69300328	69308311	LINC01488	7983	69297828	69302828
NR_120466	chr12	+	15154766	15159617	LINC01489	4851	15152266	15157266
NR_120469	chr12	+	81156932	81164494	LINC01490	7562	81154432	81159432
NR_120336	chr15	-	48095580	48138433	LINC01491	42853	48135933	48140933
NR_121578	chr9	-	105902809	106087315	LINC01492	184506	106084815	106089815
NR_120553	chr11	+	38670407	38676799	LINC01493	6392	38667907	38672907
NR_110238	chr2	-	219765536	219795359	LINC01494	29823	219792859	219797859
NR_120583	chr11	-	22467217	22513565	LINC01495	46348	22511065	22516065
NR_110654	chrX	-	51242760	51250293	LINC01496	7533	51247793	51252793
NR_110875	chr17	+	67957847	67979685	LINC01497	21838	67955347	67960347
NR_120483	chr12	-	108853201	108867466	LINC01498	14265	108864966	108869966
NR_120584	chr11	+	41736117	41857992	LINC01499	121875	41733617	41738617
NR_110547	chr14	+	59295005	59484046	LINC01500	189041	59292505	59297505
NR_034157	chr9	-	93224713	93345028	LINC01501	120315	93342528	93347528
NR_034016	chr9	+	138466770	138478958	LINC01502	12188	138464270	138469270
NR_120685	chr9	+	132099201	132109756	LINC01503	10555	132096701	132101701
NR_110952	chr9	+	74920351	74958126	LINC01504	37775	74917851	74922851
NR_104145	chr9	+	109378338	109442081	LINC01505	63743	109375838	109380838
NR_109769	chr9	-	71158456	71161518	LINC01506	3062	71159018	71164018
NR_121213	chr9	+	82439444	82649470	LINC01507	210026	82436944	82441944
NR_109795	chr9	-	93063177	93195771	LINC01508	132594	93193271	93198271
NR_121581	chr9	-	110182564	110228866	LINC01509	46302	110226366	110231366
NR_120506	chr7	-	116203647	116254874	LINC01510	51227	116252374	116257374
NR_125810	chr5	-	1363696	1380188	LINC01511	16492	1377688	1382688
NR_024478	chr6	+	43858764	43905944	LINC01512	47180	43856264	43861264
NR_120620	chr10	+	102936078	102953904	LINC01514	17826	102933578	102938578
NR_120647	chr10	+	67331182	67526299	LINC01515	195117	67328682	67333682
NR_120649	chr10	+	25401986	25450162	LINC01516	48176	25399486	25404486
NR_120652	chr10	+	29032578	29097148	LINC01517	64570	29030078	29035078
NR_120656	chr10	-	43168460	43187207	LINC01518	18747	43184707	43189707
NR_120667	chr10	-	86953176	86958694	LINC01519	5518	86956194	86961194
NR_120671	chr10	+	87209348	87251758	LINC01520	42410	87206848	87211848
NR_120386	chr22	+	31742744	31747141	LINC01521	4397	31740244	31745244
NR_110027	chr20	-	46608836	46618861	LINC01522	10025	46616361	46621361
NR_110038	chr20	+	51237376	51266965	LINC01524	29589	51234876	51239876
NR_126408	chr1	+	117838087	117863958	LINC01525	25871	117835587	117840587
NR_104176	chr19	-	36279777	36288811	LINC01529	9034	36286311	36291311
NR_034159	chr19	-	52095035	52097633	LINC01530	2598	52095133	52100133
NR_040046	chr19	+	35896508	35907742	LINC01531	11234	35894008	35899008
NR_040036	chr19	+	29493461	29504862	LINC01532	11401	29490961	29495961
NR_110675	chr19	+	32516767	32539805	LINC01533	23038	32514267	32519267
NR_110719	chr19	+	37742786	37756437	LINC01535	13651	37740286	37745286
NR_126364	chr11	+	72281699	72284266	LINC01537	2567	72279199	72284199
NR_033983	chr18	-	61880317	61927290	LINC01538	46973	61924790	61929790
NR_040025	chr18	-	53750586	53804767	LINC01539	54181	53802267	53807267
NR_038326	chr18	-	69187199	69246192	LINC01541	58993	69243692	69248692
NR_110762	chr18	+	24002958	24018008	LINC01543	15050	24000458	24005458
NR_103449	chr18	+	59415408	59421928	LINC01544	6520	59412908	59417908
NR_046101	chrX	-	46746853	46759139	LINC01545	12286	46756639	46761639
NR_038428	chrX	+	3189860	3202694	LINC01546	12834	3187360	3192360
NR_027128	chr21	-	46353198	46359828	LINC01547	6630	46357328	46362328
NR_024102	chr21	-	34537775	34542541	LINC01548	4766	34540041	34545041
NR_037585	chr21	+	18811207	18821503	LINC01549	10296	18808707	18813707
NR_015430	chr14	-	98391946	98444461	LINC01550	52515	98441961	98446961
NR_026731	chr14	+	29241909	29264000	LINC01551	22091	29239409	29244409
NR_024340	chr10	-	61717974	61720671	LINC01553	2697	61718171	61723171
NR_026936	chr5	+	95187935	95195836	LINC01554	7901	95185435	95190435
NR_027379	chr1	-	85093912	85100703	LINC01555	6791	85098203	85103203
NR_026773	chr6	-	168185218	168197539	LINC01558	12321	168195039	168200039
NR_036555	chr12	-	13523604	13529679	LINC01559	6075	13527179	13532179
NR_126059	chrX	+	47342114	47344626	LINC01560	2512	47339614	47344614
NR_147076	chr1	-	51660766	51700768	LINC01562	40002	51698268	51703268
NR_110896	chr17	+	20978868	20993926	LINC01563	15058	20976368	20981368
NR_125841	chr6	+	53493177	53496192	LINC01564	3015	53490677	53495677
NR_125802	chr3	-	128290842	128294929	LINC01565	4087	128292429	128297429
NR_027080	chr16	+	34597786	34626084	LINC01566	28298	34595286	34600286
NR_122072	chr16	-	24672742	24682383	LINC01567	9641	24679883	24684883
NR_038234	chr16	+	73420703	73455295	LINC01568	34592	73418203	73423203
NR_039999	chr16	-	4295825	4303790	LINC01569	7965	4301290	4306290
NR_110902	chr16	-	5651169	5666251	LINC01570	15082	5663751	5668751
NR_110916	chr16	+	51796429	51806557	LINC01571	10128	51793929	51798929
NR_126330	chr16	-	72317199	72698908	LINC01572	381709	72696408	72701408
NR_037601	chr15	+	93426072	93441977	LINC01578	15905	93423572	93428572
NR_138083	chr15	-	94439288	94443828	LINC01579	4540	94441328	94446328
NR_120323	chr15	+	94443929	94527379	LINC01580	83450	94441429	94446429
NR_120320	chr15	-	94448633	94651167	LINC01581	202534	94648667	94653667
NR_120325	chr15	-	98626207	98631982	LINC01582	5775	98629482	98634482
NR_120367	chr15	+	82380934	82390034	LINC01583	9100	82378434	82383434
NR_120368	chr15	-	86626575	86659948	LINC01584	33373	86657448	86662448
NR_120371	chr15	+	91203464	91208185	LINC01585	4721	91200964	91205964
NR_120370	chr15	-	89128801	89148341	LINC01586	19540	89145841	89150841
NR_126519	chr4	+	5526295	5529527	LINC01587	3232	5523795	5528795
NR_126498	chr14	-	50448386	50474238	LINC01588	25852	50471738	50476738
NR_026784	chr6	+	88106841	88109459	LINC01590	2618	88104341	88109341
NR_026706	chr8	+	136246373	136311962	LINC01591	65589	136243873	136248873
NR_039986	chr8	-	69824037	70016425	LINC01592	192388	70013925	70018925
NR_135071	chr2	-	108665655	108669211	LINC01593	3556	108666711	108671711
NR_131251	chr2	-	108784203	108834297	LINC01594	50094	108831797	108836797
NR_132380	chr4	+	190802669	190806022	LINC01596	3353	190800169	190805169
NR_145432	chr20	-	29513583	29521213	LINC01597	7630	29518713	29523713
NR_133643	chr20	-	29558487	29570363	LINC01598	11876	29567863	29572863
NR_131171	chr14	-	50474030	50571761	LINC01599	97731	50569261	50574261
NR_131168	chr6	-	2622146	2634837	LINC01600	12691	2632337	2637337
NR_131768	chr18	+	42111743	42133868	LINC01601	22125	42109243	42114243
NR_130934	chr8	+	58890916	58896685	LINC01602	5769	58888416	58893416
NR_110433	chr8	-	70337105	70360479	LINC01603	23374	70357979	70362979
NR_121620	chr8	-	37263981	37351431	LINC01605	87450	37348931	37353931
NR_038235	chr8	+	58130834	58145513	LINC01606	14679	58128334	58133334
NR_125410	chr8	+	80680376	80715077	LINC01607	34701	80677876	80682876
NR_125417	chr8	-	111949918	112039662	LINC01608	89744	112037162	112042162
NR_125418	chr8	-	112111189	112248432	LINC01609	137243	112245932	112250932
NR_132100	chr6	-	85130750	85184647	LINC01611	53897	85182147	85187147
NR_125889	chr4	+	171147741	171204873	LINC01612	57132	171145241	171150241
NR_132393	chr9	+	122697337	122700110	LINC01613	2773	122694837	122699837
NR_132383	chr2	+	216582765	216585669	LINC01614	2904	216580265	216585265
NR_132623	chr6	-	169558186	169563084	LINC01615	4898	169560584	169565584
NR_147034	chr8	+	74791216	74795309	LINC01617	4093	74788716	74793716
NR_040106	chr4	+	53656160	53681631	LINC01618	25471	53653660	53658660
NR_046160	chr12	-	92378751	92536607	LINC01619	157856	92534107	92539107
NR_132343	chr20	-	43080623	43093984	LINC01620	13361	43091484	43096484
NR_131786	chr6	-	80513299	80521963	LINC01621	8664	80519463	80524463
NR_027115	chr6	-	961240	1101567	LINC01622	140327	1099067	1104067
NR_033379	chr6_cox_hap2	-	350247	354323	LINC01623	4076	351823	356823
NR_104177	chr6	+	170581561	170588554	LINC01624	6993	170579061	170584061
NR_033919	chr6	-	139790131	139795733	LINC01625	5602	139793233	139798233
NR_121615	chr6	+	72130729	72168575	LINC01626	37846	72128229	72133229
NR_133913	chr14	+	77425980	77432145	LINC01629	6165	77423480	77428480
NR_040074	chr18	+	48918411	49088839	LINC01630	170428	48915911	48920911
NR_146489	chr1	+	184970658	184977810	LINC01633	7152	184968158	184973158
NR_024417	chr22	+	18512150	18520734	LINC01634	8584	18509650	18514650
NR_110537	chr22	+	21311379	21318968	LINC01637	7589	21308879	21313879
NM_001350812	chr22	-	27617307	27620688	LINC01638	3381	27618188	27623188
NR_146918	chr22	+	43796336	43805687	LINC01639	9351	43793836	43798836
NR_134617	chr22	+	33504514	33512280	LINC01640	7766	33502014	33507014
NR_109967	chr22	-	47857047	47882860	LINC01644	25813	47880360	47885360
NR_126001	chr1	+	177320721	177335594	LINC01645	14873	177318221	177323221
NR_147025	chr1	+	4631546	4643764	LINC01646	12218	4629046	4634046
NR_104624	chr1	+	11669587	11673411	LINC01647	3824	11667087	11672087
NR_110790	chr1	-	30486798	30510459	LINC01648	23661	30507959	30512959
NR_125969	chr1	+	116461996	116468529	LINC01649	6533	116459496	116464496
NR_110794	chr1	+	218216846	218232482	LINC01653	15636	218214346	218219346
NR_125946	chr1	+	18392150	18400905	LINC01654	8755	18389650	18394650
NR_125989	chr1	-	222001007	222014008	LINC01655	13001	222011508	222016508
NR_125964	chr1	+	175846478	175849600	LINC01657	3122	175843978	175848978
NR_110539	chr22	-	23804268	23829167	LINC01658	24899	23826667	23831667
NR_136569	chr22	-	20632131	20656828	LINC01660	24697	20654328	20659328
NR_147165	chr1	+	107360860	107380815	LINC01661	19955	107358360	107363360
NR_136561	chr22	+	18721426	18745407	LINC01662	23981	18718926	18723926
NR_136571	chr22	-	18852555	18881944	LINC01663	29389	18879444	18884444
NR_103793	chr22	+	17602484	17612994	LINC01664	10510	17599984	17604984
NR_038377	chr4_gl000193_random	-	49162	88375	LINC01667	39213	85875	90875
NR_136540	chr21	-	44881839	44899414	LINC01669	17575	44896914	44901914
NR_131192	chr21	-	44019513	44035205	LINC01671	15692	44032705	44037705
NR_104620	chr1	+	6784804	6790072	LINC01672	5268	6782304	6787304
NR_110544	chr21	+	14918353	14930781	LINC01674	12428	14915853	14920853
NR_146890	chr1	-	166445008	166459276	LINC01675	14268	166456776	166461776
NR_125955	chr1	-	106132315	106161557	LINC01676	29242	106159057	106164057
NR_146609	chr1	-	106470245	106570875	LINC01677	100630	106568375	106573375
NR_131902	chr21	-	44777934	44782229	LINC01679	4295	44779729	44784729
NR_146892	chr1	-	191190288	191197628	LINC01680	7340	191195128	191200128
NR_146891	chr1	+	170143519	170210711	LINC01681	67192	170141019	170146019
NR_146476	chr1	-	230011296	230021565	LINC01682	10269	230019065	230024065
NR_146910	chr21	-	21265592	21272069	LINC01683	6477	21269569	21274569
NR_135519	chr21	+	25801053	25920256	LINC01684	119203	25798553	25803553
NR_109959	chr21	-	23381476	23470778	LINC01687	89302	23468278	23473278
NR_109963	chr21	-	25676862	25693690	LINC01689	16828	25691190	25696190
NR_046198	chr21	+	26212863	26430056	LINC01692	217193	26210363	26215363
NR_131925	chr1	+	211813149	211827963	LINC01693	14814	211810649	211815649
NR_146912	chr21	+	47013567	47022970	LINC01694	9403	47011067	47016067
NR_126012	chr21	-	29488412	29600986	LINC01695	112574	29598486	29603486
NR_135085	chr1	+	209498800	209501877	LINC01696	3077	209496300	209501300
NR_126010	chr21	+	29420732	29509928	LINC01697	89196	29418232	29423232
NR_146491	chr1	+	209545399	209553035	LINC01698	7636	209542899	209547899
NR_109962	chr21	-	40346354	40349700	LINC01700	3346	40347200	40352200
NR_146920	chr1	+	226271275	226277990	LINC01703	6715	226268775	226273775
NR_033946	chr1	-	158101833	158110430	LINC01704	8597	158107930	158112930
NR_110610	chr20	+	7328079	7349148	LINC01706	21069	7325579	7330579
NR_146608	chr1	+	69521580	69650685	LINC01707	129105	69519080	69524080
NR_125951	chr1	-	99937975	99953360	LINC01708	15385	99950860	99955860
NR_146917	chr1	-	219086098	219091853	LINC01710	5755	219089353	219094353
NR_146478	chr1	+	83911736	83920454	LINC01712	8718	83909236	83914236
NR_146909	chr20	-	6711387	6716783	LINC01713	5396	6714283	6719283
NR_125998	chr1	+	8268731	8275268	LINC01714	6537	8266231	8271231
NR_146730	chr1	+	28969767	28975311	LINC01715	5544	28967267	28972267
NR_136537	chr20	+	55152618	55171182	LINC01716	18564	55150118	55155118
NR_146914	chr1	+	208902032	208906529	LINC01717	4497	208899532	208904532
NR_125968	chr1	-	145376205	145382404	LINC01719	6199	145379904	145384904
NR_033922	chr1	+	190594019	190770788	LINC01720	176769	190591519	190596519
NR_040102	chr20	+	24180402	24205224	LINC01721	24822	24177902	24182902
NR_109868	chr20	-	12845851	12933167	LINC01722	87316	12930667	12935667
NR_146895	chr1	-	196014009	196057845	LINC01724	43836	196055345	196060345
NR_119375	chr1	-	84041470	84326679	LINC01725	285209	84324179	84329179
NR_109878	chr20	-	21591424	21684223	LINC01726	92799	21681723	21686723
NR_109880	chr20	+	21550661	21596360	LINC01727	45699	21548161	21553161
NR_109859	chr20	+	3789140	3793081	LINC01730	3941	3786640	3791640
NR_125966	chr1	+	181143619	181151342	LINC01732	7723	181141119	181146119
NR_110003	chr20	+	25936447	25949924	LINC01733	13477	25933947	25938947
NR_027124	chr20	-	37842423	37853391	LINC01734	10968	37850891	37855891
NR_135116	chr1	+	230138463	230142909	LINC01736	4446	230135963	230140963
NR_146479	chr1	-	230728405	230731329	LINC01737	2924	230728829	230733829
NR_146606	chr1	-	63466167	63478142	LINC01739	11975	63475642	63480642
NR_125985	chr1	+	212719035	212729408	LINC01740	10373	212716535	212721535
NR_110722	chr1	+	177669658	177679465	LINC01741	9807	177667158	177672158
NR_040002	chr1	-	246679340	246687589	LINC01743	8249	246685089	246690089
NR_110683	chr1	-	232862999	232878461	LINC01744	15462	232875961	232880961
NR_146922	chr1	+	232853816	232857995	LINC01745	4179	232851316	232856316
NR_146527	chr20	-	22647930	22665982	LINC01747	18052	22663482	22668482
NR_146508	chr1	-	60981387	61088357	LINC01748	106970	61085857	61090857
NR_033370	chr20	+	61640734	61716423	LINC01749	75689	61638234	61643234
NR_145438	chr1	+	112533157	112541463	LINC01750	8306	112530657	112535657
NR_135005	chr20	-	7282735	7288079	LINC01751	5344	7285579	7290579
NR_147162	chr1	-	56381281	56410636	LINC01753	29355	56408136	56413136
NR_146496	chr20	-	46011509	46040888	LINC01754	29379	46038388	46043388
NR_147161	chr1	+	56410759	56415792	LINC01755	5033	56408259	56413259
NR_110758	chr1	-	29656131	29676626	LINC01756	20495	29674126	29679126
NR_132738	chr1	+	9242262	9252144	LINC01759	9882	9239762	9244762
NR_135588	chr1	-	95776483	95783819	LINC01760	7336	95781319	95786319
NR_033966	chr1	+	95940292	95944912	LINC01761	4620	95937792	95942792
NR_125972	chr1	-	116966345	117021448	LINC01762	55103	117018948	117023948
NR_146610	chr1	+	91317315	91320456	LINC01763	3141	91314815	91319815
NR_110750	chr19	+	36088796	36092403	LINC01766	3607	36086296	36091296
NR_125994	chr1	-	1365536	1369953	LINC01770	4417	1367453	1372453
NR_131923	chr1	+	53793904	53802181	LINC01771	8277	53791404	53796404
NR_147210	chr1	+	16787442	16794976	LINC01772	7534	16784942	16789942
NR_146915	chr1	+	209145798	209148652	LINC01774	2854	209143298	209148298
NR_134931	chr19	-	2458934	2462183	LINC01775	3249	2459683	2464683
NR_046088	chr1	+	98676266	98738214	LINC01776	61948	98673766	98678766
NR_027088	chr1	+	4472110	4484744	LINC01777	12634	4469610	4474610
NR_146732	chr1	+	31297498	31307131	LINC01778	9633	31294998	31299998
NR_146623	chr1	+	119870874	119898805	LINC01780	27931	119868374	119873374
NR_125940	chr1	+	81001439	81112473	LINC01781	111034	80998939	81003939
NR_110694	chr19	-	32592997	32596822	LINC01782	3825	32594322	32599322
NR_135233	chr19	-	22798358	22806773	LINC01785	8415	22804273	22809273
NR_110693	chr1	-	96719624	96839681	LINC01787	120057	96837181	96842181
NR_125938	chr1	+	71172135	71252151	LINC01788	80016	71169635	71174635
NR_110223	chr2	+	195595318	195626159	LINC01790	30841	195592818	195597818
NR_147209	chr19	+	31658415	31698569	LINC01791	40154	31655915	31660915
NR_037886	chr2	-	201577027	201599900	LINC01792	22873	201597400	201602400
NR_110219	chr2	+	59444842	59506535	LINC01793	61693	59442342	59447342
NR_147010	chr2	+	58503011	58523683	LINC01795	20672	58500511	58505511
NR_135562	chr2	-	103489797	103512180	LINC01796	22383	103509680	103514680
NR_110265	chr2	-	66924161	66930359	LINC01797	6198	66927859	66932859
NR_110156	chr2	+	66801161	66922720	LINC01798	121559	66798661	66803661
NR_110169	chr2	+	67131567	67198598	LINC01799	67031	67129067	67134067
NR_110224	chr2	-	65073263	65090765	LINC01800	17502	65088265	65093265
NR_033982	chr19	-	35307057	35323773	LINC01801	16716	35321273	35326273
NR_146973	chr2	+	208125168	208135788	LINC01802	10620	208122668	208127668
NR_110201	chr2	+	15830905	15859085	LINC01804	28180	15828405	15833405
NR_147011	chr2	+	64713486	64728038	LINC01805	14552	64710986	64715986
NR_110164	chr2	+	162101249	162105561	LINC01806	4312	162098749	162103749
NR_110271	chr2	-	68023185	68052694	LINC01812	29509	68050194	68055194
NR_135590	chr2	-	56301788	56317517	LINC01813	15729	56315017	56320017
NR_110257	chr2	-	8699962	8723922	LINC01814	23960	8721422	8726422
NR_110161	chr2	-	81688482	81694070	LINC01815	5588	81691570	81696570
NR_146972	chr2	-	151091405	151113521	LINC01817	22116	151111021	151116021
NR_110585	chr2	-	43254991	43266682	LINC01819	11691	43264182	43269182
NR_110222	chr2	+	195208992	195284355	LINC01821	75363	195206492	195211492
NR_038837	chr2	-	21910305	21933524	LINC01822	23219	21931024	21936024
NR_147208	chr2	-	123823731	123831057	LINC01826	7326	123828557	123833557
NR_110564	chr2	+	67313577	67516376	LINC01828	202799	67311077	67316077
NR_038844	chr2	-	67350488	67442451	LINC01829	91963	67439951	67444951
NR_135526	chr2	+	138859453	138863475	LINC01832	4022	138856953	138861953
NR_147195	chr2	-	45148218	45166338	LINC01833	18120	45163838	45168838
NM_001302493	chr19	-	15962803	15975714	LINC01835	12911	15973214	15978214
NR_146451	chr19	+	35396218	35399094	LINC01838	2876	35393718	35398718
NR_046593	chr3	-	184264501	184274706	LINC01840	10205	184272206	184277206
NR_134908	chr19	-	14416269	14474802	LINC01841	58533	14472302	14477302
NR_134916	chr19	+	14444554	14454726	LINC01842	10172	14442054	14447054
NR_105045	chr5	+	133842242	133844921	LINC01843	2679	133839742	133844742
NR_110558	chr5	+	142125164	142140558	LINC01844	15394	142122664	142127664
NR_027110	chr5	-	158875563	158893284	LINC01845	17721	158890784	158895784
NR_146477	chr5	-	97421569	97496943	LINC01846	75374	97494443	97499443
NR_109891	chr5	-	159203781	159298391	LINC01847	94610	159295891	159300891
NR_146956	chr2	+	101220200	101225820	LINC01849	5620	101217700	101222700
NR_147201	chr15	-	38361012	38365191	LINC01852	4179	38362691	38367691
NR_122041	chr2	-	129999745	130031464	LINC01854	31719	130028964	130033964
NR_110285	chr2	+	130680749	130704276	LINC01856	23527	130678249	130683249
NR_135566	chr2	+	208527107	208543846	LINC01857	16739	208524607	208529607
NR_110745	chr19	-	23237624	23244067	LINC01858	6443	23241567	23246567
NR_110746	chr19	-	23197876	23206499	LINC01859	8623	23203999	23208999
NR_146729	chr5	-	153266987	153278547	LINC01861	11560	153276047	153281047
NR_110741	chr19	+	56578049	56590166	LINC01864	12117	56575549	56580549
NR_146953	chr2	+	316283	337054	LINC01865	20771	313783	318783
NR_135239	chr2	+	52597785	52617208	LINC01867	19423	52595285	52600285
NR_136526	chr19	+	51774519	51784488	LINC01872	9969	51772019	51777019
NR_130931	chr2	+	66610437	66619578	LINC01873	9141	66607937	66612937
NR_110249	chr2	-	156877046	157111443	LINC01876	234397	157108943	157113943
NR_110270	chr2	+	200472790	200523855	LINC01877	51065	200470290	200475290
NR_131941	chr2	+	213660054	213683987	LINC01878	23933	213657554	213662554
NR_122073	chr18	+	74401985	74405592	LINC01879	3607	74399485	74404485
NR_146651	chr2	-	242989834	243026289	LINC01880	36455	243023789	243028789
NR_130701	chr2	+	243030783	243102476	LINC01881	71693	243028283	243033283
NR_110763	chr18	-	12739484	12749421	LINC01882	9937	12746921	12751921
NR_146968	chr2	+	108145874	108172952	LINC01886	27078	108143374	108148374
NR_146509	chr18	-	10610995	10626417	LINC01887	15422	10623917	10628917
NR_146988	chr2	-	235353233	235363239	LINC01891	10006	235360739	235365739
NR_146900	chr18	+	5081180	5098779	LINC01892	17599	5078680	5083680
NR_146507	chr18	+	73921464	73927779	LINC01893	6315	73918964	73923964
NR_146903	chr18	-	22512737	22567943	LINC01894	55206	22565443	22570443
NR_146506	chr18	-	3347700	3350557	LINC01895	2857	3348057	3353057
NR_134646	chr18	-	73408037	73424358	LINC01898	16321	73421858	73426858
NR_126324	chr18	-	69399851	69449462	LINC01899	49611	69446962	69451962
NR_146471	chr18	-	65475743	65482059	LINC01903	6316	65479559	65484559
NR_146510	chr18	+	53709508	53763546	LINC01905	54038	53707008	53712008
NR_040038	chr2	-	231555635	231565244	LINC01907	9609	231562744	231567744
NR_126336	chr18	+	68002674	68019695	LINC01909	17021	68000174	68005174
NR_110764	chr18	-	68047375	68051827	LINC01910	4452	68049327	68054327
NR_033996	chr2	+	42104694	42121186	LINC01913	16492	42102194	42107194
NR_040033	chr18	+	22208145	22242162	LINC01915	34017	22205645	22210645
NR_110798	chr18	+	51094816	51124221	LINC01919	29405	51092316	51097316
NR_110241	chr2	-	151409045	151428735	LINC01920	19690	151426235	151431235
NR_131977	chr18	+	72076682	72080443	LINC01922	3761	72074182	72079182
NR_110267	chr2	-	199164086	199239821	LINC01923	75735	199237321	199242321
NR_033881	chr18	+	61771324	62090827	LINC01924	319503	61768824	61773824
NR_136505	chr18	-	508567	515294	LINC01925	6727	512794	517794
NR_146904	chr18	+	56481111	56501596	LINC01926	20485	56478611	56483611
NR_110784	chr18	-	74334737	74350968	LINC01927	16231	74348468	74353468
NR_146901	chr18	+	11454476	11465995	LINC01928	11519	11451976	11456976
NR_110743	chr18	-	52773134	52791537	LINC01929	18403	52789037	52794037
NR_146275	chr1	-	98399029	98407296	LINC01930	8267	98404796	98409796
NR_145421	chr2	-	150624019	150715705	LINC01931	91686	150713205	150718205
NR_134261	chr5	+	158654722	158672135	LINC01932	17413	158652222	158657222
NR_109876	chr5	+	151338458	151650010	LINC01933	311552	151335958	151340958
NR_130784	chr2	+	181988563	182264280	LINC01934	275717	181986063	181991063
NR_135530	chr2	-	103583866	103600887	LINC01935	17021	103598387	103603387
NR_110179	chr2	-	895901	901137	LINC01939	5236	898637	903637
NR_034162	chr2	-	239840997	239847965	LINC01940	6968	239845465	239850465
NR_146970	chr2	-	126867676	126875562	LINC01941	7886	126873062	126878062
NR_146727	chr5	+	173116461	173132852	LINC01942	16391	173113961	173118961
NR_146484	chr2	-	132741358	132795473	LINC01945	54115	132792973	132797973
NR_146994	chr2	-	32018889	32029049	LINC01946	10160	32026549	32031549
NR_108020	chr5	-	166332226	166353375	LINC01947	21149	166350875	166355875
NR_104664	chr5	-	55753621	55777596	LINC01948	23975	55775096	55780096
NR_130914	chr5	-	86511551	86535018	LINC01949	23467	86532518	86537518
NR_104671	chr5	-	106150897	106346715	LINC01950	195818	106344215	106349215
NR_046113	chr5	-	174346084	174422734	LINC01951	76650	174420234	174425234
NR_146974	chr2	-	214020539	214032434	LINC01953	11895	214029934	214034934
NR_110575	chr2	+	11018392	11025244	LINC01954	6852	11015892	11020892
NR_134282	chr5	+	113911737	113915667	LINC01957	3930	113909237	113914237
NR_027127	chr5	-	134984371	134989624	LINC01959	5253	134987124	134992124
NR_037701	chr2	+	217081611	217084915	LINC01963	3304	217079111	217084111
NR_146453	chr2	-	85291232	85294470	LINC01964	3238	85291970	85296970
NR_037891	chr3	+	194429149	194502897	LINC01968	73748	194426649	194431649
NR_135639	chr17	-	80247921	80250690	LINC01970	2769	80248190	80253190
NR_146990	chr3	-	194485966	194489438	LINC01972	3472	194486938	194491938
NR_028337	chr17	-	75875082	75880169	LINC01973	5087	75877669	75882669
NR_146884	chr17	+	3880396	3886439	LINC01975	6043	3877896	3882896
NR_146504	chr17	+	77797250	77801503	LINC01977	4253	77794750	77799750
NR_110851	chr17	+	77893155	77897803	LINC01978	4648	77890655	77895655
NR_110850	chr17	-	77889050	77900524	LINC01979	11474	77898024	77903024
NR_146630	chr3	+	27839078	27901816	LINC01980	62738	27836578	27841578
NR_132438	chr3	-	27872376	27875627	LINC01981	3251	27873127	27878127
NR_146898	chr17	+	50467881	50613061	LINC01982	145180	50465381	50470381
NR_134939	chr3	-	195563325	195587275	LINC01983	23950	195584775	195589775
NR_147054	chr3	+	30560359	30568685	LINC01985	8326	30557859	30562859
NR_104134	chr17	-	75718953	75724641	LINC01987	5688	75722141	75727141
NR_110748	chr17	-	32496394	32510651	LINC01989	14257	32508151	32513151
NR_110039	chr3	+	107149776	107182759	LINC01990	32983	107147276	107152276
NR_135538	chr3	-	187676562	187694195	LINC01991	17633	187691695	187696695
NR_146896	chr17	-	26255949	26318733	LINC01992	62784	26316233	26321233
NR_073178	chr17	-	76257429	76274573	LINC01993	17144	76272073	76277073
NR_040105	chr3	-	182164757	182204150	LINC01994	39393	182201650	182206650
NR_134941	chr3	-	182216077	182224912	LINC01995	8835	182222412	182227412
NR_145431	chr17	+	4513743	4520942	LINC01996	7199	4511243	4516243
NR_126009	chr17	+	58641906	58663981	LINC01999	22075	58639406	58644406
NR_135479	chr17	+	33895132	33901332	LINC02001	6200	33892632	33897632
NR_135222	chr17	+	70338951	70351277	LINC02003	12326	70336451	70341451
NR_146711	chr3	+	134032417	134040013	LINC02004	7596	134029917	134034917
NR_146637	chr3	+	73858394	73928771	LINC02005	70377	73855894	73860894
NR_146713	chr3	-	153101338	153480315	LINC02006	378977	153477815	153482815
NR_147146	chr3	+	82035292	82512826	LINC02008	477534	82032792	82037792
NR_135561	chr3	+	146639709	146643005	LINC02010	3296	146637209	146642209
NR_135245	chr3	-	14840837	14852921	LINC02011	12084	14850421	14855421
NR_145451	chr3	-	197232132	197236532	LINC02012	4400	197234032	197239032
NR_146710	chr3	-	129807708	129813147	LINC02014	5439	129810647	129815647
NR_110826	chr3	+	177534652	177617012	LINC02015	82360	177532152	177537152
NR_110147	chr3	-	127041149	127109513	LINC02016	68364	127107013	127112013
NR_147142	chr3	+	55212199	55223242	LINC02017	11043	55209699	55214699
NR_146653	chr3	+	129830549	129839412	LINC02021	8863	129828049	129833049
NR_136189	chr3	-	12919020	12926710	LINC02022	7690	12924210	12929210
NR_146652	chr3	-	117397539	117409772	LINC02024	12233	117407272	117412272
NR_147147	chr3	+	84931240	84942530	LINC02025	11290	84928740	84933740
NR_033944	chr3	-	193675160	193721448	LINC02026	46288	193718948	193723948
NR_132411	chr3	+	81043018	81144798	LINC02027	101780	81040518	81045518
NR_136179	chr3	-	193723244	193788759	LINC02028	65515	193786259	193791259
NR_135546	chr3	+	156799629	156806336	LINC02029	6707	156797129	156802129
NR_134937	chr3	+	147795945	147805816	LINC02032	9871	147793445	147798445
NR_024618	chr3	+	122605359	122611263	LINC02035	5904	122602859	122607859
NR_125403	chr3	-	193920804	193967942	LINC02036	47138	193965442	193970442
NR_125402	chr3	+	193965436	193975561	LINC02037	10125	193962936	193967936
NR_146718	chr3	-	193558616	193561798	LINC02038	3182	193559298	193564298
NR_105042	chr5	+	125515269	125529543	LINC02039	14274	125512769	125517769
NR_146716	chr3	+	187164833	187167737	LINC02041	2904	187162333	187167333
NR_110017	chr3	-	112455295	112468166	LINC02042	12871	112465666	112470666
NR_125409	chr3	-	186528668	186543310	LINC02043	14642	186540810	186545810
NR_110823	chr3	-	112861196	112886578	LINC02044	25382	112884078	112889078
NR_146712	chr3	+	147998677	148117743	LINC02046	119066	147996177	148001177
NR_135570	chr3	-	120531027	120555204	LINC02049	24177	120552704	120557704
NR_147143	chr3	+	80814047	80838539	LINC02050	24492	80811547	80816547
NR_033844	chr3	-	186172769	186211450	LINC02052	38681	186208950	186213950
NR_132416	chr3	+	180131960	180140289	LINC02053	8329	180129460	180134460
NM_001322103	chr3	+	184119324	184157436	LINC02054	38112	184116824	184121824
NR_147196	chr8	+	137543040	137909844	LINC02055	366804	137540540	137545540
NR_105007	chr5	-	71869901	71956496	LINC02056	86595	71953996	71958996
NR_146624	chr5	-	60546386	60560756	LINC02057	14370	60558256	60563256
NR_105017	chr5	+	86042634	86045589	LINC02059	2955	86040134	86045134
NR_105021	chr5	-	87704798	87734907	LINC02060	30109	87732407	87737407
NR_104628	chr5	-	29380195	29396083	LINC02064	15888	29393583	29398583
NR_146488	chr5	-	65500950	65505274	LINC02065	4324	65502774	65507774
NR_102265	chr3	+	161144214	161166030	LINC02067	21816	161141714	161146714
NR_146714	chr3	-	172278690	172313397	LINC02068	34707	172310897	172315897
NR_110043	chr3	-	184474176	184490943	LINC02069	16767	184488443	184493443
NR_135563	chr3	+	86531092	86546146	LINC02070	15054	86528592	86533592
NR_110751	chr17	-	49389969	49412523	LINC02071	22554	49410023	49415023
NR_122104	chr17	+	49414075	49419932	LINC02072	5857	49411575	49416575
NR_146897	chr17	+	49512787	49523163	LINC02073	10376	49510287	49515287
NR_110805	chr17	-	47535222	47539111	LINC02075	3889	47536611	47541611
NR_104343	chr17	+	18314472	18317702	LINC02076	3230	18311972	18316972
NR_146636	chr3	-	78087855	78098114	LINC02077	10259	78095614	78100614
NR_109783	chr17	+	77681074	77686081	LINC02078	5007	77678574	77683574
NR_110837	chr17	+	74795125	74803184	LINC02080	8059	74792625	74797625
NR_110849	chr17	-	76613465	76628139	LINC02081	14674	76625639	76630639
NR_109989	chr3	+	168619732	168639781	LINC02082	20049	168617232	168622232
NR_026934	chr3	+	101659702	101716770	LINC02085	57068	101657202	101662202
NR_110839	chr17	-	15709555	15721056	LINC02087	11501	15718556	15723556
NR_146887	chr17	-	20516290	20536564	LINC02088	20274	20534064	20539064
NR_146899	chr17	+	50939480	50976948	LINC02089	37468	50936980	50941980
NR_104420	chr17	-	33614	37042	LINC02091	3428	34542	39542
NR_040020	chr17	+	71782960	71796934	LINC02092	13974	71780460	71785460
NR_146885	chr17	-	13202497	13210077	LINC02093	7580	13207577	13212577
NR_110876	chr17	-	70017991	70022120	LINC02095	4129	70019620	70024620
NR_110827	chr17	+	70068473	70089622	LINC02097	21149	70065973	70070973
NR_146647	chr11	+	128078660	128111336	LINC02098	32676	128076160	128081160
NR_125815	chr8	+	29605824	29656008	LINC02099	50184	29603324	29608324
NR_104669	chr5	-	57403458	57418168	LINC02101	14710	57415668	57420668
NR_103771	chr5	-	6686437	6707824	LINC02102	21387	6705324	6710324
NR_104632	chr5	+	39520532	39524810	LINC02104	4278	39518032	39523032
NR_147167	chr5	-	53071880	53115512	LINC02105	43632	53113012	53118012
NR_147009	chr5	+	38025798	38184034	LINC02107	158236	38023298	38028298
NR_109904	chr5	-	57837393	57854070	LINC02108	16677	57851570	57856570
NR_130777	chr5	+	29143609	29173082	LINC02109	29473	29141109	29146109
NR_134262	chr5	+	37948592	37951156	LINC02110	2564	37946092	37951092
NR_033975	chr5	-	17379014	17387419	LINC02111	8405	17384919	17389919
NR_027112	chr5	-	9641426	9903936	LINC02112	262510	9901436	9906436
NR_110562	chr5	+	98869693	98913658	LINC02113	43965	98867193	98872193
NR_104670	chr5	-	102864134	102877686	LINC02115	13552	102875186	102880186
NR_147166	chr5	+	51303864	51339743	LINC02118	35879	51301364	51306364
NR_134272	chr5	+	38148581	38153817	LINC02119	5236	38146081	38151081
NR_033832	chr5	+	32947548	32962573	LINC02120	15025	32945048	32950048
NR_134266	chr5	-	5069304	5078424	LINC02121	9120	5075924	5080924
NR_110934	chr16	+	76668894	76692375	LINC02125	23481	76666394	76671394
NR_110918	chr16	-	65175658	65210476	LINC02126	34818	65207976	65212976
NR_110913	chr16	+	51051668	51069688	LINC02127	18020	51049168	51054168
NR_131191	chr16	-	14456965	14464123	LINC02130	7158	14461623	14466623
NR_110650	chr16	+	47892491	47942342	LINC02133	49851	47889991	47894991
NR_146502	chr16	+	47999599	48005598	LINC02134	5999	47997099	48002099
NR_038438	chr16	+	86320036	86326995	LINC02135	6959	86317536	86322536
NR_146574	chr16	-	71444343	71460367	LINC02136	16024	71457867	71462867
NR_046200	chr16	+	89232790	89235555	LINC02138	2765	89230290	89235290
NR_033984	chr16	+	85170755	85183049	LINC02139	12294	85168255	85173255
NR_134923	chr16	-	54399918	54404611	LINC02140	4693	54402111	54407111
NR_110917	chr16	+	59889256	60087875	LINC02141	198619	59886756	59891756
NR_105064	chr5	-	163875427	163894408	LINC02143	18981	163891908	163896908
NR_028351	chr5	-	6310553	6337405	LINC02145	26852	6334905	6339905
NR_147185	chr5	-	20612733	20615644	LINC02146	2911	20613144	20618144
NR_104997	chr5	+	117066055	117601757	LINC02147	535702	117063555	117068555
NR_109944	chr5	-	15191754	15266669	LINC02149	74915	15264169	15269169
NR_104625	chr5	-	16373469	16441211	LINC02150	67742	16438711	16443711
NR_033894	chr8	+	20831496	20852630	LINC02153	21134	20828996	20833996
NR_146309	chrX	-	13284166	13321571	LINC02154	37405	13319071	13324071
NR_122070	chr3	+	42812103	42815126	LINC02158	3023	42809603	42814603
NR_027111	chr5	-	160358785	160365633	LINC02159	6848	160363133	160368133
NR_147008	chr5	+	33229840	33255659	LINC02160	25819	33227340	33232340
NR_147000	chr5	+	3452929	3461774	LINC02162	8845	3450429	3455429
NR_033985	chr16	+	34980922	34990995	LINC02167	10073	34978422	34983422
NR_126340	chr16	-	54279456	54304791	LINC02169	25335	54302291	54307291
NR_131948	chr16	-	80862631	80926493	LINC02170	63862	80923993	80928993
NR_034136	chr4	-	3675319	3679582	LINC02171	4263	3677082	3682082
NR_146553	chr4	+	138466884	138524584	LINC02172	57700	138464384	138469384
NR_147150	chr4	+	107354780	107374604	LINC02173	19824	107352280	107357280
NR_147157	chr4	-	172523833	172559914	LINC02174	36081	172557414	172562414
NR_135195	chr16	+	9449444	9501950	LINC02177	52506	9446944	9451944
NR_146572	chr16	-	50424826	50429044	LINC02178	4218	50426544	50431544
NR_104655	chr16	+	52119192	52132979	LINC02180	13787	52116692	52121692
NR_126008	chr16	+	87091389	87097597	LINC02181	6208	87088889	87093889
NR_110909	chr16	-	14103132	14109875	LINC02185	6743	14107375	14112375
NR_135182	chr16	+	86755696	86771432	LINC02188	15736	86753196	86758196
NR_146571	chr16	-	31558018	31564888	LINC02190	6870	31562388	31567388
NR_110649	chr16	-	47883224	47921041	LINC02192	37817	47918541	47923541
NR_134269	chr5	-	70616857	70742583	LINC02197	125726	70740083	70745083
NR_130778	chr5	-	68263567	68325754	LINC02198	62187	68323254	68328254
NR_109932	chr5	+	8839843	8881636	LINC02199	41793	8837343	8842343
NR_109881	chr5	-	121964646	122066255	LINC02201	101609	122063755	122068755
NR_109890	chr5	+	158527490	158544486	LINC02202	16996	158524990	158529990
NR_015416	chr15	+	22278031	22371088	LINC02203	93057	22275531	22280531
NR_135691	chr15	-	70863296	70878945	LINC02204	15649	70876445	70881445
NR_135687	chr15	-	67223874	67248853	LINC02206	24979	67246353	67251353
NR_120321	chr15	+	94399788	94421585	LINC02207	21797	94397288	94402288
NR_104610	chr5	-	117686666	117897812	LINC02208	211146	117895312	117900312
NR_024473	chr8	+	29779028	29811123	LINC02209	32095	29776528	29781528
NR_138258	chr17_ctg5_hap1	-	1143723	1170468	LINC02210	26745	1167968	1172968
NM_001256299	chr17_ctg5_hap1	-	954314	1170468	LINC02210-CRHR1	216154	1167968	1172968
NR_136209	chr5	+	25191061	25302389	LINC02211	111328	25188561	25193561
NR_104606	chr5	-	10493638	10502840	LINC02212	9202	10500340	10505340
NR_134289	chr5	-	10505101	10522196	LINC02213	17095	10519696	10524696
NR_104678	chr5	-	116078997	116097905	LINC02214	18908	116095405	116100405
NR_104998	chr5	+	117931882	117963787	LINC02215	31905	117929382	117934382
NR_134275	chr5	+	17404127	17441803	LINC02217	37676	17401627	17406627
NR_134270	chr5	+	17444118	17484055	LINC02218	39937	17441618	17446618
NR_105003	chr5	+	67485703	67494235	LINC02219	8532	67483203	67488203
NR_147005	chr5	-	12877583	13032998	LINC02220	155415	13030498	13035498
NR_147004	chr5	+	9854488	9857721	LINC02221	3233	9851988	9856988
NR_134286	chr5	+	17807382	17930598	LINC02223	123216	17804882	17809882
NR_131946	chr5	-	44495245	44510384	LINC02224	15139	44507884	44512884
NR_109900	chr5	-	57186157	57194989	LINC02225	8832	57192489	57197489
NR_039984	chr5	-	8333595	8457677	LINC02226	124082	8455177	8460177
NR_109888	chr5	-	157747711	157836781	LINC02227	89070	157834281	157839281
NR_147006	chr5	-	25126413	25190765	LINC02228	64352	25188265	25193265
NR_105001	chr5	-	65803372	65807432	LINC02229	4060	65804932	65809932
NR_146276	chr12	-	65314624	65386071	LINC02231	71447	65383571	65388571
NR_033976	chr4	-	65779998	65870218	LINC02232	90220	65867718	65872718
NR_146278	chr4	-	160587657	160698936	LINC02233	111279	160696436	160701436
NR_146299	chr5	+	97176461	97259179	LINC02234	82718	97173961	97178961
NR_146281	chr5	+	6795992	6826841	LINC02236	30849	6793492	6798492
NR_146282	chr8	+	112388867	112482846	LINC02237	93979	112386367	112391367
NR_146300	chr1	+	74140361	74204325	LINC02238	63964	74137861	74142861
NR_037896	chr5	-	24835388	24840692	LINC02239	5304	24838192	24843192
NR_109887	chr5	+	124828953	124937920	LINC02240	108967	124826453	124831453
NR_147169	chr5	-	66928093	66942617	LINC02242	14524	66940117	66945117
NR_134925	chrX	+	134083578	134087411	LINC02243	3833	134081078	134086078
NR_036586	chr2	-	65128973	65159581	LINC02245	30608	65157081	65162081
NR_146322	chr21	-	16189158	16290989	LINC02246	101831	16288489	16293489
NR_026771	chr15	+	30488238	30506743	LINC02249	18505	30485738	30490738
NR_146565	chr15	+	98546267	98565568	LINC02251	19301	98543767	98548767
NR_146869	chr15	-	34943335	34947965	LINC02252	4630	34945465	34950465
NR_120324	chr15	-	97913600	98065041	LINC02254	151441	98062541	98067541
NR_146881	chr15	+	74671422	74687096	LINC02255	15674	74668922	74673922
NR_102756	chr15	+	32828959	32872810	LINC02256	43851	32826459	32831459
NR_135684	chr15	-	72900821	72929296	LINC02259	28475	72926796	72931796
NR_134657	chr4	-	55469377	55473298	LINC02260	3921	55470798	55475798
NR_125921	chr4	+	27219100	27283847	LINC02261	64747	27216600	27221600
NR_147151	chr4	-	118235752	118281795	LINC02262	46043	118279295	118284295
NR_147153	chr4	+	118281807	118294005	LINC02263	12198	118279307	118284307
NR_147154	chr4	+	118755555	118791103	LINC02264	35548	118753055	118758055
NR_121641	chr4	+	40309201	40332436	LINC02265	23235	40306701	40311701
NR_147156	chr4	-	146256414	146261571	LINC02266	5157	146259071	146264071
NR_147149	chr4	+	97231853	97739566	LINC02267	507713	97229353	97234353
NR_125896	chr4	-	175015810	175141549	LINC02268	125739	175139049	175144049
NR_146487	chr4	+	174818423	174850676	LINC02269	32253	174815923	174820923
NR_125910	chr4	+	12225074	12252909	LINC02270	27835	12222574	12227574
NR_147148	chr4	+	62009373	62019369	LINC02271	9996	62006873	62011873
NR_121628	chr4	+	153021904	153025868	LINC02273	3964	153019404	153024404
NR_135238	chr14	-	74289261	74296838	LINC02274	7577	74294338	74299338
NR_037878	chr4	-	170838911	170897053	LINC02275	58142	170894553	170899553
NR_146991	chr4	+	38565623	38575581	LINC02278	9958	38563123	38568123
NR_135293	chr14	-	105127456	105131895	LINC02280	4439	105129395	105134395
NR_147160	chr4	+	55199058	55222271	LINC02283	23213	55196558	55201558
NR_146490	chr14	+	101587192	101589882	LINC02285	2690	101584692	101589692
NR_110554	chr14	+	77507391	77535846	LINC02288	28455	77504891	77509891
NR_110553	chr14	-	77535522	77542534	LINC02289	7012	77540034	77545034
NR_033943	chr14	-	98098983	98152995	LINC02291	54012	98150495	98155495
NR_110127	chr14	+	95795920	95801841	LINC02292	5921	95793420	95798420
NR_110556	chr14	+	27278553	27289909	LINC02293	11356	27276053	27281053
NR_110033	chr14	-	27244700	27291326	LINC02294	46626	27288826	27293826
NR_046104	chr14	-	19407014	19410111	LINC02297	3097	19407611	19412611
NR_110546	chr14	+	105560483	105565833	LINC02298	5350	105557983	105562983
NR_146552	chr14	+	97207527	97256950	LINC02299	49423	97205027	97210027
NR_146650	chr14	+	83108975	83173169	LINC02301	64194	83106475	83111475
NR_146457	chr14	-	45232359	45268329	LINC02302	35970	45265829	45270829
NR_146547	chr14	-	46175460	46184805	LINC02303	9345	46182305	46187305
NR_146554	chr14	+	97621193	97625073	LINC02304	3880	97618693	97623693
NR_109999	chr14	-	81908330	81916501	LINC02308	8171	81914001	81919001
NR_146549	chr14	-	51858846	51863853	LINC02310	5007	51861353	51866353
NR_146498	chr14	-	82200955	82209482	LINC02311	8527	82206982	82211982
NR_146447	chr14	-	98215600	98229168	LINC02312	13568	98226668	98231668
NR_146544	chr14	+	32414058	32419500	LINC02313	5442	32411558	32416558
NR_109758	chr14	+	41423915	41610251	LINC02315	186336	41421415	41426415
NR_146492	chr14	-	90918406	90921461	LINC02317	3055	90918961	90923961
NR_146450	chr14	+	96039898	96048293	LINC02318	8395	96037398	96042398
NR_146561	chr14	+	103011590	103022163	LINC02323	10573	103009090	103014090
NR_103769	chr14	-	65679610	65689065	LINC02324	9455	65686565	65691565
NR_110166	chr14	+	97925152	98047720	LINC02325	122568	97922652	97927652
NR_110155	chr14	+	86401021	86596121	LINC02328	195100	86398521	86403521
NR_146551	chr14	-	88100722	88121638	LINC02330	20916	88119138	88124138
NR_120400	chr13	+	52908429	52916018	LINC02333	7589	52905929	52910929
NR_135814	chr13	+	112248355	112294426	LINC02337	46071	112245855	112250855
NR_120416	chr13	+	58739960	58783617	LINC02338	43657	58737460	58742460
NR_134946	chr13	-	61998821	62002079	LINC02339	3258	61999579	62004579
NR_135319	chr13	+	42999027	43060092	LINC02341	61065	42996527	43001527
NR_146542	chr13	+	34922179	35190429	LINC02343	268250	34919679	34924679
NR_120330	chr15	+	38332593	38354541	LINC02345	21948	38330093	38335093
NR_040082	chr15	+	26147506	26298267	LINC02346	150761	26145006	26150006
NR_130748	chr12	+	126927026	126957331	LINC02347	30305	126924526	126929526
NR_147041	chr15	-	102142988	102154542	LINC02348	11554	102152042	102157042
NR_146291	chr12	+	126910691	126918773	LINC02350	8082	126908191	126913191
NR_146567	chr15	-	98866661	98964227	LINC02351	97566	98961727	98966727
NR_135834	chr15	+	31508223	31517210	LINC02352	8987	31505723	31510723
NR_125887	chr4	+	150075446	150199274	LINC02355	123828	150072946	150077946
NR_110053	chr12	+	126580537	126588478	LINC02359	7941	126578037	126583037
NR_146995	chr4	-	11742574	11771092	LINC02360	28518	11768592	11773592
NR_146452	chr12	-	132671279	132674240	LINC02361	2961	132671740	132676740
NR_125934	chr4	-	185286713	185303460	LINC02362	16747	185300960	185305960
NR_040108	chr4	-	185262183	185275130	LINC02363	12947	185272630	185277630
NR_146499	chr4	+	28998405	29016215	LINC02364	17810	28995905	29000905
NR_131967	chr4	-	185505246	185546026	LINC02365	40780	185543526	185548526
NR_120463	chr12	+	10902832	10930050	LINC02366	27218	10900332	10905332
NR_120479	chr12	+	9520059	9550213	LINC02367	30154	9517559	9522559
NR_104648	chr12	+	128602761	128606497	LINC02368	3736	128600261	128605261
NR_104647	chr12	-	128571527	128602686	LINC02369	31159	128600186	128605186
NR_103736	chr12	+	131832014	131852100	LINC02370	20086	131829514	131834514
NR_033970	chr12	-	127354039	127359236	LINC02372	5197	127356736	127361736
NR_147159	chr4	+	188123139	188134029	LINC02374	10890	188120639	188125639
NR_110057	chr12	-	127808699	127824617	LINC02375	15918	127822117	127827117
NR_146537	chr12	-	127758816	127768828	LINC02376	10012	127766328	127771328
NR_146522	chr12	-	17734756	17742012	LINC02378	7256	17739512	17744512
NR_125907	chr4	+	58292037	58332152	LINC02380	40115	58289537	58294537
NR_026656	chr12	+	54519854	54526626	LINC02381	6772	54517354	54522354
NR_146993	chr4	-	43459550	43494560	LINC02383	35010	43492060	43497060
NR_120458	chr12	-	68825621	68845264	LINC02384	19643	68842764	68847764
NR_146469	chr12	-	31516414	31522235	LINC02387	5821	31519735	31524735
NR_120452	chr12	-	58959741	59175498	LINC02388	215757	59172998	59177998
NR_033988	chr12	+	65277553	65371302	LINC02389	93749	65275053	65280053
NR_135018	chr12	+	90687094	90694475	LINC02392	7381	90684594	90689594
NR_033987	chr12	+	128366161	128383184	LINC02393	17023	128363661	128368661
NR_110048	chr12	+	50305735	50320122	LINC02395	14387	50303235	50308235
NR_146570	chr12	-	50302664	50305646	LINC02396	2982	50303146	50308146
NR_144532	chr12	+	92860454	92877723	LINC02397	17269	92857954	92862954
NR_040098	chr12	+	20167618	20251802	LINC02398	84184	20165118	20170118
NR_110103	chr12	+	103941571	103953593	LINC02401	12022	103939071	103944071
NR_110042	chr12	-	43009304	43040300	LINC02402	30996	43037800	43042800
NR_135022	chr12	+	58481674	58487143	LINC02403	5469	58479174	58484174
NR_104646	chr12	-	127399773	127544942	LINC02405	145169	127542442	127547442
NR_146531	chr12	+	76653662	76699749	LINC02407	46087	76651162	76656162
NR_103861	chr12	+	67913861	67960911	LINC02408	47050	67911361	67916361
NR_135016	chr12	+	96196874	96217092	LINC02410	20218	96194374	96199374
NR_120451	chr12	-	128115813	128121012	LINC02411	5199	128118512	128123512
NR_120492	chr12	+	93568141	93575608	LINC02412	7467	93565641	93570641
NR_146865	chr12	+	3477273	3480767	LINC02417	3494	3474773	3479773
NR_024457	chr12	-	130518356	130526887	LINC02418	8531	130524387	130529387
NR_110063	chr12	-	68102826	68123255	LINC02421	20429	68120755	68125755
NR_135029	chr12	-	32029902	32040137	LINC02422	10235	32037637	32042637
NR_134999	chr12	-	119196558	119199484	LINC02423	2926	119196984	119201984
NR_135021	chr12	-	78720459	78753526	LINC02424	33067	78751026	78756026
NR_146530	chr12	-	66421504	66424846	LINC02425	3342	66422346	66427346
NR_110089	chr12	+	82347497	82386912	LINC02426	39415	82344997	82349997
NR_147158	chr4	-	185427613	185458737	LINC02427	31124	185456237	185461237
NR_125925	chr4	+	104346198	104360885	LINC02428	14687	104343698	104348698
NR_133941	chr4	+	59849999	59912677	LINC02429	62678	59847499	59852499
NR_038838	chr4	+	171961752	171980311	LINC02431	18559	171959252	171964252
NR_121625	chr4	-	142242277	142253771	LINC02432	11494	142251271	142256271
NR_026992	chr4	+	158493641	158497303	LINC02433	3662	158491141	158496141
NR_147059	chr4	+	185973049	186028402	LINC02436	55353	185970549	185975549
NR_134997	chr12	-	119256611	119271341	LINC02439	14730	119268841	119273841
NR_131985	chr12	-	128508332	128511711	LINC02441	3379	128509211	128514211
NR_120476	chr12	-	5343161	5352317	LINC02443	9156	5349817	5354817
NR_110130	chr12	+	73552969	73602097	LINC02444	49128	73550469	73555469
NR_146456	chr12	+	10705977	10728287	LINC02446	22310	10703477	10708477
NR_027441	chr4	-	7099150	7105103	LINC02447	5953	7102603	7107603
NR_120454	chr12	+	8388010	8395160	LINC02449	7150	8385510	8390510
NR_135028	chr12	+	43086017	43110921	LINC02450	24904	43083517	43088517
NR_135027	chr12	+	43040384	43080503	LINC02451	40119	43037884	43042884
NR_038383	chr12	-	98879321	98897633	LINC02453	18312	98895133	98900133
NR_146529	chr12	+	65996648	66006767	LINC02454	10119	65994148	65999148
NR_038385	chr12	-	89404902	89413469	LINC02458	8567	89410969	89415969
NR_146536	chr12	-	114676775	114679575	LINC02459	2800	114677075	114682075
NR_146866	chr12	+	43549117	43556913	LINC02461	7796	43546617	43551617
NR_147155	chr4	+	135345022	135466659	LINC02462	121637	135342522	135347522
NR_110753	chr4	-	130645325	130692633	LINC02466	47308	130690133	130695133
NR_146523	chr12	-	20273913	20280835	LINC02468	6922	20278335	20283335
NR_104634	chr12	-	10089177	10096094	LINC02470	6917	10093594	10098594
NR_146526	chr12	+	40550040	40561649	LINC02471	11609	40547540	40552540
NR_146996	chr4	+	29215913	29222783	LINC02472	6870	29213413	29218413
NR_131959	chr4	+	44018877	44024078	LINC02475	5201	44016377	44021377
NR_131960	chr7	-	119259483	119547429	LINC02476	287946	119544929	119549929
NR_103775	chr2	-	161114229	161128406	LINC02478	14177	161125906	161130906
NR_147186	chr4	+	131297515	131309226	LINC02479	11711	131295015	131300015
NR_134665	chr4	-	6672454	6675608	LINC02482	3154	6673108	6678108
NR_033964	chr4	+	76279285	76287776	LINC02483	8491	76276785	76281785
NR_147183	chr4	-	34123032	34271369	LINC02484	148337	34268869	34273869
NR_147187	chr4	-	136034239	136044714	LINC02485	10475	136042214	136047214
NR_033797	chr4	+	153457415	153460415	LINC02486	3000	153454915	153459915
NR_117092	chr6	-	168080305	168084467	LINC02487	4162	168081967	168086967
NR_147181	chr15	+	53408561	53421895	LINC02490	13334	53406061	53411061
NR_110436	chr4	-	188454032	188593795	LINC02492	139763	188591295	188596295
NR_125919	chr4	-	17173379	17187680	LINC02493	14301	17185180	17190180
NR_133943	chr4	-	59390679	59402493	LINC02494	11814	59399993	59404993
NR_037863	chr4	+	6202459	6235663	LINC02495	33204	6199959	6204959
NR_125935	chr4	+	31172765	31213296	LINC02497	40531	31170265	31175265
NR_046377	chr4	+	74374519	74394250	LINC02499	19731	74372019	74377019
NR_121639	chr4	+	120860694	120885448	LINC02502	24754	120858194	120863194
NR_125936	chr4	+	31999000	32157028	LINC02506	158028	31996500	32001500
NR_134640	chr4	+	138114909	138121102	LINC02510	6193	138112409	138117409
NR_110838	chr4	-	125421096	125479589	LINC02516	58493	125477089	125482089
NR_126057	chr6	+	37475123	37504056	LINC02520	28933	37472623	37477623
NR_038906	chr6	+	125995498	126041364	LINC02523	45866	125992998	125997998
NR_038296	chr6	-	3183051	3196001	LINC02525	12950	3193501	3198501
NR_125873	chr6	+	159804562	159817473	LINC02529	12911	159802062	159807062
NR_033557	chr6	-	107165326	107235416	LINC02532	70090	107232916	107237916
NR_134602	chr6	-	115954705	115964999	LINC02534	10294	115962499	115967499
NR_134633	chr6	-	86096936	86114520	LINC02535	17584	86112020	86117020
NR_117091	chr6	-	168067521	168079903	LINC02538	12382	168077403	168082403
NR_121618	chr6	-	138051306	138060174	LINC02539	8868	138057674	138062674
NR_125844	chr6	-	113944736	113971277	LINC02541	26541	113968777	113973777
NR_125863	chr6	-	169575398	169582835	LINC02544	7437	169580335	169585335
NR_135109	chr11	+	12052421	12083332	LINC02547	30911	12049921	12054921
NR_125854	chr6	-	68936861	69039791	LINC02549	102930	69037291	69042291
NR_125383	chr11	-	130714087	130732005	LINC02551	17918	130729505	130734505
NR_120585	chr11	-	104439216	104480030	LINC02552	40814	104477530	104482530
NR_134581	chr22	+	27706611	27713801	LINC02554	7190	27704111	27709111
NR_146569	chr16	+	24247424	24264181	LINC2194	16757	24244924	24249924
NR_131248	chr6	-	52011611	52015821	LINCMD1	4210	52013321	52018321
NR_120604	chr8	+	10332074	10339484	LINCR-0001	7410	10329574	10334574
NR_120606	chr3	+	191143312	191308145	LINCR-0002	164833	191140812	191145812
NR_120607	chr5	+	56866168	56913254	LINCR-0003	47086	56863668	56868668
NM_001301186	chr15	-	77905365	78113242	LINGO1	207877	78110742	78115742
NR_045123	chr15	+	77934105	77941581	LINGO1-AS1	7476	77931605	77936605
NR_120362	chr15	+	77952392	77960416	LINGO1-AS2	8024	77949892	77954892
NM_001258282	chr9	-	27948083	29212998	LINGO2	1264915	29210498	29215498
NM_001101391	chr19	-	2289773	2308156	LINGO3	18383	2305656	2310656
NM_001004432	chr1	-	151772739	151777918	LINGO4	5179	151775418	151780418
NM_001040616	chr15	-	101109427	101142445	LINS1	33018	101139945	101144945
NM_000235	chr10	-	90973325	91011796	LIPA	38471	91009296	91014296
NM_000236	chr15	+	58724174	58861073	LIPC	136899	58721674	58726674
NR_120338	chr15	-	58727099	58790934	LIPC-AS1	63835	58788434	58793434
NM_005357	chr19	-	42905658	42931578	LIPE	25920	42929078	42934078
NR_073180	chr19	+	42901299	43156507	LIPE-AS1	255208	42898799	42903799
NM_001198828	chr10	+	90424145	90438572	LIPF	14427	90421645	90426645
NM_001308006	chr18	+	47088400	47119279	LIPG	30879	47085900	47090900
NM_139248	chr3	-	185225569	185270369	LIPH	44800	185267869	185272869
NM_001303001	chr21	-	15481134	15583212	LIPI	102078	15580712	15585712
NM_001010939	chr10	+	90346518	90366733	LIPJ	20215	90344018	90349018
NM_001080518	chr10	+	90484300	90512513	LIPK	28213	90481800	90486800
NM_001128215	chr10	+	90562486	90580303	LIPM	17817	90559986	90564986
NM_001102469	chr10	+	90521162	90537999	LIPN	16837	90518662	90523662
NM_145197	chr2	+	99771417	99779613	LIPT1	8196	99768917	99773917
NM_001144869	chr11	-	74201555	74204758	LIPT2	3203	74202258	74207258
NR_024320	chr16	-	11641577	11681322	LITAF	39745	11678822	11683822
NR_146458	chr18	-	68002743	68005416	LIVAR	2673	68002916	68007916
NM_153234	chr5	-	96427573	96478520	LIX1	50947	96476020	96481020
NM_153713	chr1	+	145477066	145501669	LIX1L	24603	145474566	145479566
NR_147182	chr1	-	145493883	145508262	LIX1L-AS1	14379	145505762	145510762
NR_038954	chr22	+	37361288	37364213	LL22NC01-81G9.3	2925	37358788	37363788
NR_027426	chr22	+	22901749	22909004	LL22NC03-63E9.3	7255	22899249	22904249
NM_004140	chr17	+	18128935	18148188	LLGL1	19253	18126435	18131435
NM_004524	chr17	+	73521782	73571290	LLGL2	49508	73519282	73524282
NM_032338	chr12	-	66516848	66524533	LLPH	7685	66522033	66527033
NR_125724	chr12	+	66524530	66528229	LLPH-AS1	3699	66522030	66527030
NM_005570	chr18	-	56995055	57026508	LMAN1	31453	57024008	57029008
NM_021819	chr15	+	75105193	75118099	LMAN1L	12906	75102693	75107693
NM_006816	chr5	-	176758562	176778885	LMAN2	20323	176776385	176781385
NM_001322346	chr2	-	97371666	97405829	LMAN2L	34163	97403329	97408329
NR_146959	chr7	-	156461705	156685902	LMBR1	224197	156683402	156688402
NM_001300750	chr12	-	49490922	49504683	LMBR1L	13761	49502183	49507183
NM_018368	chr6	-	70385640	70507049	LMBRD1	121409	70504549	70509549
NM_001007527	chr5	-	36103413	36152015	LMBRD2	48602	36149515	36154515
NM_001278234	chr3	+	8543492	8609811	LMCD1	66319	8540992	8545992
NR_033378	chr3	-	8262833	8543344	LMCD1-AS1	280511	8540844	8545844
NM_001352017	chr16	-	903635	1031598	LMF1	127963	1029098	1034098
NR_110945	chr16	+	971032	984524	LMF1-AS1	13492	968532	973532
NM_033200	chr22	-	50941375	50946135	LMF2	4760	50943635	50948635
NR_026787	chr3	+	197687070	197770591	LMLN	83521	197684570	197689570
NM_001282625	chr1	+	156052336	156107657	LMNA	55321	156049836	156054836
NM_005573	chr5	+	126112314	126172712	LMNB1	60398	126109814	126114814
NM_032737	chr19	-	2428162	2456966	LMNB2	28804	2454466	2459466
NM_001145727	chr12	-	25649250	25801496	LMNTD1	152246	25798996	25803996
NM_173573	chr11	-	554849	560779	LMNTD2	5930	558279	563279
NM_001270428	chr11	-	8245850	8290182	LMO1	44332	8287682	8292682
NM_005574	chr11	-	33880122	33913836	LMO2	33714	33911336	33916336
NM_001243609	chr12	-	16701305	16761148	LMO3	59843	16758648	16763648
NM_006769	chr1	+	87794150	87814607	LMO4	20457	87791650	87796650
NM_005358	chr13	+	76194569	76434006	LMO7	239437	76192069	76197069
NR_120412	chr13	-	76178835	76210130	LMO7-AS1	31295	76207630	76212630
NM_001257995	chr13	+	76445173	76457948	LMO7DN	12775	76442673	76447673
NR_126373	chr13	+	76451021	76455261	LMO7DN-IT1	4240	76448521	76453521
NM_012134	chr1	-	201865583	201915716	LMOD1	50133	201913216	201918216
NM_207163	chr7	+	123295860	123304341	LMOD2	8481	123293360	123298360
NM_001304418	chr3	-	69157822	69171746	LMOD3	13924	69169246	69174246
NM_014916	chr7	+	97736196	97838944	LMTK2	102748	97733696	97738696
NM_001080434	chr19	-	48988527	49016446	LMTK3	27919	49013946	49018946
NM_177398	chr1	-	165171103	165325952	LMX1A	154849	165323452	165328452
NM_001174146	chr9	+	129376721	129463311	LMX1B	86590	129374221	129379221
NR_125920	chr4	-	93183648	93198453	LNCPRESS2	14805	93195953	93200953
NR_146297	chr3	-	145784130	145786972	LNCSRLR	2842	145784472	145789472
NM_001085451	chr3	+	100120036	100175170	LNP1	55134	100117536	100122536
NM_005575	chr5	+	96271345	96365115	LNPEP	93770	96268845	96273845
NR_130941	chr2	-	176788619	176867567	LNPK	78948	176865067	176870067
NM_001126328	chr4	-	54326436	54457753	LNX1	131317	54455253	54460253
NR_046622	chr4	+	54366243	54389443	LNX1-AS1	23200	54363743	54368743
NR_046827	chr4	+	54459122	54471548	LNX1-AS2	12426	54456622	54461622
NM_153371	chr13	-	28120049	28194720	LNX2	74671	28192220	28197220
NR_122124	chr12	+	740056	755044	LOC100049716	14988	737556	742556
NR_104007	chr7	+	72440212	72443674	LOC100101148	3462	72437712	72442712
NR_145523	chrX	-	115944898	115951828	LOC100126447	6930	115949328	115954328
NR_015384	chr11	-	19732479	19736218	LOC100126784	3739	19733718	19738718
NR_104607	chr17	-	12663450	12693601	LOC100128006	30151	12691101	12696101
NR_147699	chr20	-	44642140	44650712	LOC100128028	8572	44648212	44653212
NR_147701	chr5	-	169735704	169739720	LOC100128059	4016	169737220	169742220
NR_015444	chr9	+	94895115	94900911	LOC100128076	5796	94892615	94897615
NR_147898	chr16	-	27719741	27730350	LOC100128079	10609	27727850	27732850
NM_001321551	chr15	-	102277296	102287073	LOC100128108	9777	102284573	102289573
NR_027622	chr3	-	169661771	169684522	LOC100128164	22751	169682022	169687022
NR_027276	chr11	+	133902166	133911236	LOC100128239	9070	133899666	133904666
NR_126025	chr7	-	81205701	81320722	LOC100128317	115021	81318222	81323222
NR_133571	chr11	-	100554891	100558686	LOC100128386	3795	100556186	100561186
NR_036508	chr19	+	58514261	58518574	LOC100128398	4313	58511761	58516761
NR_104178	chr11	+	71725336	71731956	LOC100128494	6620	71722836	71727836
NR_038941	chr22	-	25498383	25508659	LOC100128531	10276	25506159	25511159
NR_046376	chr19	+	5978413	6020374	LOC100128568	41961	5975913	5980913
NR_033913	chr9	+	139640612	139644363	LOC100128593	3751	139638112	139643112
NR_146557	chrX	-	103136650	103174131	LOC100128594	37481	103171631	103176631
NR_047572	chr16	+	3082481	3089133	LOC100128770	6652	3079981	3084981
NR_077227	chr7	+	64035072	64078967	LOC100128885	43895	64032572	64037572
NR_146628	chr5	+	137667793	137672835	LOC100128966	5042	137665293	137670293
NR_147233	chr15	-	63338232	63341447	LOC100128979	3215	63338947	63343947
NR_145525	chr20	+	39609352	39654036	LOC100128988	44684	39606852	39611852
NR_038919	chr8	-	19041185	19103032	LOC100128993	61847	19100532	19105532
NR_038876	chr21	-	47247754	47256333	LOC100129027	8579	47253833	47258833
NR_027406	chr9	+	127115751	127121463	LOC100129034	5712	127113251	127118251
NR_034091	chr1	+	94057524	94065587	LOC100129046	8063	94055024	94060024
NR_024524	chr10	+	38464598	38503273	LOC100129055	38675	38462098	38467098
NR_033990	chr1	+	104615644	104619693	LOC100129138	4049	104613144	104618144
NR_033999	chr7	-	139102208	139112272	LOC100129148	10064	139109772	139114772
NR_046086	chr2	+	219866936	219880444	LOC100129175	13508	219864436	219869436
NR_110295	chr11	+	94963349	94967568	LOC100129203	4219	94960849	94965849
NR_136576	chrX	-	70882840	70886718	LOC100129291	3878	70884218	70889218
NR_033912	chr9	-	93825575	93837414	LOC100129316	11839	93834914	93839914
NR_125368	chr2	-	56400668	56412905	LOC100129434	12237	56410405	56415405
NR_126024	chr7	-	3180564	3198206	LOC100129603	17642	3195706	3200706
NR_033940	chr1	+	99469831	99614408	LOC100129620	144577	99467331	99472331
NR_125387	chr6_ssto_hap7	+	344677	385401	LOC100129636	40724	342177	347177
NM_001290330	chr16	+	89006444	89017932	LOC100129697	11488	89003944	89008944
NR_033828	chr4	-	7032280	7047958	LOC100129931	15678	7045458	7050458
NR_026870	chr19	+	40129324	40133041	LOC100129935	3717	40126824	40131824
NM_001292024	chr12	-	66245006	66275947	LOC100129940	30941	66273447	66278447
NR_147501	chr8	-	146034194	146052425	LOC100130027	18231	146049925	146054925
NR_135221	chr15	+	29967138	29971367	LOC100130111	4229	29964638	29969638
NR_037900	chr5	+	137368462	137374622	LOC100130172	6160	137365962	137370962
NR_024563	chr12	+	132851976	132857486	LOC100130238	5510	132849476	132854476
NR_024564	chr20	-	19222945	19265240	LOC100130264	42295	19262740	19267740
NR_147908	chr16	+	8943325	8954274	LOC100130283	10949	8940825	8945825
NR_027247	chr1	+	238025474	238091619	LOC100130331	66145	238022974	238027974
NM_001242698	chr6	-	13279526	13295818	LOC100130357	16292	13293318	13298318
NM_001272086	chr17	-	79349231	79359160	LOC100130370	9929	79356660	79361660
NR_147703	chr20	-	34735202	34743682	LOC100130373	8480	34741182	34746182
NR_026874	chr1	-	852197	855072	LOC100130417	2875	852572	857572
NR_144752	chr2	-	214140509	214148933	LOC100130451	8424	214146433	214151433
NR_034036	chr2	-	197565358	197577736	LOC100130452	12378	197575236	197580236
NR_049793	chr6	-	138144806	138189370	LOC100130476	44564	138186870	138191870
NM_001324076	chr17	-	72556839	72563482	LOC100130520	6643	72560982	72565982
NR_135126	chr9	+	136919411	136923927	LOC100130548	4516	136916911	136921911
NR_110634	chr20	+	61991339	62002529	LOC100130587	11190	61988839	61993839
NR_026966	chr2	-	178148235	178257419	LOC100130691	109184	178254919	178259919
NR_136612	chr10	+	82007513	82015164	LOC100130698	7651	82005013	82010013
NM_001195150	chr7	+	128506401	128512102	LOC100130705	5701	128503901	128508901
NR_046285	chr5	+	14712802	14716638	LOC100130744	3836	14710302	14715302
NR_038450	chr7	-	56943077	56949839	LOC100130849	6762	56947339	56952339
NR_024569	chr4	-	1189570	1202750	LOC100130872	13180	1200250	1205250
NM_001243523	chr7	+	137638093	137642712	LOC100130880	4619	137635593	137640593
NR_039988	chr22	+	40428335	40432581	LOC100130899	4246	40425835	40430835
NR_034082	chr17	+	5095378	5138931	LOC100130950	43553	5092878	5097878
NR_046245	chr8	+	39420630	39437653	LOC100130964	17023	39418130	39423130
NR_024469	chr11	+	67085309	67159158	LOC100130987	73849	67082809	67087809
NR_038921	chr10	+	22541000	22547477	LOC100130992	6477	22538500	22543500
NR_038401	chr6	-	38874270	38920883	LOC100131047	46613	38918383	38923383
NR_034022	chr7	-	7115400	7136417	LOC100131257	21017	7133917	7138917
NR_036551	chr17	+	37213271	37237704	LOC100131347	24433	37210771	37215771
NR_147697	chr2	+	162931366	162934442	LOC100131604	3076	162928866	162933866
NR_046369	chr11	-	118251934	118289530	LOC100131626	37596	118287030	118292030
NR_034062	chr3	+	187420153	187450203	LOC100131635	30050	187417653	187422653
NR_040024	chr18	-	74506687	74534251	LOC100131655	27564	74531751	74536751
NR_111930	chr1	+	143687126	143717173	LOC100132057	30047	143684626	143689626
NR_028325	chr1	+	323891	328581	LOC100132062	4690	321391	326391
NR_033937	chr9	+	97094757	97123230	LOC100132077	28473	97092257	97097257
NR_046085	chr11	-	111284966	111288911	LOC100132078	3945	111286411	111291411
NR_024237	chr1	+	151810944	151816641	LOC100132111	5697	151808444	151813444
NR_033389	chr2	-	63271099	63275656	LOC100132215	4557	63273156	63278156
NR_135128	chr9	-	66490071	66494170	LOC100132249	4099	66491670	66496670
NR_028322	chr1	+	323891	328581	LOC100132287	4690	321391	326391
NR_038399	chr6	+	140092209	140181608	LOC100132735	89399	140089709	140094709
NR_034004	chrX	+	70917045	70923256	LOC100132741	6211	70914545	70919545
NR_038890	chr9	+	99631181	99634510	LOC100132781	3329	99628681	99633681
NM_001317989	chr8	+	110656343	110660313	LOC100132813	3970	110653843	110658843
NR_027503	chr5	-	99715208	99723958	LOC100133050	8750	99721458	99726458
NR_121583	chr9	-	140762376	140787022	LOC100133077	24646	140784522	140789522
NR_029411	chr7	+	76178657	76257299	LOC100133091	78642	76176157	76181157
NR_040084	chr21	-	37441939	37498938	LOC100133286	56999	37496438	37501438
NR_029192	chr11	-	71576554	71639493	LOC100133315	62939	71636993	71641993
NR_028327	chr1	+	323891	328581	LOC100133331	4690	321391	326391
NR_026913	chr8	-	144063447	144099807	LOC100133669	36360	144097307	144102307
NR_024443	chr9	+	69651360	69664949	LOC100133920	13589	69648860	69653860
NR_024453	chr16	+	432240	442960	LOC100134368	10720	429740	434740
NM_001278587	chr17	+	71733992	71752696	LOC100134391	18704	71731492	71736492
NR_004846	chr20	+	25990434	26003903	LOC100134868	13469	25987934	25992934
NM_001256368	chr2	-	155292364	155313950	LOC100144595	21586	155311450	155316450
NR_125374	chr1	+	165738165	165744685	LOC100147773	6520	165735665	165740665
NR_024419	chr18	-	8360817	8367032	LOC100192426	6215	8364532	8369532
NR_037872	chrUn_gl000218	-	38785	97454	LOC100233156	58669	94954	99954
NR_026658	chr12	-	54472622	54475607	LOC100240735	2985	54473107	54478107
NR_026682	chr5	-	172381785	172386371	LOC100268168	4586	172383871	172388871
NR_027097	chr2	+	33152193	33171202	LOC100271832	19009	33149693	33154693
NR_147174	chr7	+	155174770	155194477	LOC100286906	19707	155172270	155177270
NR_147620	chr22	+	22292608	22297805	LOC100286925	5197	22290108	22295108
NR_037885	chr2	-	104995307	105024790	LOC100287010	29483	105022290	105027290
NR_040040	chr8	-	6261076	6264069	LOC100287015	2993	6261569	6266569
NM_001242885	chr16	+	89387540	89391756	LOC100287036	4216	89385040	89390040
NR_036520	chr17	+	73267379	73269976	LOC100287042	2597	73264879	73269879
NR_073509	chr17	+	20615758	20641178	LOC100287072	25420	20613258	20618258
NR_136593	chr1	+	224180431	224221561	LOC100287497	41130	224177931	224182931
NR_028348	chr7	+	62809447	62812152	LOC100287704	2705	62806947	62811947
NR_040021	chr20	+	36305311	36311636	LOC100287792	6325	36302811	36307811
NR_028349	chr7	+	62809447	62812152	LOC100287834	2705	62806947	62811947
NR_037168	chr8	+	48100929	48104885	LOC100287846	3956	48098429	48103429
NM_001319240	chr11	+	74204429	74209578	LOC100287896	5149	74201929	74206929
NR_040246	chr12	-	106890187	107168609	LOC100287944	278422	107166109	107171109
NR_033908	chr1	-	700244	714068	LOC100288069	13824	711568	716568
NR_038925	chr8	-	143783669	143808391	LOC100288181	24722	143805891	143810891
NR_146103	chr15	+	30763371	30782516	LOC100288203	19145	30760871	30765871
NR_144452	chr13	-	74987093	74993252	LOC100288208	6159	74990752	74995752
NR_130933	chr5	+	171712600	171725380	LOC100288254	12780	171710100	171715100
NR_037627	chr2	-	111160495	111181393	LOC100288570	20898	111178893	111183893
NR_038253	chr15	+	30938317	31065209	LOC100288637	126892	30935817	30940817
NR_147912	chr17	-	3038262	3080229	LOC100288728	41967	3077729	3082729
NR_130745	chr12	+	73724	91263	LOC100288778	17539	71224	76224
NR_125377	chr12	+	46777458	47046362	LOC100288798	268904	46774958	46779958
NR_027442	chr9	+	123555774	123561009	LOC100288842	5235	123553274	123558274
NR_103773	chr17	-	47583018	47651426	LOC100288866	68408	47648926	47653926
NM_001257362	chrUn_gl000213	-	108006	139339	LOC100288966	31333	136839	141839
NR_104179	chr19	+	12305829	12318391	LOC100289333	12562	12303329	12308329
NR_037142	chr20	-	1754010	1760392	LOC100289473	6382	1757892	1762892
NR_040022	chr6	+	166756118	166764957	LOC100289495	8839	166753618	166758618
NM_001242713	chr7	+	102004265	102021196	LOC100289561	16931	102001765	102006765
NR_103774	chr16	+	88797587	88807833	LOC100289580	10246	88795087	88800087
NR_037178	chr6_ssto_hap7	+	4292680	4302272	LOC100294145	9592	4290180	4295180
NR_029376	chr17	-	78325630	78388968	LOC100294362	63338	78386468	78391468
NR_033267	chr12	+	49782956	49786116	LOC100335030	3160	49780456	49785456
NR_033341	chr19	-	44609491	44617336	LOC100379224	7845	44614836	44619836
NR_134873	chr4	+	154561319	154602332	LOC100419170	41013	154558819	154563819
NR_125376	chr15	+	45021185	45025049	LOC100419583	3864	45018685	45023685
NR_110759	chr19	-	28926295	29218601	LOC100420587	292306	29216101	29221101
NR_130179	chrX	+	55306520	55315219	LOC100421746	8699	55304020	55309020
NR_109775	chr15	-	52211159	52216317	LOC100422556	5158	52213817	52218817
NR_147505	chr6	+	3231636	3240217	LOC100422781	8581	3229136	3234136
NR_036526	chr9	+	100000707	100059596	LOC100499484	58889	99998207	100003207
NR_036527	chr9	+	100000707	100139577	LOC100499484-C9ORF174	138870	99998207	100003207
NR_036533	chr10	-	22724353	22726858	LOC100499489	2505	22724358	22729358
NM_001242804	chr18	+	55297533	55336508	LOC100505549	38975	55295033	55300033
NR_135129	chr9	-	126768555	126771675	LOC100505588	3120	126769175	126774175
NR_038332	chr19	+	42636780	42641251	LOC100505622	4471	42634280	42639280
NR_125831	chr6	-	39856565	39865156	LOC100505635	8591	39862656	39867656
NR_038333	chr5	+	140937877	140944827	LOC100505658	6950	140935377	140940377
NR_038334	chr19	-	44395955	44405955	LOC100505715	10000	44403455	44408455
NR_038319	chr2	-	28530557	28533326	LOC100505716	2769	28530826	28535826
NR_120504	chr2	-	28371423	28429828	LOC100505736	58405	28427328	28432328
NR_145832	chr2	-	28931915	28959071	LOC100505774	27156	28956571	28961571
NR_040111	chr17	+	39558667	39568840	LOC100505782	10173	39556167	39561167
NR_038072	chr1	-	164738352	164743878	LOC100505795	5526	164741378	164746378
NR_134648	chr18	+	70535622	70548634	LOC100505797	13012	70533122	70538122
NR_038340	chr18	+	70992175	71017124	LOC100505817	24949	70989675	70994675
NM_001195535	chr5	+	121495870	121518358	LOC100505841	22488	121493370	121498370
NR_135482	chrUn_gl000224	+	102502	110268	LOC100505874	7766	100002	105002
NR_037877	chr4	-	22328989	22341289	LOC100505912	12300	22338789	22343789
NR_125434	chr16	+	15188267	15203054	LOC100505915	14787	15185767	15190767
NR_037851	chr1	-	168369426	168391894	LOC100505918	22468	168389394	168394394
NR_110018	chr7	-	7989469	8008383	LOC100505921	18914	8005883	8010883
NR_125740	chr7	+	8301854	8382911	LOC100505938	81057	8299354	8304354
NR_104656	chr16	-	67551608	67562648	LOC100505942	11040	67560148	67565148
NR_038912	chr12	-	107074535	107078478	LOC100505978	3943	107075978	107080978
NR_134944	chr13	-	112809470	112815024	LOC100506016	5554	112812524	112817524
NR_104622	chr1	-	9485152	9489055	LOC100506022	3903	9486555	9491555
NR_037845	chr1	-	173204198	173446294	LOC100506023	242096	173443794	173448794
NR_038356	chr14	-	31345384	31359014	LOC100506071	13630	31356514	31361514
NR_103732	chr2	+	97944453	97957632	LOC100506076	13179	97941953	97946953
NR_047550	chr11	+	4208381	4223883	LOC100506082	15502	4205881	4210881
NR_039997	chr16	-	70349542	70380650	LOC100506083	31108	70378150	70383150
NR_134568	chr7	+	20257199	20261322	LOC100506098	4123	20254699	20259699
NR_046240	chr9	+	131486740	131495522	LOC100506100	8782	131484240	131489240
NR_130704	chr2	+	97949671	97957533	LOC100506123	7862	97947171	97952171
NR_045375	chr2	-	166713985	166728451	LOC100506124	14466	166725951	166730951
NR_130990	chr11	+	76092346	76125665	LOC100506127	33319	76089846	76094846
NR_104182	chr2	-	46795395	46807377	LOC100506142	11982	46804877	46809877
NR_111906	chr20	+	49262007	49276828	LOC100506175	14821	49259507	49264507
NR_038393	chr7	+	22602955	22613617	LOC100506178	10662	22600455	22605455
NR_109774	chr6	-	57125321	57128144	LOC100506188	2823	57125644	57130644
NR_038980	chr6	+	8435855	8785678	LOC100506207	349823	8433355	8438355
NR_103855	chr11	-	7458867	7487066	LOC100506258	28199	7484566	7489566
NR_110515	chr22	-	37748230	37750879	LOC100506271	2649	37748379	37753379
NR_038432	chr2	+	7561391	7590381	LOC100506274	28990	7558891	7563891
NR_038920	chr12	+	13132770	13137576	LOC100506314	4806	13130270	13135270
NR_045122	chr14	+	65556635	65561029	LOC100506321	4394	65554135	65559135
NR_038905	chr11	+	86666662	86711989	LOC100506368	45327	86664162	86669162
NR_073512	chr21	-	36744804	36953062	LOC100506403	208258	36950562	36955562
NM_001004352	chr9	+	26066672	26118406	LOC100506422	51734	26064172	26069172
NR_125918	chr4	+	54562067	54600525	LOC100506444	38458	54559567	54564567
NR_040535	chr22	+	39828164	39833133	LOC100506472	4969	39825664	39830664
NR_038434	chr2	-	13106907	13147138	LOC100506474	40231	13144638	13149638
NR_109995	chr14	+	74254062	74270331	LOC100506476	16269	74251562	74256562
NR_038965	chr7	+	29019582	29052985	LOC100506497	33403	29017082	29022082
NR_148200	chr22	-	41605125	41613631	LOC100506544	8506	41611131	41616131
NR_037665	chr5	-	40825364	40829244	LOC100506548	3880	40826744	40831744
NR_103809	chr12	-	117415244	117425142	LOC100506551	9898	117422642	117427642
NR_038966	chr7	+	157647276	157658782	LOC100506585	11506	157644776	157649776
NR_103860	chr12	-	29433348	29470781	LOC100506606	37433	29468281	29473281
NR_102752	chr5	+	43067124	43093660	LOC100506639	26536	43064624	43069624
NR_120526	chr11	-	32057524	32062864	LOC100506675	5340	32060364	32065364
NR_125362	chr22	+	43434590	43448371	LOC100506679	13781	43432090	43437090
NR_110024	chr7	+	127116936	127125858	LOC100506682	8922	127114436	127119436
NR_104615	chr5	-	987291	997455	LOC100506688	10164	994955	999955
NR_135044	chr12	+	122501195	122506466	LOC100506691	5271	122498695	122503695
NR_108082	chr7	+	35756046	35759322	LOC100506725	3276	35753546	35758546
NR_036557	chr1	-	202955579	202976393	LOC100506747	20814	202973893	202978893
NR_144530	chr2	-	118940497	118943962	LOC100506797	3465	118941462	118946462
NR_038404	chr1	+	21619782	21626362	LOC100506801	6580	21617282	21622282
NR_040081	chr6	+	75994729	76001580	LOC100506804	6851	75992229	75997229
NR_038269	chr12	-	58325231	58329947	LOC100506844	4716	58327447	58332447
NR_104616	chr5	-	2303833	2312315	LOC100506858	8482	2309815	2314815
NR_126341	chr12	+	58985483	59206450	LOC100506869	220967	58982983	58987983
NR_134651	chr6	-	19729651	19804990	LOC100506885	75339	19802490	19807490
NR_109781	chr1	-	24865763	24882515	LOC100506985	16752	24880015	24885015
NR_040092	chr8	+	12294521	12424354	LOC100506990	129833	12292021	12297021
NR_110801	chr17	+	63096929	63107212	LOC100507002	10283	63094429	63099429
NR_120420	chr2	+	64455534	64479665	LOC100507006	24131	64453034	64458034
NR_037884	chr4	+	100010007	100222513	LOC100507053	212506	100007507	100012507
NR_120431	chr12	-	65860598	66036152	LOC100507065	175554	66033652	66038652
NR_134293	chr8	-	22112088	22132675	LOC100507071	20587	22130175	22135175
NR_120528	chr11	-	35154196	35159579	LOC100507144	5383	35157079	35162079
NR_038323	chr8	+	23193720	23223638	LOC100507156	29918	23191220	23196220
NR_038309	chr11	-	42209292	42275240	LOC100507205	65948	42272740	42277740
NR_038930	chr12	-	69068150	69080639	LOC100507250	12489	69078139	69083139
NR_103862	chr11	+	124670323	124704383	LOC100507283	34060	124667823	124672823
NR_121609	chr3	+	139108644	139302161	LOC100507291	193517	139106144	139111144
NR_037626	chr2	+	111003214	111024135	LOC100507334	20921	111000714	111005714
NR_038982	chr9	+	98225890	98232301	LOC100507346	6411	98223390	98228390
NR_040050	chr17	+	75543022	75561103	LOC100507351	18081	75540522	75545522
NR_045214	chr19	+	14247963	14282075	LOC100507373	34112	14245463	14250463
NR_038300	chr12	-	74526955	74686411	LOC100507377	159456	74683911	74688911
NR_038402	chr5	+	175546551	175552168	LOC100507387	5617	175544051	175549051
NR_121617	chr4	-	75881183	75895572	LOC100507388	14389	75893072	75898072
NR_038455	chr3	+	142645516	142661378	LOC100507389	15862	142643016	142648016
NR_038958	chrUn_gl000220	+	97128	126696	LOC100507412	29568	94628	99628
NR_038933	chr12	+	2945981	2968961	LOC100507424	22980	2943481	2948481
NR_038437	chr2	+	208983852	209021486	LOC100507443	37634	208981352	208986352
NR_134294	chr8	-	50409321	50424739	LOC100507464	15418	50422239	50427239
NR_121622	chr6	+	140297455	140414858	LOC100507477	117403	140294955	140299955
NR_125882	chr4	+	129349170	129440551	LOC100507487	91381	129346670	129351670
NR_103764	chr6	+	4136305	4157619	LOC100507506	21314	4133805	4138805
NR_037902	chr3	-	155008020	155011489	LOC100507537	3469	155008989	155013989
NR_147835	chr19	-	17599798	17622698	LOC100507551	22900	17620198	17625198
NR_038246	chr6	+	146056004	146207721	LOC100507557	151717	146053504	146058504
NR_038953	chr1	+	53704281	53708455	LOC100507564	4174	53701781	53706781
NR_045486	chr2	+	136577760	136580657	LOC100507600	2897	136575260	136580260
NR_108065	chr7	+	149717	155461	LOC100507642	5744	147217	152217
NR_110505	chr14	+	20006912	20010956	LOC100508046	4044	20004412	20009412
NR_134669	chr4	+	37003400	37022328	LOC100508631	18928	37000900	37005900
NR_038967	chr7	+	102004307	102067129	LOC100630923	62822	102001807	102006807
NR_040015	chr19	-	38314362	38345836	LOC100631378	31474	38343336	38348336
NR_045215	chr11	-	117066328	117072630	LOC100652768	6302	117070130	117075130
NR_104151	chrY	+	24462824	24466531	LOC100652931	3707	24460324	24465324
NR_046221	chr12	+	53907767	53911392	LOC100652999	3625	53905267	53910267
NR_110160	chr7	+	112258119	112260704	LOC100996249	2585	112255619	112260619
NR_103777	chr1	-	113554308	113615724	LOC100996251	61416	113613224	113618224
NR_121626	chr1	-	118139453	118148392	LOC100996263	8939	118145892	118150892
NR_103444	chr5	-	602283	612325	LOC100996325	10042	609825	614825
NR_136559	chr22	-	21655548	21680925	LOC100996335	25377	21678425	21683425
NR_110670	chr19	-	3141573	3155173	LOC100996351	13600	3152673	3157673
NR_103794	chr5	-	175476680	175489058	LOC100996385	12378	175486558	175491558
NR_136570	chr22	-	18660792	18688630	LOC100996415	27838	18686130	18691130
NR_110037	chr7	+	66119505	66134589	LOC100996437	15084	66117005	66122005
NR_104147	chr3	-	158263008	158288855	LOC100996447	25847	158286355	158291355
NR_073177	chr11	+	64216528	64219128	LOC100996455	2600	64214028	64219028
NR_121638	chr1	+	2497973	2515973	LOC100996583	18000	2495473	2500473
NR_110621	chr1	+	95975671	95981020	LOC100996635	5349	95973171	95978171
NR_110040	chr7	+	54827005	54872656	LOC100996654	45651	54824505	54829505
NR_135816	chr14	-	69092243	69095504	LOC100996664	3261	69093004	69098004
NR_110034	chr12	-	127137491	127174864	LOC100996671	37373	127172364	127177364
NR_144516	chr1	-	144832208	145039963	LOC100996724	207755	145037463	145042463
NM_001348152	chr1	+	149288353	149291743	LOC100996741	3390	149285853	149290853
NM_001323075	chrX	+	70887551	70891374	LOC101059915	3823	70885051	70890051
NR_110174	chr2	-	114588759	114648569	LOC101060091	59810	114646069	114651069
NR_120398	chr13	-	111800543	111805924	LOC101060553	5381	111803424	111808424
NR_103451	chr9	-	137711260	137764464	LOC101448202	53204	137761964	137766964
NR_103805	chr2	+	46656328	46668972	LOC101805491	12644	46653828	46658828
NR_109994	chr20	-	25165307	25177528	LOC101926889	12221	25175028	25180028
NR_110653	chr8	+	71383368	71397922	LOC101926892	14554	71380868	71385868
NR_125837	chr6	+	46459788	46501217	LOC101926898	41429	46457288	46462288
NR_105056	chr5	-	140425789	140457609	LOC101926905	31820	140455109	140460109
NR_110656	chr8	+	73644279	73664078	LOC101926908	19799	73641779	73646779
NR_110104	chr15	+	91565851	91574369	LOC101926911	8518	91563351	91568351
NR_110185	chr2	-	171556877	171627276	LOC101926913	70399	171624776	171629776
NR_125838	chr6	+	46244060	46333242	LOC101926915	89182	46241560	46246560
NR_110002	chr14	+	23398817	23423901	LOC101926933	25084	23396317	23401317
NR_134643	chr6	-	46638180	46655902	LOC101926934	17722	46653402	46658402
NR_110001	chr20	-	25825302	25834657	LOC101926935	9355	25832157	25837157
NR_110657	chr10	-	92162277	92300562	LOC101926942	138285	92298062	92303062
NR_110044	chr7	-	74103270	74143256	LOC101926943	39986	74140756	74145756
NR_110627	chr1	+	60238466	60254501	LOC101926944	16035	60235966	60240966
NR_104635	chr5	-	42155934	42175447	LOC101926960	19513	42172947	42177947
NR_110658	chr6	+	46871207	46877764	LOC101926962	6557	46868707	46873707
NR_110054	chr7	+	642481	648139	LOC101926963	5658	639981	644981
NR_110628	chr1	-	61125302	61291256	LOC101926964	165954	61288756	61293756
NR_132384	chr7	+	601594	605256	LOC101927000	3662	599094	604094
NR_110803	chr17	+	27253292	27271766	LOC101927018	18474	27250792	27255792
NR_125839	chr6	+	49779252	49788216	LOC101927020	8964	49776752	49781752
NR_110069	chr7	+	1200009	1205594	LOC101927021	5585	1197509	1202509
NR_110559	chr5	+	111563979	111593006	LOC101927023	29027	111561479	111566479
NR_110204	chr2	+	179278385	179304970	LOC101927027	26585	179275885	179280885
NR_110954	chr8	-	80681614	80783972	LOC101927040	102358	80781472	80786472
NR_110208	chr2	-	47419543	47572213	LOC101927043	152670	47569713	47574713
NR_110032	chr14	+	24912158	24971403	LOC101927045	59245	24909658	24914658
NR_110843	chr6	-	49783205	49792479	LOC101927048	9274	49789979	49794979
NR_136329	chr2	-	91887713	91900136	LOC101927050	12423	91897636	91902636
NR_109952	chr22	-	38037838	38054384	LOC101927051	16546	38051884	38056884
NR_110209	chr2	+	97584842	97591574	LOC101927053	6732	97582342	97587342
NR_120594	chr2	+	179641652	179644690	LOC101927055	3038	179639152	179644152
NR_125395	chr3	-	125546079	125604920	LOC101927056	58841	125602420	125607420
NR_125390	chr8	-	97964091	98458725	LOC101927066	494634	98456225	98461225
NR_110647	chr9	-	71568003	71590757	LOC101927069	22754	71588257	71593257
NR_126337	chr2	-	99377525	99388361	LOC101927070	10836	99385861	99390861
NR_130785	chr5	-	113783114	114109110	LOC101927078	325996	114106610	114111610
NR_110480	chr15	+	22278030	22383564	LOC101927079	105534	22275530	22280530
NR_109875	chr5	+	114937851	114956116	LOC101927100	18265	114935351	114940351
NR_110136	chr11	+	56615953	56645554	LOC101927120	29601	56613453	56618453
NR_110045	chr14	+	31889963	31922089	LOC101927124	32126	31887463	31892463
NR_110907	chr16	+	11559115	11567030	LOC101927131	7915	11556615	11561615
NR_110840	chr6	-	53426086	53438073	LOC101927136	11987	53435573	53440573
NR_123718	chr1	-	66508182	66516401	LOC101927139	8219	66513901	66518901
NR_134295	chr8	+	83824338	83874159	LOC101927141	49821	83821838	83826838
NR_110213	chr2	-	101589109	101593623	LOC101927142	4514	101591123	101596123
NR_110669	chr1	-	224396449	224400981	LOC101927143	4532	224398481	224403481
NR_146733	chr19	+	28284338	28515876	LOC101927151	231538	28281838	28286838
NR_125879	chr4	+	47916243	47992754	LOC101927157	76511	47913743	47918743
NR_110004	chr20	+	41314122	41317202	LOC101927159	3080	41311622	41316622
NR_110668	chr1	+	224407314	224415745	LOC101927164	8431	224404814	224409814
NR_110804	chr17	+	46522194	46543402	LOC101927166	21208	46519694	46524694
NR_110415	chr14	+	35550286	35582336	LOC101927178	32050	35547786	35552786
NR_125880	chr4	+	47833361	47898865	LOC101927179	65504	47830861	47835861
NR_108066	chr7	+	2477397	2487485	LOC101927181	10088	2474897	2479897
NR_126040	chr18	+	6954675	6957417	LOC101927188	2742	6952175	6957175
NR_125842	chr6	+	53794779	53862465	LOC101927189	67686	53792279	53797279
NR_104675	chr5	-	115703112	115710267	LOC101927190	7155	115707767	115712767
NR_110217	chr2	-	186584600	186605204	LOC101927196	20604	186602704	186607704
NR_110184	chr11	-	58901445	58910281	LOC101927204	8836	58907781	58912781
NR_110742	chr6	-	56979708	57037011	LOC101927211	57303	57034511	57039511
NR_110747	chr4	-	68283022	68287718	LOC101927237	4696	68285218	68290218
NR_110073	chr7	+	77044514	77054760	LOC101927243	10246	77042014	77047014
NR_120417	chr13	-	95356997	95360740	LOC101927248	3743	95358240	95363240
NR_109965	chr22	+	40917803	40922711	LOC101927257	4908	40915303	40920303
NR_120449	chr12	-	49686413	49718359	LOC101927267	31946	49715859	49720859
NR_110075	chr7	-	80000832	80003755	LOC101927269	2923	80001255	80006255
NR_110908	chr16	+	50702765	50705550	LOC101927272	2785	50700265	50705265
NR_134454	chr10	+	100206077	100213562	LOC101927278	7485	100203577	100208577
NR_110754	chr13	+	95413194	95587664	LOC101927284	174470	95410694	95415694
NR_121660	chr3	+	73570472	73618925	LOC101927296	48453	73567972	73572972
NR_110756	chr15	-	98096513	98103928	LOC101927310	7415	98101428	98106428
NR_110757	chr6	+	97753461	98156793	LOC101927314	403332	97750961	97755961
NR_110591	chr12	-	50345294	50356566	LOC101927318	11272	50354066	50359066
NR_125939	chr1	+	76477008	76485041	LOC101927342	8033	76474508	76479508
NR_108073	chr7	+	7294784	7317700	LOC101927354	22916	7292284	7297284
NR_110077	chr7	+	81638492	81659271	LOC101927356	20779	81635992	81640992
NR_134281	chr5	-	121917193	121920295	LOC101927357	3102	121917795	121922795
NR_121182	chr9	+	76986446	76998446	LOC101927358	12000	76983946	76988946
NR_125885	chr4	-	134015015	134070271	LOC101927359	55256	134067771	134072771
NR_125843	chr6	+	99872746	99879190	LOC101927365	6444	99870246	99875246
NR_110133	chr3	+	79460876	79484377	LOC101927374	23501	79458376	79463376
NR_110080	chr7	+	84161791	84213634	LOC101927378	51843	84159291	84164291
NR_110084	chr7	-	7589734	7605696	LOC101927391	15962	7603196	7608196
NR_110131	chr3	-	7994491	8057994	LOC101927394	63503	8055494	8060494
NR_110777	chr18	+	10661929	10666884	LOC101927410	4955	10659429	10664429
NR_110049	chr12	-	124065612	124068874	LOC101927415	3262	124066374	124071374
NR_110050	chr14	-	45368110	45381120	LOC101927418	13010	45378620	45383620
NR_120621	chr10	-	103012577	103023307	LOC101927419	10730	103020807	103025807
NR_109882	chr5	+	124372523	124703427	LOC101927421	330904	124370023	124375023
NR_136328	chr1	+	148876039	148902123	LOC101927429	26084	148873539	148878539
NR_125943	chr1	-	81979564	82023387	LOC101927434	43823	82020887	82025887
NR_120421	chr13	-	100393123	100609419	LOC101927437	216296	100606919	100611919
NR_110085	chr7	+	89964536	89973408	LOC101927446	8872	89962036	89967036
NR_134582	chr22	+	43671947	43679832	LOC101927447	7885	43669447	43674447
NR_109771	chr9	-	81750337	81760581	LOC101927450	10244	81758081	81763081
NR_120331	chr1	-	147680369	147719342	LOC101927468	38973	147716842	147721842
NR_120622	chr10	+	106083121	106086503	LOC101927472	3382	106080621	106085621
NR_110386	chrX	+	40122169	40146974	LOC101927476	24805	40119669	40124669
NR_110630	chr1	+	229644176	229649834	LOC101927478	5658	229641676	229646676
NR_110225	chr2	+	197124747	197128928	LOC101927482	4181	197122247	197127247
NR_105039	chr5	-	125608209	125620867	LOC101927488	12658	125618367	125623367
NR_110189	chr11	+	61355965	61375018	LOC101927495	19053	61353465	61358465
NR_110088	chr7	+	92465796	92546501	LOC101927497	80705	92463296	92468296
NR_109772	chr9	+	84304627	84391814	LOC101927502	87187	84302127	84307127
NM_001323425	chr11	+	1049777	1055764	LOC101927503	5987	1047277	1052277
NR_134297	chr8	-	120075181	120081021	LOC101927513	5840	120078521	120083521
NR_147610	chr4	+	141049168	141060011	LOC101927516	10843	141046668	141051668
NR_120624	chr10	-	106234697	106240033	LOC101927523	5336	106237533	106242533
NR_110807	chr17	-	55678225	55685773	LOC101927539	7548	55683273	55688273
NR_125419	chr8	+	121773492	121789072	LOC101927543	15580	121770992	121775992
NR_120625	chr10	-	107433367	107580091	LOC101927549	146724	107577591	107582591
NR_110102	chr7	+	98610787	98634102	LOC101927550	23315	98608287	98613287
NR_147506	chr22	-	45396445	45399500	LOC101927551	3055	45397e3	45402e3
NR_119374	chr1	-	84267198	84326229	LOC101927560	59031	84323729	84328729
NR_110782	chr18	-	20303453	20366800	LOC101927571	63347	20364300	20369300
NM_001347907	chr19	+	36505400	36542019	LOC101927572	36619	36502900	36507900
NR_110995	chr9	+	86678357	86709494	LOC101927575	31137	86675857	86680857
NR_120450	chr12	-	58012187	58015686	LOC101927583	3499	58013186	58018186
NR_125420	chr8	-	125204931	125259639	LOC101927588	54708	125257139	125262139
NR_110681	chr1	+	231010591	231014761	LOC101927604	4170	231008091	231013091
NR_110062	chr14	+	53620071	53624246	LOC101927620	4175	53617571	53622571
NR_110996	chr9	+	88742454	88771987	LOC101927623	29533	88739954	88744954
NR_110013	chr7	-	17503068	17598533	LOC101927630	95465	17596033	17601033
NR_125886	chr4	+	144833483	144903605	LOC101927636	70122	144830983	144835983
NR_121193	chr6	+	112557796	112627885	LOC101927640	70089	112555296	112560296
NR_125421	chr8	+	127337739	127341778	LOC101927657	4039	127335239	127340239
NR_110568	chr2	+	67440539	67471706	LOC101927661	31167	67438039	67443039
NR_110809	chr17	-	56154251	56160565	LOC101927666	6314	56158065	56163065
NR_110114	chr7	-	19958603	20180049	LOC101927668	221446	20177549	20182549
NR_135241	chr14	+	56981048	57018027	LOC101927690	36979	56978548	56983548
NR_110853	chr6	+	868497	876613	LOC101927691	8116	865997	870997
NR_120628	chr10	+	116524546	116539662	LOC101927692	15116	116522046	116527046
NR_126335	chr11	-	3529209	3593217	LOC101927708	64008	3590717	3595717
NR_110272	chr2	-	119357358	119360542	LOC101927709	3184	119358042	119363042
NR_110841	chr6	+	2884221	2900910	LOC101927730	16689	2881721	2886721
NR_110115	chr7	+	100951587	100954619	LOC101927746	3032	100949087	100954087
NR_135827	chr15	-	101432547	101459488	LOC101927751	26941	101456988	101461988
NR_134303	chr8	-	1710128	1712750	LOC101927752	2622	1710250	1715250
NR_110815	chr17	+	58042456	58074333	LOC101927755	31877	58039956	58044956
NR_132750	chr6	+	3025024	3027658	LOC101927759	2634	3022524	3027524
NR_120629	chr10	+	978965	988683	LOC101927762	9718	976465	981465
NR_110117	chr7	+	20336330	20351335	LOC101927769	15005	20333830	20338830
NR_110051	chr20	+	52169308	52191847	LOC101927770	22539	52166808	52171808
NR_110416	chr14	-	62022989	62037371	LOC101927780	14382	62034871	62039871
NR_125944	chr1	+	234782034	234796670	LOC101927787	14636	234779534	234784534
NR_135194	chr16	+	88949922	88953544	LOC101927793	3622	88947422	88952422
NR_110275	chr2	-	201645217	201676893	LOC101927795	31676	201674393	201679393
NR_134605	chr18	-	33759963	33767398	LOC101927809	7435	33764898	33769898
NR_110120	chr7	-	20367923	20371385	LOC101927811	3462	20368885	20373885
NR_110930	chr16	-	21601018	21610706	LOC101927814	9688	21608206	21613206
NR_125425	chr8	-	2387218	2585991	LOC101927815	198773	2583491	2588491
NR_110931	chr16	+	89497325	89520902	LOC101927817	23577	89494825	89499825
NR_125424	chr8	+	134898738	134914650	LOC101927822	15912	134896238	134901238
NR_121564	chr9	+	44384584	44391314	LOC101927827	6730	44382084	44387084
NR_110814	chr3	+	20383959	20392420	LOC101927829	8461	20381459	20386459
NR_109985	chrX	+	154696200	154723771	LOC101927830	27571	154693700	154698700
NM_001290053	chr1	+	87678351	87717014	LOC101927844	38663	87675851	87680851
NR_125427	chr8	+	135862177	135894142	LOC101927845	31965	135859677	135864677
NR_109791	chr9	+	92731697	92749768	LOC101927847	18071	92729197	92734197
NR_125945	chr1	-	235093089	235099746	LOC101927851	6657	235097246	235102246
NR_121667	chr3	+	24192814	24231447	LOC101927854	38633	24190314	24195314
NR_136397	chr17	-	59439028	59445065	LOC101927855	6037	59442565	59447565
NR_136572	chr22	+	20328519	20706784	LOC101927859	378265	20326019	20331019
NR_110283	chr2	-	208051413	208119040	LOC101927865	67627	208116540	208121540
NR_110141	chr7	+	103085653	103154454	LOC101927870	68801	103083153	103088153
NR_135634	chr17	+	60885862	60913732	LOC101927877	27870	60883362	60888362
NR_110278	chr2	+	129622173	129626301	LOC101927881	4128	129619673	129624673
NR_110281	chr2	+	75751193	75769832	LOC101927884	18639	75748693	75753693
NR_135114	chr1	+	19536879	19567198	LOC101927895	30319	19534379	19539379
NR_110284	chr2	+	77213090	77236914	LOC101927907	23824	77210590	77215590
NR_134280	chr5	-	166591938	166595406	LOC101927908	3468	166592906	166597906
NR_110818	chr17	-	2865540	2869189	LOC101927911	3649	2866689	2871689
NR_110157	chr7	+	157258924	157292410	LOC101927914	33486	157256424	157261424
NR_125428	chr8	-	138418343	138425831	LOC101927915	7488	138423331	138428331
NR_126334	chr20	-	57438810	57463865	LOC101927932	25055	57461365	57466365
NR_110287	chr2	+	78315855	78354932	LOC101927948	39077	78313355	78318355
NR_110842	chr6	-	5665219	5695505	LOC101927950	30286	5693005	5698005
NR_121565	chr9	-	95770396	95777226	LOC101927954	6830	95774726	95779726
NR_136588	chr2	+	209407366	209690311	LOC101927960	282945	209404866	209409866
NR_120632	chr10	+	4093917	4131205	LOC101927964	37288	4091417	4096417
NR_110288	chr2	-	77970821	78517857	LOC101927967	547036	78515357	78520357
NR_130737	chr5	+	168133931	168147889	LOC101927969	13958	168131431	168136431
NR_125848	chr6	-	5452700	5458308	LOC101927972	5608	5455808	5460808
NR_110289	chr2	-	79720841	79727970	LOC101927987	7129	79725470	79730470
NR_120539	chr11	+	9860688	9950808	LOC101928008	90120	9858188	9863188
NR_110685	chr1	+	153146993	153164152	LOC101928009	17159	153144493	153149493
NR_110158	chr7	+	112262435	112348122	LOC101928012	85687	112259935	112264935
NR_110291	chr2	+	210894645	210929080	LOC101928020	34435	210892145	210897145
NR_136398	chr17	+	65240891	65258196	LOC101928021	17305	65238391	65243391
NR_120481	chr12	-	9524377	9534018	LOC101928030	9641	9531518	9536518
NR_125947	chr1	+	153518217	153524245	LOC101928034	6028	153515717	153520717
NR_104657	chr16	-	74226290	74249420	LOC101928035	23130	74246920	74251920
NR_135833	chr15	-	32878305	32906947	LOC101928042	28642	32904447	32909447
NR_109903	chr20	-	59044666	59048034	LOC101928048	3368	59045534	59050534
NR_125888	chr4	+	162943884	162968702	LOC101928052	24818	162941384	162946384
NR_120540	chr11	+	10830843	10844478	LOC101928053	13635	10828343	10833343
NR_110727	chr19	-	44501047	44507022	LOC101928063	5975	44504522	44509522
NR_111907	chr1	-	245128505	245134171	LOC101928068	5666	245131671	245136671
NR_120586	chr11	-	66240960	66247720	LOC101928069	6760	66245220	66250220
NR_110071	chr14	-	71075514	71108015	LOC101928075	32501	71105515	71110515
NM_001287812	chr5	+	172182505	172189565	LOC101928093	7060	172180005	172185005
NR_132786	chr1	+	95527151	95533101	LOC101928098	5950	95524651	95529651
NR_120430	chr12	+	10516367	10551105	LOC101928100	34738	10513867	10518867
NR_147855	chr1	-	154374798	154379040	LOC101928101	4242	154376540	154381540
NR_110292	chr2	+	215674952	215828329	LOC101928103	153377	215672452	215677452
NR_121657	chr3	-	150452257	150456772	LOC101928105	4515	150454272	150459272
NR_109961	chr21	-	34484009	34496006	LOC101928107	11997	34493506	34498506
NR_125948	chr1	-	95628774	95699538	LOC101928118	70764	95697038	95702038
NR_147613	chr9	-	97689301	97707836	LOC101928119	18535	97705336	97710336
NR_110651	chrX	+	84465711	84474295	LOC101928128	8584	84463211	84468211
NR_121677	chr4	-	166651930	166664223	LOC101928131	12293	166661723	166666723
NR_135052	chr11	-	13942993	13946410	LOC101928132	3417	13943910	13948910
NR_120327	chr15	-	33595857	33602860	LOC101928134	7003	33600360	33605360
NR_110817	chr3	-	34917288	35435515	LOC101928135	518227	35433015	35438015
NR_125849	chr6	+	128349009	128407435	LOC101928140	58426	128346509	128351509
NR_135251	chr14	-	73927640	73930348	LOC101928143	2708	73927848	73932848
NR_120634	chr10	+	6660677	6681743	LOC101928150	21066	6658177	6663177
NR_134306	chr8	+	144790220	144796068	LOC101928160	5848	144787720	144792720
NR_110294	chr2	+	134023766	134042330	LOC101928161	18564	134021266	134026266
NR_110799	chr1	+	23848421	23854911	LOC101928163	6490	23845921	23850921
NR_136178	chr3	-	151877252	151923218	LOC101928166	45966	151920718	151925718
NR_120523	chr7	+	29164648	29167788	LOC101928168	3140	29162148	29167148
NR_120329	chr15	+	35047284	35105124	LOC101928174	57840	35044784	35049784
NR_135113	chr1	-	156584533	156591720	LOC101928177	7187	156589220	156594220
NR_135572	chr2	+	133673129	133689067	LOC101928185	15938	133670629	133675629
NR_125851	chr6	-	10932549	10954322	LOC101928191	21773	10951822	10956822
NR_135597	chr9	-	66969462	67030841	LOC101928195	61379	67028341	67033341
NR_110390	chrX	-	4545240	4551613	LOC101928201	6373	4549113	4554113
NR_110180	chr7	-	123977433	123992150	LOC101928211	14717	123989650	123994650
NR_110235	chr2	+	20189964	20204567	LOC101928222	14603	20187464	20192464
NR_125852	chr6	-	134750167	134800035	LOC101928231	49868	134797535	134802535
NR_135635	chr17	+	71509821	71514909	LOC101928251	5088	71507321	71512321
NR_125853	chr6	-	11990575	12001477	LOC101928253	10902	11998977	12003977
NR_110183	chr7	-	124869632	124904345	LOC101928254	34713	124901845	124906845
NR_110828	chr17	-	9074384	9082435	LOC101928266	8051	9079935	9084935
NR_110418	chr21	-	37326976	37376965	LOC101928269	49989	37374465	37379465
NR_120635	chr10	-	9239328	9337556	LOC101928272	98228	9335056	9340056
NR_120402	chr2	-	138636323	138685502	LOC101928273	49179	138683002	138688002
NR_125892	chr4	+	4763486	4789101	LOC101928279	25615	4760986	4765986
NR_110188	chr7	+	124824622	125019375	LOC101928283	194753	124822122	124827122
NR_110729	chr19	-	49871961	49891338	LOC101928295	19377	49888838	49893838
NR_120636	chr10	+	10100684	10105465	LOC101928298	4781	10098184	10103184
NR_110698	chr1	+	26551810	26556331	LOC101928303	4521	26549310	26554310
NR_125856	chr6	-	134846455	134861143	LOC101928304	14688	134858643	134863643
NR_125893	chr4	+	4922534	4990398	LOC101928306	67864	4920034	4925034
NR_125894	chr4	-	173555835	173648029	LOC101928314	92194	173645529	173650529
NR_120637	chr10	-	10461500	10504312	LOC101928322	42812	10501812	10506812
NR_125400	chr3	-	42653801	42695880	LOC101928323	42079	42693380	42698380
NR_125953	chr1	-	26789247	26794028	LOC101928324	4781	26791528	26796528
NR_110194	chr7	+	126855180	126869975	LOC101928333	14795	126852680	126857680
NR_110395	chrX	-	107137826	107179210	LOC101928335	41384	107176710	107181710
NR_110396	chrX	+	118425491	118469573	LOC101928336	44082	118422991	118427991
NR_110236	chr2	+	88838237	88875128	LOC101928371	36891	88835737	88840737
NR_110695	chr1	+	160902254	160919712	LOC101928372	17458	160899754	160904754
NR_121570	chr9	+	42771707	42782614	LOC101928381	10907	42769207	42774207
NR_110237	chr2	+	144694633	144721722	LOC101928386	27089	144692133	144697133
NR_135631	chrX	+	17546557	17605281	LOC101928389	58724	17544057	17549057
NR_108099	chr7	-	56601922	56605823	LOC101928401	3901	56603323	56608323
NR_135540	chr2	+	88927346	88931343	LOC101928403	3997	88924846	88929846
NR_110699	chr1	+	163131464	163182813	LOC101928404	51349	163128964	163133964
NR_120335	chr15	-	45543778	45571420	LOC101928414	27642	45568920	45573920
NR_110937	chr16	-	82986834	83023903	LOC101928417	37069	83021403	83026403
NR_104605	chr17	-	12575178	12609452	LOC101928418	34274	12606952	12611952
NR_135053	chr11	+	102323649	102332769	LOC101928424	9120	102321149	102326149
NR_136240	chr6	+	16761368	16767114	LOC101928433	5746	16758868	16763868
NM_001286997	chr1	-	103959702	104068133	LOC101928436	108431	104065633	104070633
NR_110399	chrX	+	112285954	112763885	LOC101928437	477931	112283454	112288454
NR_109802	chr9	-	102348067	102582171	LOC101928438	234104	102579671	102584671
NR_120471	chr12	+	23328569	23344521	LOC101928441	15952	23326069	23331069
NR_120529	chr11	-	69902335	69911477	LOC101928443	9142	69908977	69913977
NR_110560	chr5	-	179022904	179030742	LOC101928445	7838	179028242	179033242
NR_110938	chr16	+	82806923	82863243	LOC101928446	56320	82804423	82809423
NR_120638	chr10	+	14116282	14129878	LOC101928453	13596	14113782	14118782
NR_125858	chr6	+	136950251	136969336	LOC101928461	19085	136947751	136952751
NR_134929	chr19	+	12098431	12157090	LOC101928464	58659	12095931	12100931
NR_135638	chr17	+	14918121	14955592	LOC101928475	37471	14915621	14920621
NR_110855	chr6	-	17501595	17511496	LOC101928491	9901	17508996	17513996
NR_110409	chrX	+	125243744	125249545	LOC101928495	5801	125241244	125246244
NR_104668	chr5	+	56946486	56966816	LOC101928505	20330	56943986	56948986
NR_135064	chr11	-	36084833	36099451	LOC101928510	14618	36096951	36101951
NR_110856	chr6	+	74779166	75400443	LOC101928516	621277	74776666	74781666
NR_110732	chr19	-	51656179	51685222	LOC101928517	29043	51682722	51687722
NR_110860	chr6	-	19068773	19180711	LOC101928519	111938	19178211	19183211
NR_121579	chr9	-	138395118	138398293	LOC101928525	3175	138395793	138400793
NR_120551	chr11	+	106122133	106135632	LOC101928535	13499	106119633	106124633
NR_125859	chr6	+	76092901	76168615	LOC101928540	75714	76090401	76095401
NR_125900	chr4	+	175752878	175797115	LOC101928551	44237	175750378	175755378
NR_125956	chr1	-	168433351	168464882	LOC101928565	31531	168462382	168467382
NR_135556	chr3	+	170185072	170472994	LOC101928583	287922	170182572	170187572
NR_125901	chr4	+	176711457	176733340	LOC101928590	21883	176708957	176713957
NR_135065	chr11	-	42023271	42107008	LOC101928591	83737	42104508	42109508
NR_135192	chr16	+	30107750	30116777	LOC101928595	9027	30105250	30110250
NR_110091	chr12	-	133609244	133613808	LOC101928597	4564	133611308	133616308
NR_126022	chr7	+	143892413	143996682	LOC101928605	104269	143889913	143894913
NR_135036	chr12	+	92539860	92579560	LOC101928617	39700	92537360	92542360
NR_108089	chr7	+	36134919	36140262	LOC101928618	5343	36132419	36137419
NR_125902	chr4	-	33897960	34041515	LOC101928622	143555	34039015	34044015
NR_110412	chrX	-	36383740	36458375	LOC101928627	74635	36455875	36460875
NR_125958	chr1	-	170430457	170501750	LOC101928650	71293	170499250	170504250
NR_109910	chr5	-	60958984	60994259	LOC101928651	35275	60991759	60996759
NR_125860	chr6	-	146915651	146920067	LOC101928661	4416	146917567	146922567
NR_110863	chr6	-	25245145	25261635	LOC101928663	16490	25259135	25264135
NR_125960	chr1	-	173386927	173430501	LOC101928673	43574	173428001	173433001
NR_110847	chr17	+	76356528	76369990	LOC101928674	13462	76354028	76359028
NR_104667	chr16	-	87305511	87326058	LOC101928682	20547	87323558	87328558
NR_121196	chr1	-	174904083	174923398	LOC101928696	19315	174920898	174925898
NR_126054	chr13	+	19756172	19761605	LOC101928697	5433	19753672	19758672
NR_110829	chr7	-	146778029	146794701	LOC101928700	16672	146792201	146797201
NR_110939	chr16	+	87245720	87260035	LOC101928708	14315	87243220	87248220
NR_125963	chr1	-	112287938	112298131	LOC101928718	10193	112295631	112300631
NR_135474	chr15	-	59060270	59063173	LOC101928725	2903	59060673	59065673
NR_120422	chr13	-	112911039	112927314	LOC101928730	16275	112924814	112929814
NR_110092	chr12	-	94101566	94131599	LOC101928731	30033	94129099	94134099
NR_110943	chr16	+	87527792	87549236	LOC101928737	21444	87525292	87530292
NR_125401	chr3	-	178819158	178865761	LOC101928739	46603	178863261	178868261
NR_110950	chr9	-	117881818	117900688	LOC101928748	18870	117898188	117903188
NR_109805	chr9	-	118501948	118506518	LOC101928775	4570	118504018	118509018
NR_110836	chr7	+	131594978	131633712	LOC101928782	38734	131592478	131597478
NR_121582	chr9	-	140934954	140939523	LOC101928786	4569	140937023	140942023
NR_110121	chr14	-	88484948	88492656	LOC101928791	7708	88490156	88495156
NR_109806	chr9	+	120410883	120419304	LOC101928797	8421	120408383	120413383
NR_134565	chr7	+	131945619	131949048	LOC101928807	3429	131943119	131948119
NR_125906	chr4	+	76901942	76927094	LOC101928809	25152	76899442	76904442
NR_120559	chr11	+	112352954	112412639	LOC101928823	59685	112350454	112355454
NR_120646	chr10	-	19999263	20017479	LOC101928834	18216	20014979	20019979
NM_001304433	chr13	-	114053924	114068708	LOC101928841	14784	114066208	114071208
NR_110740	chr19	+	5847477	5858250	LOC101928844	10773	5844977	5849977
NR_120563	chr11	-	112830002	112834182	LOC101928847	4180	112831682	112836682
NR_110852	chr17	-	78775439	78779432	LOC101928855	3993	78776932	78781932
NR_130779	chr5	+	67089040	67096886	LOC101928858	7846	67086540	67091540
NR_120513	chr7	-	133485245	133509641	LOC101928861	24396	133507141	133512141
NR_120564	chr11	-	78135028	78140882	LOC101928865	5854	78138382	78143382
NR_136325	chr2	+	233877323	233880595	LOC101928881	3272	233874823	233879823
NR_109986	chr3	-	180425377	180587966	LOC101928882	162589	180585466	180590466
NR_134456	chr10	-	66660893	66684276	LOC101928887	23383	66681776	66686776
NR_120565	chr11	+	46193505	46198656	LOC101928894	5151	46191005	46196005
NR_120566	chr11	+	78244221	78269611	LOC101928896	25390	78241721	78246721
NR_134307	chr8	-	145592595	145596648	LOC101928902	4053	145594148	145599148
NR_110134	chr14	+	91108972	91115232	LOC101928909	6260	91106472	91111472
NR_110869	chr6	+	88494577	88621449	LOC101928911	126872	88492077	88497077
NR_134279	chr5	-	68773299	68781439	LOC101928924	8140	68778939	68783939
NR_135133	chr9	-	141090384	141093903	LOC101928932	3519	141091403	141096403
NR_110867	chr6	-	89235642	89249088	LOC101928936	13446	89246588	89251588
NR_110095	chr12	+	99487136	99498789	LOC101928937	11653	99484636	99489636
NR_120567	chr11	-	114231356	114250761	LOC101928940	19405	114248261	114253261
NR_125908	chr4	+	82086093	82114549	LOC101928942	28456	82083593	82088593
NR_120570	chr11	-	80462243	80473846	LOC101928944	11603	80471346	80476346
NR_111911	chr10	-	68653867	68771911	LOC101928961	118044	68769411	68774411
NR_125970	chr1	-	116465193	116519897	LOC101928977	54704	116517397	116522397
NR_125909	chr4	-	84889234	85220322	LOC101928978	331088	85217822	85222822
NR_135066	chr11	-	115602662	115605480	LOC101928985	2818	115602980	115607980
NR_120344	chr15	+	64220472	64228152	LOC101928988	7680	64217972	64222972
NR_120648	chr10	-	70975088	70992246	LOC101928994	17158	70989746	70994746
NR_134630	chr6_apd_hap1	+	395478	561686	LOC101929006	166208	392978	397978
NR_135069	chr11	+	116510138	116528969	LOC101929011	18831	116507638	116512638
NR_111915	chr6	+	90348250	90399200	LOC101929057	50950	90345750	90350750
NR_126333	chr12	+	103545619	103562086	LOC101929058	16467	103543119	103548119
NR_110879	chr4	+	87040958	87141079	LOC101929064	100121	87038458	87043458
NR_125429	chr8	+	17942376	17955160	LOC101929066	12784	17939876	17944876
NR_148222	chr6_cox_hap2	-	2874750	2880943	LOC101929072	6193	2878443	2883443
NR_120650	chr10	-	26213306	26222639	LOC101929073	9333	26220139	26225139
NR_120345	chr15	-	68126645	68131217	LOC101929076	4572	68128717	68133717
NR_120574	chr11	-	118382632	118401490	LOC101929089	18858	118398990	118403990
NR_125911	chr4	-	15006565	15429538	LOC101929095	422973	15427038	15432038
NR_110786	chr1	-	117568103	117602112	LOC101929099	34009	117599612	117604612
NR_110052	chr3	-	186914877	186925417	LOC101929106	10540	186922917	186927917
NR_121584	chr9	-	129032402	129038194	LOC101929116	5792	129035694	129040694
NR_121668	chr6	-	159586930	159591039	LOC101929122	4109	159588539	159593539
NR_110427	chr19	-	22703796	22710751	LOC101929124	6955	22708251	22713251
NR_125431	chr8	+	9046508	9060366	LOC101929128	13858	9044008	9049008
NR_135551	chr3	+	187009059	187015721	LOC101929130	6662	187006559	187011559
NR_120423	chr13	+	41707063	41810822	LOC101929140	103759	41704563	41709563
NR_125975	chr1	+	119683018	119818596	LOC101929147	135578	119680518	119685518
NR_110413	chrY	-	24247838	24293631	LOC101929148	45793	24291131	24296131
NR_105012	chr5	+	77180479	77254920	LOC101929154	74441	77177979	77182979
NR_135550	chr3	+	57678931	57682378	LOC101929159	3447	57676431	57681431
NR_134641	chr4	-	25532661	25570968	LOC101929161	38307	25568468	25573468
NR_120474	chr12	+	108130331	108153745	LOC101929162	23414	108127831	108132831
NR_136245	chr6_mann_hap4	+	3565773	3718366	LOC101929163	152593	3563273	3568273
NR_134476	chr10	+	76672543	76696160	LOC101929165	23617	76670043	76675043
NR_104677	chr8	+	21155749	21166960	LOC101929172	11211	21153249	21158249
NR_134628	chr6	-	33599020	33601522	LOC101929188	2502	33599022	33604022
NR_133004	chr11	-	120811263	120828748	LOC101929208	17485	120826248	120831248
NR_125922	chr4	-	95038970	95128707	LOC101929210	89737	95126207	95131207
NR_105004	chr8	+	49532962	49536455	LOC101929217	3493	49530462	49535462
NR_110787	chr1	+	200638634	200663378	LOC101929224	24744	200636134	200641134
NR_132790	chr11	-	120738641	120765506	LOC101929227	26865	120763006	120768006
NR_125432	chr8	+	10697535	10704019	LOC101929229	6484	10695035	10700035
NR_110240	chr2	+	150443871	150704748	LOC101929231	260877	150441371	150446371
NR_125433	chr8	+	22735484	22745535	LOC101929237	10051	22732984	22737984
NR_120424	chr13	+	45680413	45687341	LOC101929259	6928	45677913	45682913
NR_105002	chr8	+	49464126	49611069	LOC101929268	146943	49461626	49466626
NR_134308	chr8	-	10920161	10924599	LOC101929269	4438	10922099	10927099
NR_120653	chr10	+	30500780	30521619	LOC101929279	20839	30498280	30503280
NR_110244	chr2	+	151485410	151491871	LOC101929282	6461	151482910	151487910
NR_125808	chr8	-	24153326	24406131	LOC101929294	252805	24403631	24408631
NR_110303	chr11	+	94883702	94892312	LOC101929295	8610	94881202	94886202
NR_125862	chr6	+	166650456	166670432	LOC101929297	19976	166647956	166652956
NR_125809	chr8	-	24347824	24372381	LOC101929315	24557	24369881	24374881
NR_110248	chr2	-	152194341	152235885	LOC101929319	41544	152233385	152238385
NR_121587	chr9	+	132044694	132047998	LOC101929331	3304	132042194	132047194
NR_120577	chr11	+	124629029	124635816	LOC101929340	6787	124626529	124631529
NR_134310	chr8	+	53106921	53112112	LOC101929341	5191	53104421	53109421
NR_134478	chr10	+	31476811	31550481	LOC101929352	73670	31474311	31479311
NR_125924	chr4	+	101111189	101136662	LOC101929353	25473	101108689	101113689
NR_109861	chr20	+	9966980	9987764	LOC101929371	20784	9964480	9969480
NM_001288707	chr22	-	18062922	18071958	LOC101929372	9036	18069458	18074458
NR_105018	chr5	+	86415964	86543835	LOC101929380	127871	86413464	86418464
NR_109866	chr20	-	10855980	10889920	LOC101929413	33940	10887420	10892420
NR_125813	chr8	+	57358365	57464626	LOC101929415	106261	57355865	57360865
NR_110870	chr6	+	168643617	168663258	LOC101929420	19641	168641117	168646117
NR_120532	chr11	+	126522672	126551998	LOC101929427	29326	126520172	126525172
NR_120660	chr10	-	32723296	32734984	LOC101929431	11688	32732484	32737484
NR_120360	chr15	-	76467231	76473827	LOC101929439	6596	76471327	76476327
NR_134479	chr10	+	43366968	43369508	LOC101929445	2540	43364468	43369468
NR_110252	chr2	-	7202857	7218011	LOC101929452	15154	7215511	7220511
NR_135692	chr15	+	77817936	77826452	LOC101929457	8516	77815436	77820436
NR_125978	chr1	+	33815952	33828846	LOC101929464	12894	33813452	33818452
NR_125817	chr8	-	29672519	29686020	LOC101929470	13501	29683520	29688520
NR_120578	chr11	+	126936896	126971201	LOC101929473	34305	126934396	126939396
NR_125818	chr8	+	58256345	58277415	LOC101929488	21070	58253845	58258845
NR_120580	chr11	+	127140964	127206928	LOC101929497	65964	127138464	127143464
NR_110593	chr2	-	162079768	162111154	LOC101929512	31386	162108654	162113654
NR_125979	chr1	+	40030741	40038875	LOC101929516	8134	40028241	40033241
NR_120581	chr11	+	128396036	128400278	LOC101929517	4242	128393536	128398536
NR_134621	chr6	+	169613306	169639657	LOC101929523	26351	169610806	169615806
NR_109946	chr5	+	16616034	16630078	LOC101929524	14044	16613534	16618534
NR_109955	chr20	-	18655038	18679352	LOC101929526	24314	18676852	18681852
NR_105005	chr8	-	59168329	59184660	LOC101929528	16331	59182160	59187160
NR_125927	chr4	-	106736301	106748329	LOC101929529	12028	106745829	106750829
NR_110255	chr2	+	162970950	163029243	LOC101929532	58293	162968450	162973450
NR_135072	chr11	-	128551134	128556817	LOC101929538	5683	128554317	128559317
NR_125984	chr1	-	212398619	212458363	LOC101929541	59744	212455863	212460863
NR_110112	chr12	-	4809582	4829268	LOC101929549	19686	4826768	4831768
NR_125819	chr8	-	35529680	35567838	LOC101929550	38158	35565338	35570338
NR_110256	chr2	-	8026897	8039786	LOC101929551	12889	8037286	8042286
NR_110873	chr6	-	40846624	40991019	LOC101929555	144395	40988519	40993519
NR_121602	chr9	-	23500688	23672397	LOC101929563	171709	23669897	23674897
NR_110258	chr2	+	163625445	163654482	LOC101929570	29037	163622945	163627945
NR_110504	chr14	-	19563121	19566680	LOC101929572	3559	19564180	19569180
NR_120661	chr10	-	82289352	82295698	LOC101929574	6346	82293198	82298198
NR_125928	chr4	-	106924473	106943635	LOC101929577	19162	106941135	106946135
NR_136299	chr9	-	66969462	67030191	LOC101929583	60729	67027691	67032691
NR_120363	chr15	-	80846950	80855285	LOC101929586	8335	80852785	80857785
NR_125986	chr1	-	44175075	44193014	LOC101929592	17939	44190514	44195514
NR_125929	chr4	-	108784634	108853275	LOC101929595	68641	108850775	108855775
NR_110259	chr2	-	38685779	38742882	LOC101929596	57103	38740382	38745382
NR_134679	chr4	+	109478388	109481548	LOC101929621	3160	109475888	109480888
NR_125820	chr8	+	37575096	37591011	LOC101929622	15915	37572596	37577596
NR_125987	chr1	+	46599042	46604752	LOC101929626	5710	46596542	46601542
NR_110574	chr2	+	165697258	165705906	LOC101929633	8648	165694758	165699758
NR_109948	chr5	+	29065350	29073330	LOC101929645	7980	29062850	29067850
NR_110140	chr11	-	131403750	131410761	LOC101929653	7011	131408261	131413261
NR_110306	chr13	+	52703030	52706859	LOC101929657	3829	52700530	52705530
NR_120670	chr10	+	87192618	87208713	LOC101929662	16095	87190118	87195118
NR_120366	chr15	-	86298171	86301956	LOC101929679	3785	86299456	86304456
NR_110260	chr2	+	166938040	167158293	LOC101929680	220253	166935540	166940540
NR_110619	chr20	+	31097761	31108088	LOC101929698	10327	31095261	31100261
NR_125864	chr6	-	43963460	44042389	LOC101929705	78929	44039889	44044889
NR_125822	chr8	-	90729626	90769939	LOC101929709	40313	90767439	90772439
NR_130776	chr5	+	95297704	95966789	LOC101929710	669085	95295204	95300204
NR_110597	chr2	+	10589853	10595678	LOC101929715	5825	10587353	10592353
NR_110139	chr14	-	21463995	21467322	LOC101929718	3327	21464822	21469822
NR_130738	chr5	+	139536903	139548370	LOC101929719	11467	139534403	139539403
NR_125988	chr1	+	49723082	49734966	LOC101929721	11884	49720582	49725582
NR_125930	chr4	-	119585242	119606496	LOC101929741	21254	119603996	119608996
NR_136301	chr9	-	95567666	95570369	LOC101929748	2703	95567869	95572869
NR_110576	chr2	-	171197026	171207453	LOC101929753	10427	171204953	171209953
NR_125931	chr4	-	120113927	120133799	LOC101929762	19872	120131299	120136299
NR_110868	chr17	-	41300383	41322420	LOC101929767	22037	41319920	41324920
NR_135813	chr1	-	149649059	149719362	LOC101929798	70303	149716862	149721862
NR_111920	chr22	-	42522500	42526883	LOC101929829	4383	42524383	42529383
NR_125823	chr8	-	42112840	42128479	LOC101929897	15639	42125979	42130979
NR_135111	chr1	-	57093463	57110991	LOC101929935	17528	57108491	57113491
NR_136254	chr7	-	153752669	153757655	LOC101929998	4986	153755155	153760155
NR_125866	chr6	+	56708783	56729136	LOC101930010	20353	56706283	56711283
NR_126041	chr19	+	42901279	42912604	LOC101930071	11325	42898779	42903779
NR_136255	chr7	+	35734815	35739022	LOC101930085	4207	35732315	35737315
NR_146581	chrX	-	3769032	3800392	LOC101930105	31360	3797892	3802892
NR_134510	chr1	-	209834703	209915907	LOC101930114	81204	209913407	209918407
NR_134242	chr4	-	174053083	174090803	LOC101930370	37720	174088303	174093303
NR_147612	chr10	+	674503	677195	LOC101930421	2692	672003	677003
NR_104163	chr10	+	32636291	32663416	LOC102031319	27125	32633791	32638791
NR_104658	chr5	-	53955986	54040086	LOC102467080	84100	54037586	54042586
NR_104662	chr5	-	54317126	54319997	LOC102467081	2871	54317497	54322497
NR_104673	chr5	-	111992124	112018585	LOC102467216	26461	112016085	112021085
NR_104674	chr5	-	114977821	115008349	LOC102467217	30528	115005849	115010849
NR_130773	chr8	+	20811143	20826449	LOC102467222	15306	20808643	20813643
NR_104999	chr5	+	120658244	120661532	LOC102467226	3288	120655744	120660744
NR_105008	chr5	+	71852903	71867569	LOC102503427	14666	71850403	71855403
NR_105044	chr5	-	133764741	133770738	LOC102546229	5997	133768238	133773238
NR_105057	chr5	-	147647869	147763413	LOC102546294	115544	147760913	147765913
NR_105065	chr5	+	163897284	163969989	LOC102546299	72705	163894784	163899784
NR_109849	chr1	+	101491401	101552935	LOC102606465	61534	101488901	101493901
NR_146188	chr8	+	10586800	10630420	LOC102723313	43620	10584300	10589300
NR_134311	chr8	-	86084311	86089276	LOC102723322	4965	86086776	86091776
NR_120375	chr15	+	63682428	63729735	LOC102723344	47307	63679928	63684928
NR_135320	chr13	+	30221829	30229612	LOC102723345	7783	30219329	30224329
NM_001322975	chr7_gl000195_random	-	42937	66040	LOC102723360	23103	63540	68540
NR_119378	chr16	+	53407404	53418171	LOC102723373	10767	53404904	53409904
NR_110795	chr18	+	12074	15930	LOC102723376	3856	9574	14574
NR_119379	chr16	-	19074075	19079013	LOC102723385	4938	19076513	19081513
NR_120514	chr7	+	67485239	67497677	LOC102723427	12438	67482739	67487739
NR_120673	chr10	-	76266255	76289082	LOC102723439	22827	76286582	76291582
NR_135671	chr17	-	35218934	35293960	LOC102723471	75026	35291460	35296460
NR_135686	chr15	-	67276544	67356520	LOC102723493	79976	67354020	67359020
NR_110877	chr17	-	70030247	70053875	LOC102723517	23628	70051375	70056375
NR_120482	chr12	-	362607	366465	LOC102723544	3858	363965	368965
NR_134485	chr5	-	126087654	126112178	LOC102723557	24524	126109678	126114678
NR_136302	chr9	+	130578344	130584799	LOC102723566	6455	130575844	130580844
NR_125405	chr3	+	122135052	122162094	LOC102723582	27042	122132552	122137552
NR_125867	chr6	+	137986782	137995691	LOC102723649	8909	137984282	137989282
NR_125991	chr1	+	96457623	96488436	LOC102723661	30813	96455123	96460123
NR_134325	chr7	-	144444	149438	LOC102723672	4994	146938	151938
NR_135179	chr16	+	17228360	17232589	LOC102723692	4229	17225860	17230860
NR_125821	chr8	-	37592278	37594944	LOC102723701	2666	37592444	37597444
NR_125932	chr4	+	103698193	103720732	LOC102723704	22539	103695693	103700693
NR_135820	chr1	+	212004302	212027045	LOC102723727	22743	212001802	212006802
NR_125824	chr8	-	41391823	41435887	LOC102723729	44064	41433387	41438387
NR_135178	chr16	-	32163432	32199434	LOC102723753	36002	32196934	32201934
NR_110761	chr1	-	143134602	143202239	LOC102723769	67637	143199739	143204739
NR_132320	chrUn_gl000241	-	16024	36957	LOC102723780	20933	34457	39457
NR_110550	chr14	-	64980868	65007086	LOC102723809	26218	65004586	65009586
NR_110584	chr2	-	42369574	42397371	LOC102723824	27797	42394871	42399871
NR_125868	chr6	-	151517807	151549592	LOC102723831	31785	151547092	151552092
NR_125993	chr1	+	216245806	216260259	LOC102723833	14453	216243306	216248306
NR_135076	chr11	+	102337985	102369530	LOC102723838	31545	102335485	102340485
NR_125869	chr6	+	68765242	68770394	LOC102723883	5152	68762742	68767742
NR_120517	chr7	+	87845974	87848539	LOC102723885	2565	87843474	87848474
NR_135822	chr1	-	219608499	219730666	LOC102723886	122167	219728166	219733166
NR_130763	chr13	-	64402972	64418258	LOC102723968	15286	64415758	64420758
NR_120484	chr12	-	10167950	10183205	LOC102724020	15255	10180705	10185705
NR_120486	chr12	+	54747474	54860814	LOC102724050	113340	54744974	54749974
NR_110598	chr2	+	166813927	166892910	LOC102724058	78983	166811427	166816427
NR_135761	chr11	+	66115461	66131235	LOC102724064	15774	66112961	66117961
NR_120307	chr16	-	80189854	80597032	LOC102724084	407178	80594532	80599532
NR_120520	chr7	-	100657600	100660889	LOC102724094	3289	100658389	100663389
NR_125874	chr6	-	4186553	4190263	LOC102724096	3710	4187763	4192763
NR_134620	chr6	-	164085397	164092516	LOC102724152	7119	164090016	164095016
NR_110552	chr14	-	76041246	76045931	LOC102724153	4685	76043431	76048431
NR_135138	chr9	-	90681349	90692815	LOC102724156	11466	90690315	90695315
NR_120308	chr16	-	83830840	83837581	LOC102724163	6741	83835081	83840081
NM_001322044	chr7_gl000195_random	-	42937	86719	LOC102724219	43782	84219	89219
NM_001319657	chr11	+	69240438	69244389	LOC102724265	3951	69237938	69242938
NR_125406	chr3	-	46406150	46448550	LOC102724297	42400	46446050	46451050
NR_120587	chr11	+	119600292	119610333	LOC102724301	10041	119597792	119602792
NR_120674	chr10	-	45940015	45948569	LOC102724323	8554	45946069	45951069
NR_134912	chr19	+	19051062	19057640	LOC102724360	6578	19048562	19053562
NR_136205	chr5	-	156789622	156887108	LOC102724404	97486	156884608	156889608
NR_120490	chr12	-	67471405	67490064	LOC102724421	18659	67487564	67492564
NM_001320643	chr21	-	44834362	44847069	LOC102724428	12707	44844569	44849569
NR_130922	chr7	-	115915659	115926781	LOC102724434	11122	115924281	115929281
NR_135683	chr15	-	87482027	87531657	LOC102724452	49630	87529157	87534157
NR_120309	chr16	-	87799936	87812754	LOC102724467	12818	87810254	87815254
NR_120522	chr7	-	29238655	29248586	LOC102724484	9931	29246086	29251086
NR_135480	chr17	-	45968595	45973182	LOC102724532	4587	45970682	45975682
NR_125999	chr1	+	8484704	8495076	LOC102724552	10372	8482204	8487204
NR_111922	chr7	-	123254214	123265011	LOC102724555	10797	123262511	123267511
NR_135824	chr1	-	17083555	17086552	LOC102724562	2997	17084052	17089052
NR_136323	chr2	+	85440774	85445292	LOC102724579	4518	85438274	85443274
NR_136300	chr9	+	67290450	67334405	LOC102724580	43955	67287950	67292950
NR_134489	chr10	+	46951471	46966835	LOC102724593	15364	46948971	46953971
NR_110883	chr17	+	47438731	47457456	LOC102724596	18725	47436231	47441231
NR_121197	chr1	-	174090775	174128425	LOC102724601	37650	174125925	174130925
NR_125407	chr3	-	181138950	181160274	LOC102724604	21324	181157774	181162774
NR_125825	chr8	+	64378406	64388040	LOC102724612	9634	64375906	64380906
NR_125826	chr8	-	64769499	65281115	LOC102724623	511616	65278615	65283615
NM_001314050	chr21	+	44589150	44592915	LOC102724652	3765	44586650	44591650
NR_126000	chr1	-	11837133	11839676	LOC102724659	2543	11837176	11842176
NR_110603	chr2	-	105552698	105654954	LOC102724691	102256	105652454	105657454
NR_136224	chr8	+	68256068	68404103	LOC102724708	148035	68253568	68258568
NR_125827	chr8	-	93577670	93667722	LOC102724710	90052	93665222	93670222
NR_120678	chr10	-	52822338	52828312	LOC102724719	5974	52825812	52830812
NR_136256	chr7	-	62807179	62810444	LOC102724738	3265	62807944	62812944
NR_125937	chr4	+	156275367	156281613	LOC102724776	6246	156272867	156277867
NR_120590	chr11	+	8790324	8831823	LOC102724784	41499	8787824	8792824
NR_125828	chr8	-	97384153	97399666	LOC102724804	15513	97397166	97402166
NR_110555	chr14	+	24030305	24037284	LOC102724814	6979	24027805	24032805
NM_001322047	chr7_gl000195_random	-	42937	86719	LOC102724843	43782	84219	89219
NR_110607	chr2	+	216318429	216328591	LOC102724849	10162	216315929	216320929
NR_125830	chr8	+	78362932	78388567	LOC102724874	25635	78360432	78365432
NR_135636	chr19	+	29097594	29106136	LOC102724908	8542	29095094	29100094
NR_126002	chr1	+	186404292	186439423	LOC102724919	35131	186401792	186406792
NR_120311	chr16	-	3997625	4000445	LOC102724927	2820	3997945	4002945
NM_001322036	chr7_gl000195_random	-	42937	86719	LOC102724951	43782	84219	89219
NM_001293172	chr11	+	15665430	15726914	LOC102724957	61484	15662930	15667930
NR_135922	chr22	+	18837630	18848564	LOC102725072	10934	18835130	18840130
NR_134450	chr8	+	13487198	13490085	LOC102725080	2887	13484698	13489698
NR_136306	chr9	+	68726465	68767301	LOC102725126	40836	68723965	68728965
NR_136261	chr7	+	12536054	12580761	LOC102725191	44707	12533554	12538554
NR_146199	chr1	-	7442547	7449814	LOC102725193	7267	7447314	7452314
NR_111954	chr1	+	149576261	149672983	LOC103091866	96722	149573761	149578761
NR_120379	chr15	+	84977216	84980581	LOC103171574	3365	84974716	84979716
NR_120555	chr11	-	38639813	38667906	LOC103312105	28093	38665406	38670406
NR_120684	chr10	+	114583254	114587491	LOC103344931	4237	114580754	114585754
NR_121624	chr6	-	140299486	140312398	LOC103352541	12912	140309898	140314898
NR_125382	chr11	-	130736143	130740142	LOC103611081	3999	130737642	130742642
NR_147619	chr9	+	46843862	46854113	LOC103908604	10251	46841362	46846362
NR_126152	chr8	+	102996659	103007078	LOC104054148	10419	102994159	102999159
NR_130145	chr18	-	3255433	3262357	LOC104968399	6924	3259857	3264857
NR_136264	chr7	-	81145062	81191135	LOC105369146	46073	81188635	81193635
NR_148213	chr8	-	104255765	104311046	LOC105369147	55281	104308546	104313546
NR_135033	chr12	-	65938017	65951091	LOC105369187	13074	65948591	65953591
NR_134238	chr4	+	89206081	89262809	LOC105369192	56728	89203581	89208581
NR_147887	chr21	+	37477178	37481988	LOC105369306	4810	37474678	37479678
NR_145823	chr11	+	75294240	75305710	LOC105369391	11470	75291740	75296740
NR_135093	chr11	-	94278497	94473521	LOC105369438	195024	94471021	94476021
NR_135097	chr11	+	96241588	96247914	LOC105369443	6326	96239088	96244088
NR_135099	chr11	-	105983185	106002843	LOC105369473	19658	106000343	106005343
NR_135100	chr11	+	110225838	110277632	LOC105369486	51794	110223338	110228338
NR_135108	chr11	+	115204295	115211158	LOC105369509	6863	115201795	115206795
NR_133008	chr11	-	120682053	120689824	LOC105369532	7771	120687324	120692324
NR_135083	chr12	-	6984928	6998522	LOC105369632	13594	6996022	7001022
NR_135030	chr12	-	22741940	22777980	LOC105369691	36040	22775480	22780480
NR_135023	chr12	-	56403875	56418875	LOC105369781	15000	56416375	56421375
NR_135017	chr12	-	94288740	94337382	LOC105369911	48642	94334882	94339882
NR_135014	chr12	-	96189122	96252617	LOC105369921	63495	96250117	96255117
NR_135803	chr12	+	52242006	52246513	LOC105369971	4507	52239506	52244506
NR_135001	chr12	-	111389486	111395622	LOC105369980	6136	111393122	111398122
NR_134995	chr12	-	128133440	128140133	LOC105370068	6693	128137633	128142633
NR_135318	chr13	-	49809650	49821976	LOC105370203	12326	49819476	49824476
NR_131919	chr13	+	88795121	88888337	LOC105370306	93216	88792621	88797621
NR_132422	chr13	-	100738284	100741197	LOC105370333	2913	100738697	100743697
NR_148221	chr13	+	110774048	110777581	LOC105370361	3533	110771548	110776548
NR_148361	chr14	-	22847807	22951948	LOC105370401	104141	22949448	22954448
NR_135256	chr14	+	39351798	39388404	LOC105370457	36606	39349298	39354298
NR_135257	chr14	+	44976611	45007713	LOC105370473	31102	44974111	44979111
NR_144368	chr14	-	62182275	62217815	LOC105370526	35540	62215315	62220315
NR_135505	chr15	-	32957902	32965266	LOC105370757	7364	32962766	32967766
NR_135681	chr15	+	42184974	42191013	LOC105370792	6039	42182474	42187474
NR_135680	chr15	+	45997392	46223267	LOC105370802	225875	45994892	45999892
NR_135679	chr15	+	55348944	55384371	LOC105370829	35427	55346444	55351444
NR_135665	chr15	+	40075106	40077817	LOC105370941	2711	40072606	40077606
NR_135836	chr15	+	41199006	41201549	LOC105370943	2543	41196506	41201506
NR_135682	chr15	+	87476110	87489562	LOC105370954	13452	87473610	87478610
NR_135176	chr16	+	1630527	1660329	LOC105371046	29802	1628027	1633027
NR_135175	chr16	+	2141436	2145018	LOC105371049	3582	2138936	2143936
NR_135174	chr16	-	11435665	11439069	LOC105371083	3404	11436569	11441569
NR_136518	chr16	-	53069601	53086785	LOC105371267	17184	53084285	53089285
NR_135171	chr16	+	71547713	71551749	LOC105371335	4036	71545213	71550213
NR_136407	chr17	-	254325	263814	LOC105371430	9489	261314	266314
NR_135098	chr1	+	150132925	150153463	LOC105371433	20538	150130425	150135425
NR_135760	chr1	+	157895756	157918861	LOC105371458	23105	157893256	157898256
NR_135642	chr17	+	1921009	1924000	LOC105371485	2991	1918509	1923509
NR_135673	chr17	-	25399414	25416267	LOC105371703	16853	25413767	25418767
NR_136415	chr17	+	42193279	42197963	LOC105371789	4684	42190779	42195779
NR_135646	chr17	-	43246171	43248852	LOC105371795	2681	43246352	43251352
NR_135674	chr17	-	46952221	46986345	LOC105371814	34124	46983845	46988845
NR_135648	chr17	+	58156669	58166053	LOC105371849	9384	58154169	58159169
NR_147886	chr17	+	60783566	60815282	LOC105371855	31716	60781066	60786066
NR_145982	chr17	-	67471394	67481673	LOC105371880	10279	67479173	67484173
NR_136417	chr17	-	74946555	74965281	LOC105371899	18726	74962781	74967781
NR_136503	chr17	-	75269865	75277979	LOC105371907	8114	75275479	75280479
NR_135654	chr17	+	79202506	79206009	LOC105371925	3503	79200006	79205006
NR_136514	chr18	+	12432772	12447797	LOC105371998	15025	12430272	12435272
NR_134604	chr18	+	22305744	22346609	LOC105372028	40865	22303244	22308244
NR_134589	chr18	-	24916954	24922620	LOC105372038	5666	24920120	24925120
NR_134585	chr18	-	34481907	34503777	LOC105372069	21870	34501277	34506277
NR_132982	chr18	-	34240351	34243381	LOC105372071	3030	34240881	34245881
NR_134909	chr19	+	11314303	11326844	LOC105372273	12541	11311803	11316803
NR_136525	chr19	+	36438016	36454972	LOC105372383	16956	36435516	36440516
NR_134907	chr19	+	39086986	39092334	LOC105372397	5348	39084486	39089486
NR_134887	chr19	-	45588586	45593649	LOC105372419	5063	45591149	45596149
NR_134883	chr19	-	51279402	51289467	LOC105372440	10065	51286967	51291967
NR_131205	chr19	+	51333785	51354399	LOC105372441	20614	51331285	51336285
NR_136529	chr19	-	57778560	57791702	LOC105372476	13142	57789202	57794202
NR_144444	chr19	-	58826315	58838614	LOC105372480	12299	58836114	58841114
NR_136527	chr19	+	58873991	58877945	LOC105372483	3954	58871491	58876491
NR_135006	chr20	+	25731843	25736686	LOC105372582	4843	25729343	25734343
NR_146919	chr20	+	45035417	45073610	LOC105372633	38193	45032917	45037917
NR_134564	chr20	+	48532358	48545358	LOC105372653	13000	48529858	48534858
NR_134576	chr20	+	52224892	52251129	LOC105372672	26237	52222392	52227392
NR_148046	chr22	+	30828672	30832488	LOC105372990	3816	30826172	30831172
NR_134623	chr22	+	37099920	37163133	LOC105373021	63213	37097420	37102420
NR_134631	chr22	-	41947712	41956887	LOC105373044	9175	41954387	41959387
NR_146602	chr22	-	45572122	45587493	LOC105373064	15371	45584993	45589993
NR_136577	chrX	+	6144398	6148332	LOC105373156	3934	6141898	6146898
NR_131237	chrX	-	102785694	102809881	LOC105373300	24187	102807381	102812381
NR_135655	chrX	+	129936609	129940372	LOC105373338	3763	129934109	129939109
NR_136168	chr2	+	558200	562092	LOC105373352	3892	555700	560700
NR_136578	chrX	-	151072902	151079555	LOC105373368	6653	151077055	151082055
NR_135656	chrX	+	152617486	152625567	LOC105373378	8081	152614986	152619986
NR_135564	chr2	-	97193676	97198043	LOC105373496	4367	97195543	97200543
NR_132317	chr2	-	128317619	128328537	LOC105373609	10918	128326037	128331037
NR_136171	chr2	+	178538049	178588015	LOC105373764	49966	178535549	178540549
NR_136318	chr2	+	191886251	191897040	LOC105373805	10789	191883751	191888751
NR_135524	chr2	+	218843429	218857338	LOC105373878	13909	218840929	218845929
NR_147411	chr3	+	112021324	112051598	LOC105374042	30274	112018824	112023824
NR_135547	chr3	-	118227257	118529680	LOC105374060	302423	118527180	118532180
NR_135545	chr3	+	166616470	166649612	LOC105374194	33142	166613970	166618970
NR_134932	chr3	+	169165654	169194840	LOC105374205	29186	169163154	169168154
NR_136186	chr3	-	195373505	195379030	LOC105374297	5525	195376530	195381530
NR_136187	chr3	+	149814229	149868788	LOC105374313	54559	149811729	149816729
NR_148199	chr4	+	570956	578655	LOC105374338	7699	568456	573456
NR_134676	chr4	+	1107426	1126763	LOC105374344	19337	1104926	1109926
NR_134668	chr4	-	42301028	42393285	LOC105374428	92257	42390785	42395785
NR_146505	chr2	-	33780111	33794497	LOC105374454	14386	33791997	33796997
NR_134233	chr4	+	21583718	21615345	LOC105374516	31627	21581218	21586218
NR_136207	chr5	+	2917967	2920642	LOC105374620	2675	2915467	2920467
NR_136312	chr2	+	78772656	78793210	LOC105374820	20554	78770156	78775156
NR_134618	chr6	+	17707273	17711258	LOC105374952	3985	17704773	17709773
NR_134615	chr6	+	19450051	19459579	LOC105374960	9528	19447551	19452551
NR_134614	chr6	-	22643738	22718153	LOC105374972	74415	22715653	22720653
NR_134611	chr6	+	26569551	26574926	LOC105374988	5375	26567051	26572051
NR_134610	chr6_cox_hap2	-	2319368	2328008	LOC105375014	8640	2325508	2330508
NR_134609	chr6	-	44513897	44519618	LOC105375075	5721	44517118	44522118
NR_134258	chr7	+	15707571	15721604	LOC105375166	14033	15705071	15710071
NR_136267	chr7	-	30287044	30325701	LOC105375218	38657	30323201	30328201
NR_136272	chr7	-	26411638	26439038	LOC105375304	27400	26436538	26441538
NR_134235	chr7	+	93520205	93522897	LOC105375401	2692	93517705	93522705
NR_133946	chr7	+	100254183	100264049	LOC105375429	9866	100251683	100256683
NR_133947	chr7	+	123634675	123667700	LOC105375483	33025	123632175	123637175
NR_133931	chr7	-	132783830	132793271	LOC105375512	9441	132790771	132795771
NR_133932	chr7	-	142952391	142983427	LOC105375545	31036	142980927	142985927
NR_132986	chr8	-	96079035	96085410	LOC105375650	6375	96082910	96087910
NR_145698	chr8	-	104493507	104514138	LOC105375690	20631	104511638	104516638
NR_136278	chr8	+	117664338	117666863	LOC105375713	2525	117661838	117666838
NR_134463	chr8	-	134676003	134696309	LOC105375773	20306	134693809	134698809
NR_134323	chr8	-	56429746	56433537	LOC105375843	3791	56431037	56436037
NR_135135	chr9	+	9799391	9803787	LOC105375972	4396	9796891	9801891
NR_135136	chr9	-	46163625	46168270	LOC105376064	4645	46165770	46170770
NR_135839	chr9	+	86322749	86328408	LOC105376114	5659	86320249	86325249
NR_135141	chr9	+	107032509	107048859	LOC105376194	16350	107030009	107035009
NR_132978	chr9	-	140838081	140841512	LOC105376331	3431	140839012	140844012
NR_136146	chr10	-	2488446	2543654	LOC105376351	55208	2541154	2546154
NR_131187	chr10	+	3360886	3792955	LOC105376360	432069	3358386	3363386
NR_134492	chr10	-	8614709	8636354	LOC105376398	21645	8633854	8638854
NR_134496	chr10	-	28721936	28784742	LOC105376468	62806	28782242	28787242
NR_135110	chr11	+	37960150	37976213	LOC105376633	16063	37957650	37962650
NR_131170	chr11	+	27493277	27503980	LOC105376671	10703	27490777	27495777
NM_001321990	chr15	-	75519093	75522031	LOC105376731	2938	75519531	75524531
NR_135536	chr3	+	17784435	17787154	LOC105376975	2719	17781935	17786935
NR_135535	chr3	+	57303593	57312155	LOC105377102	8562	57301093	57306093
NR_135533	chr3	-	66780801	66788760	LOC105377143	7959	66786260	66791260
NR_135532	chr3	+	68549787	68555023	LOC105377146	5236	68547287	68552287
NR_136191	chr4	+	70047817	70082485	LOC105377267	34668	70045317	70050317
NR_148380	chr4	+	99580052	99585702	LOC105377342	5650	99577552	99582552
NR_131186	chr4	+	103749211	103765263	LOC105377348	16052	103746711	103751711
NM_001350601	chr4	+	113436534	113468040	LOC105377372	31506	113434034	113439034
NR_133945	chr4	-	139741110	139933800	LOC105377448	192690	139931300	139936300
NR_134680	chr4	-	144738946	144750501	LOC105377458	11555	144748001	144753001
NR_136202	chr4	-	103339758	103423643	LOC105377621	83885	103421143	103426143
NR_136203	chr4	-	144098812	144106014	LOC105377623	7202	144103514	144108514
NR_134682	chr4	-	32007474	32024044	LOC105377651	16570	32021544	32026544
NR_136214	chr5	-	170066161	170108474	LOC105377716	42313	170105974	170110974
NR_134260	chr5	+	179084762	179101296	LOC105377763	16534	179082262	179087262
NR_136251	chr6	+	84419160	84436214	LOC105377879	17054	84416660	84421660
NR_134603	chr6	-	106899370	106905123	LOC105377924	5753	106902623	106907623
NR_134601	chr6	+	118407065	118416635	LOC105377967	9570	118404565	118409565
NR_134600	chr6	+	119870972	120166230	LOC105377975	295258	119868472	119873472
NR_134599	chr6	-	149348364	149353797	LOC105378047	5433	149351297	149356297
NR_134597	chr6	+	155835977	155847152	LOC105378068	11175	155833477	155838477
NR_134594	chr6	+	161892008	161905077	LOC105378098	13069	161889508	161894508
NR_134592	chr6	-	167578836	167583468	LOC105378123	4632	167580968	167585968
NR_134591	chr6	-	167871476	167885013	LOC105378127	13537	167882513	167887513
NR_136250	chr6	-	169327835	169364477	LOC105378146	36642	169361977	169366977
NR_134498	chr10	+	43250589	43265069	LOC105378269	14480	43248089	43253089
NR_134503	chr10	+	56245989	56415811	LOC105378311	169822	56243489	56248489
NR_134313	chr10	+	72698809	72715398	LOC105378349	16589	72696309	72701309
NR_132791	chr10	+	77472212	77503606	LOC105378367	31394	77469712	77474712
NR_134315	chr10	-	81388513	81422941	LOC105378385	34428	81420441	81425441
NR_134317	chr10	-	85432161	85436845	LOC105378397	4684	85434345	85439345
NR_134319	chr10	+	92792922	92801012	LOC105378430	8090	92790422	92795422
NR_134330	chr10	+	107899922	107948480	LOC105378470	48558	107897422	107902422
NR_147951	chr1	+	1534812	1542590	LOC105378586	7778	1532312	1537312
NR_135054	chr1	-	19918295	19923326	LOC105378614	5031	19920826	19925826
NR_135048	chr1	+	39339072	39341898	LOC105378663	2826	39336572	39341572
NR_133055	chr1	-	43242336	43250566	LOC105378683	8230	43248066	43253066
NR_135837	chr1	-	87036863	87170176	LOC105378828	133313	87167676	87172676
NR_135038	chr1	-	91248540	91317195	LOC105378853	68655	91314695	91319695
NR_134252	chr5	-	72427834	72446419	LOC105379030	18585	72443919	72448919
NR_134250	chr5	-	118347497	118406585	LOC105379143	59088	118404085	118409085
NR_146771	chr5	-	122421926	122426011	LOC105379152	4085	122423511	122428511
NR_134248	chr5	-	132014776	132018321	LOC105379176	3545	132015821	132020821
NR_134246	chr5	+	136463885	136466658	LOC105379192	2773	136461385	136466385
NR_134244	chr5	-	138080118	138089613	LOC105379194	9495	138087113	138092113
NR_136310	chr9	+	69476016	69481677	LOC105379252	5661	69473516	69478516
NR_136589	chr8	+	41909267	41962505	LOC105379393	53238	41906767	41911767
NR_134504	chrUn_gl000219	+	45396	57412	LOC105379477	12016	42896	47896
NR_135513	chr4	+	190598968	190601527	LOC105379514	2559	190596468	190601468
NR_136574	chr22	-	18660803	18668247	LOC105379550	7444	18665747	18670747
NR_131227	chr2	-	168671283	168797654	LOC105616981	126371	168795154	168800154
NR_131917	chr2	+	192554906	192575195	LOC105747689	20289	192552406	192557406
NR_131944	chr10	+	8939951	8956559	LOC105755953	16608	8937451	8942451
NR_132988	chr16	+	2318663	2323073	LOC106660606	4410	2316163	2321163
NR_133569	chr16	+	66785654	66788645	LOC106699570	2991	66783154	66788154
NR_134500	chr10	-	48324787	48332197	LOC107001062	7410	48329697	48334697
NR_147846	chr2	+	120234029	120244919	LOC107105282	10890	120231529	120236529
NR_015341	chr17	+	28903482	28964484	LOC107133515	61002	28900982	28905982
NR_148348	chr9	+	45441884	45565124	LOC107984035	123240	45439384	45444384
NR_146902	chr13	-	19648173	19692423	LOC107984132	44250	19689923	19694923
NM_001330236	chr14	+	103550546	103556362	LOC107984640	5816	103548046	103553046
NR_148060	chr14	+	96181819	96223116	LOC107984703	41297	96179319	96184319
NR_148210	chr15	-	62488370	62495517	LOC107984784	7147	62493017	62498017
NM_001350579	chr17	+	29335301	29373850	LOC107984974	38549	29332801	29337801
NR_146603	chr22	-	31282042	31317766	LOC107985544	35724	31315266	31320266
NR_147976	chr2	-	124769511	124782751	LOC107985820	13240	124780251	124785251
NR_148338	chr7	+	128026735	128032401	LOC107986845	5666	128024235	128029235
NR_144383	chr6	-	26086517	26091262	LOC108783645	4745	26088762	26093762
NR_146092	chr4	-	113567875	113571207	LOC109864269	3332	113568707	113573707
NR_146604	chr22	+	27256173	27277748	LOC110091768	21575	27253673	27258673
NR_146644	chr21	-	15281768	15306200	LOC110091776	24432	15303700	15308700
NR_146657	chr21	+	15095788	15138858	LOC110091777	43070	15093288	15098288
NM_001303427	chr1	-	46505811	46642167	LOC110117498-PIK3R3	136356	46639667	46644667
NM_001352000	chr6_dbb_hap3	+	3235414	3256040	LOC110384692	20626	3232914	3237914
NR_132971	chr15	-	69689242	69707368	LOC145694	18126	69704868	69709868
NR_015419	chr15	-	57178367	57210697	LOC145783	32330	57208197	57213197
NR_024264	chr15	-	37156643	37178734	LOC145845	22091	37176234	37181234
NR_015434	chr1	+	1334909	1337426	LOC148413	2517	1332409	1337409
NR_026817	chr1	+	207991723	207995941	LOC148696	4218	207989223	207994223
NR_002929	chr1	+	202830881	202844369	LOC148709	13488	202828381	202833381
NM_001256615	chr1	-	231319844	231323373	LOC149373	3529	231320873	231325873
NR_104170	chr20	+	36888576	36917348	LOC149684	28772	36886076	36891076
NR_034152	chr20	+	31175280	31196694	LOC149950	21414	31172780	31177780
NR_026922	chr2	+	132250385	132279149	LOC150776	28764	132247885	132252885
NR_037808	chr2	+	240684553	240722356	LOC150935	37803	240682053	240687053
NR_026925	chr2	-	239133753	239140318	LOC151174	6565	239137818	239142818
NR_038238	chr2	+	231751260	231769232	LOC151484	17972	231748760	231753760
NR_015447	chr5	+	43042235	43045370	LOC153684	3135	43039735	43044735
NR_027312	chr6	-	142847591	142959026	LOC153910	111435	142956526	142961526
NR_002787	chr6	-	170563421	170571657	LOC154449	8236	170569157	170574157
NR_015421	chr7	-	143509060	143533810	LOC154761	24750	143531310	143536310
NR_036573	chr7	+	148982371	148994403	LOC155060	12032	148979871	148984871
NR_040039	chr8	+	9182560	9192590	LOC157273	10030	9180060	9185060
NR_132344	chr9	-	98868942	98878693	LOC158434	9751	98876193	98881193
NR_033838	chr9	+	98828120	98864194	LOC158435	36074	98825620	98830620
NR_126343	chr11	+	777577	784284	LOC171391	6707	775077	780077
NR_033841	chr2	-	241894035	241906868	LOC200772	12833	241904368	241909368
NR_026921	chr5	-	177045500	177099278	LOC202181	53778	177096778	177101778
NR_003266	chr3	-	197340897	197354752	LOC220729	13855	197352252	197357252
NR_026681	chr11	+	44995452	44999578	LOC221122	4126	44992952	44997952
NR_126168	chr7	+	5553484	5565176	LOC221946	11692	5550984	5555984
NR_122043	chr14	+	21056382	21075380	LOC254028	18998	21053882	21058882
NR_046173	chr8	+	22941867	22961070	LOC254896	19203	22939367	22944367
NR_122044	chr5	+	148442879	148489350	LOC255187	46471	148440379	148445379
NR_125923	chr4	+	100871650	100958862	LOC256880	87212	100869150	100874150
NR_034107	chr5	+	52405671	52410956	LOC257396	5285	52403171	52408171
NR_136644	chr10	-	43246635	43250651	LOC283028	4016	43248151	43253151
NR_033848	chr10	+	127371811	127398246	LOC283038	26435	127369311	127374311
NR_104162	chr10	-	64099346	64134886	LOC283045	35540	64132386	64137386
NR_126004	chr11	+	112141471	112233257	LOC283140	91786	112138971	112143971
NR_033852	chr11	+	134306375	134375555	LOC283177	69180	134303875	134308875
NR_033853	chr11	-	58701115	58825925	LOC283194	124810	58823425	58828425
NR_046090	chr11	-	75469499	75479692	LOC283214	10193	75477192	75482192
NR_036678	chr11	-	7872297	7927502	LOC283299	55205	7925002	7930002
NR_033854	chr12	-	53436972	53448222	LOC283335	11250	53445722	53450722
NR_147498	chr12	-	126885337	126933873	LOC283435	48536	126931373	126936373
NR_147215	chr15	+	58357422	58364903	LOC283665	7481	58354922	58359922
NR_040057	chr15	-	23094330	23115254	LOC283683	20924	23112754	23117754
NM_001243538	chr15	-	31514970	31523054	LOC283710	8084	31520554	31525554
NR_027073	chr15	-	74418713	74421619	LOC283731	2906	74419119	74424119
NR_027436	chrUn_gl000219	-	56348	99642	LOC283788	43294	97142	102142
NR_027078	chr16	-	56126898	56225006	LOC283856	98108	56222506	56227506
NR_026950	chr16	-	74366303	74402153	LOC283922	35850	74399653	74404653
NR_028335	chr17	-	2310274	2318730	LOC284009	8456	2316230	2321230
NR_024349	chr17	-	7816639	7819265	LOC284023	2626	7816765	7821765
NR_136643	chr18	-	77398927	77439745	LOC284241	40818	77437245	77442245
NR_033888	chr19	-	43715942	43752798	LOC284344	36856	43750298	43755298
NR_002938	chr19	-	54102884	54106751	LOC284379	3867	54104251	54109251
NR_040029	chr19	-	29777917	30016659	LOC284395	238742	30014159	30019159
NR_029390	chr19	-	37756840	37759912	LOC284412	3072	37757412	37762412
NR_046097	chr1	+	205831206	205865215	LOC284581	34009	205828706	205833706
NR_027087	chr1	+	24526729	24538180	LOC284632	11451	24524229	24529229
NR_027090	chr20	-	22380970	22401281	LOC284788	20311	22398781	22403781
NR_027091	chr20	-	25121433	25129426	LOC284798	7993	25126926	25131926
NR_038460	chr22	-	20186252	20192441	LOC284865	6189	20189941	20194941
NM_001318329	chr22	-	27444105	27456480	LOC284898	12375	27453980	27458980
NR_122046	chr22	+	48027422	48251349	LOC284930	223927	48024922	48029922
NR_038917	chr22	-	48934711	48943199	LOC284933	8488	48940699	48945699
NR_038888	chr2	+	86042252	86053911	LOC284950	11659	86039752	86044752
NR_038891	chr2	-	106209553	106227016	LOC285000	17463	106224516	106229516
NR_122048	chr2	+	30569511	30573024	LOC285043	3513	30567011	30572011
NR_026846	chr2	-	87257797	87303536	LOC285074	45739	87301036	87306036
NR_135766	chr2	-	242836133	242844774	LOC285095	8641	242842274	242847274
NR_147407	chr4	+	159091903	159124029	LOC285505	32126	159089403	159094403
NR_027108	chr5	+	173006636	173012071	LOC285593	5435	173004136	173009136
NR_037889	chr5	+	158758525	158789842	LOC285626	31317	158756025	158761025
NR_027253	chr5	-	17130136	17217531	LOC285696	87395	17215031	17220031
NR_046100	chr6	-	119773711	119812467	LOC285762	38756	119809967	119814967
NR_126020	chr6	-	181465	205484	LOC285766	24019	202984	207984
NR_126021	chr6	-	170575756	170585850	LOC285804	10094	170583350	170588350
NR_038992	chr6	-	26472171	26482737	LOC285819	10566	26480237	26485237
NR_027117	chr6	-	35694538	35704724	LOC285847	10186	35702224	35707224
NR_038232	chr7	-	156230482	156238282	LOC285889	7800	156235782	156240782
NR_038873	chr8	+	22925741	22941132	LOC286059	15391	22923241	22928241
NR_111948	chr8	-	1244293	1250823	LOC286083	6530	1248323	1253323
NR_038874	chr8	+	58173784	58179170	LOC286177	5386	58171284	58176284
NR_134276	chr8	+	58658707	58662756	LOC286178	4049	58656207	58661207
NR_046175	chr9	-	42844369	42859085	LOC286297	14716	42856585	42861585
NR_026847	chr9	-	100153118	100158973	LOC286359	5855	100156473	100161473
NR_104161	chr11	-	68914695	68939030	LOC338694	24335	68936530	68941530
NR_034139	chr15	-	83379222	83382745	LOC338963	3523	83380245	83385245
NR_120387	chr16	+	88809174	88812156	LOC339059	2982	88806674	88811674
NR_040000	chr17	+	5675553	5834016	LOC339166	158463	5673053	5678053
NR_147507	chr17	-	43268297	43299132	LOC339192	30835	43296632	43301632
NR_123730	chr17	+	20841832	20885670	LOC339260	43838	20839332	20844332
NR_040034	chr18	+	73834952	73857210	LOC339298	22258	73832452	73837452
NR_033883	chr1	+	244080703	244210619	LOC339529	129916	244078203	244083203
NR_104171	chr1	+	43323292	43354463	LOC339539	31171	43320792	43325792
NR_038972	chr20	-	11247306	11254031	LOC339593	6725	11251531	11256531
NR_038918	chr22	+	32772650	32780329	LOC339666	7679	32770150	32775150
NR_144462	chr22	+	47741320	47769291	LOC339685	27971	47738820	47743820
NR_036496	chr2	-	61368726	61372110	LOC339803	3384	61369610	61374610
NR_034023	chr2	+	64834445	64843616	LOC339807	9171	64831945	64836945
NM_001257177	chr3	+	18004063	18310410	LOC339862	306347	18001563	18006563
NR_038976	chr3	-	131043935	131100319	LOC339874	56384	131097819	131102819
NR_038931	chr4	-	188225236	188426767	LOC339975	201531	188424267	188429267
NR_134291	chr5	-	72491116	72497788	LOC340090	6672	72495288	72500288
NR_015383	chr8	-	12623570	12668910	LOC340357	45340	12666410	12671410
NR_126029	chr9	-	109737113	109865269	LOC340512	128156	109862769	109867769
NR_027277	chr4	-	40044536	40058819	LOC344967	14283	40056319	40061319
NR_046103	chr7	-	136583519	136849088	LOC349160	265569	136846588	136851588
NR_046450	chr12	+	9769879	9811010	LOC374443	41131	9767379	9772379
NR_104155	chr11	-	112404944	112426525	LOC387810	21581	112424025	112429025
NR_002556	chr16	-	29476288	29478899	LOC388242	2611	29476399	29481399
NM_001278081	chr16	+	57844548	57850831	LOC388282	6283	57842048	57847048
NM_001291905	chr17	+	18992773	19000876	LOC388436	8103	18990273	18995273
NM_001013644	chr1	+	149288353	149291742	LOC388692	3389	149285853	149290853
NM_001287682	chr20	+	2187573	2193797	LOC388780	6224	2185073	2190073
NM_001256579	chr21	-	15963712	16015428	LOC388813	51716	16012928	16017928
NR_033995	chr4	-	184415889	184425668	LOC389247	9779	184423168	184428168
NR_144629	chr7	+	155753912	155761085	LOC389602	7173	155751412	155756412
NR_033928	chr8	+	23082733	23088439	LOC389641	5706	23080233	23085233
NR_003920	chr9	+	14993324	15019722	LOC389705	26398	14990824	14995824
NR_029410	chr9	+	88420916	88457794	LOC389765	36878	88418416	88423416
NM_001242480	chr7_gl000195_random	-	42937	86735	LOC389831	43798	84235	89235
NR_027420	chrUn_gl000218	-	46844	55049	LOC389834	8205	52549	57549
NR_034031	chrX	-	3735575	3761935	LOC389906	26360	3759435	3764435
NM_001321601	chr19	+	6396369	6412415	LOC390877	16046	6393869	6398869
NR_033867	chr8	-	73114986	73163869	LOC392232	48883	73161369	73166369
NR_040079	chr10	+	6368506	6377943	LOC399715	9437	6366006	6371006
NR_027282	chr10	+	124639148	124658230	LOC399815	19082	124636648	124641648
NR_122071	chr11	+	45392947	45410059	LOC399886	17112	45390447	45395447
NR_145484	chr11	-	129103672	129153059	LOC399975	49387	129150559	129155559
NR_135737	chr15	+	100347227	100423187	LOC400464	75960	100344727	100349727
NR_126007	chr16	-	70190242	70207351	LOC400541	17109	70204851	70209851
NR_034133	chr18	-	70821292	70931733	LOC400655	110441	70929233	70934233
NR_144514	chr19	+	21832469	21841410	LOC400682	8941	21829969	21834969
NR_046201	chr19	-	32880955	32896445	LOC400684	15490	32893945	32898945
NR_125344	chr19	-	46560935	46580887	LOC400706	19952	46578387	46583387
NR_138096	chr19	+	50553845	50578840	LOC400710	24995	50551345	50556345
NR_026744	chr1	-	165446078	165551392	LOC400794	105314	165548892	165553892
NR_147896	chr1	+	199117725	199362435	LOC400800	244710	199115225	199120225
NR_120405	chr21	-	40249214	40310353	LOC400867	61139	40307853	40312853
NR_002821	chr22	-	38740669	38794931	LOC400927	54262	38792431	38797431
NM_001289912	chr22	-	38686696	38794527	LOC400927-CSNK1E	107831	38792027	38797027
NR_026833	chr2	+	6122109	6128364	LOC400940	6255	6119609	6124609
NR_148241	chr2	+	177001339	177005119	LOC401021	3780	176998839	177003839
NM_001008737	chr3	-	10048101	10052779	LOC401052	4678	10050279	10055279
NR_134654	chr6	+	42751233	42759061	LOC401261	7828	42748733	42753733
NR_122075	chr7	-	22689578	22705152	LOC401312	15574	22702652	22707652
NR_038889	chr7	-	30587972	30617395	LOC401320	29423	30614895	30619895
NR_038864	chr7	+	35353465	35416086	LOC401324	62621	35350965	35355965
NR_130727	chr7	-	56876816	56880429	LOC401357	3613	56877929	56882929
NR_015374	chr8	-	65486865	65489820	LOC401463	2955	65487320	65492320
NR_135124	chr9	-	132902888	132906498	LOC401554	3610	132903998	132908998
NR_046107	chr9	+	138073454	138079152	LOC401557	5698	138070954	138075954
NR_125365	chrX	-	45707508	45710920	LOC401585	3412	45708420	45713420
NM_001301851	chr11	+	125365109	125369422	LOC403312	4313	125362609	125367609
NR_122076	chr9	-	66513679	66553911	LOC403323	40232	66551411	66556411
NR_121211	chr12	-	105496249	105501420	LOC414300	5171	105498920	105503920
NR_122079	chr4	+	36245737	36275837	LOC439933	30100	36243237	36248237
NR_033972	chr11	-	9776316	9781080	LOC440028	4764	9778580	9783580
NR_027044	chr11	+	49580079	49831969	LOC440040	251890	49577579	49582579
NR_027471	chr9	-	89623365	89657041	LOC440173	33676	89654541	89659541
NR_033738	chr15	+	84860599	84878025	LOC440300	17426	84858099	84863099
NR_036750	chr17	-	36351795	36413256	LOC440434	61461	36410756	36415756
NR_135765	chr1	+	17197439	17200587	LOC440570	3148	17194939	17199939
NR_036595	chr1	-	110828998	110881793	LOC440600	52795	110879293	110884293
NR_036683	chr1	+	165667986	165679199	LOC440700	11213	165665486	165670486
NR_027143	chr2	-	111160495	111181393	LOC440895	20898	111178893	111183893
NR_147036	chr9	-	69174195	69198043	LOC440896	23848	69195543	69200543
NR_030728	chr2	+	132036862	132057392	LOC440910	20530	132034362	132039362
NR_136642	chr2	+	223183189	223222629	LOC440934	39440	223180689	223185689
NR_121655	chr3	+	147139113	147227697	LOC440982	88584	147136613	147141613
NR_073404	chr5	+	69782327	69787614	LOC441081	5287	69779827	69784827
NM_001271675	chr6	+	66011310	66015504	LOC441155	4194	66008810	66013810
NR_015364	chr7	+	26443107	26535986	LOC441204	92879	26440607	26445607
NR_038378	chr7	-	65111923	65235797	LOC441242	123874	65233297	65238297
NR_003034	chr11	-	50238998	50257633	LOC441601	18635	50255133	50260133
NR_024380	chr10	-	42827313	42863493	LOC441666	36180	42860993	42865993
NR_037597	chr2	-	95534429	95613087	LOC442028	78658	95610587	95615587
NR_033906	chr5	-	7301442	7306827	LOC442132	5385	7304327	7309327
NR_033960	chr7	+	419390	422845	LOC442497	3455	416890	421890
NR_026564	chr11	+	18230684	18235111	LOC494141	4427	18228184	18233184
NR_003602	chr7	+	72440164	72443674	LOC541473	3510	72437664	72442664
NR_046116	chr4	+	68919225	68938951	LOC550113	19726	68916725	68921725
NR_132323	chr6	+	29759682	29765584	LOC554223	5902	29757182	29762182
NR_033859	chr12	-	246576	258332	LOC574538	11756	255832	260832
NR_002557	chr16	-	29476288	29478899	LOC613038	2611	29476399	29481399
NR_130924	chr20	-	15872978	15966527	LOC613266	93549	15964027	15969027
NR_024523	chr19	+	21933546	21936240	LOC641367	2694	21931046	21936046
NR_046243	chr5	-	50668570	50679166	LOC642366	10596	50676666	50681666
NR_024374	chr12	+	9436252	9466684	LOC642846	30432	9433752	9438752
NR_026943	chr21	+	46707966	46717269	LOC642852	9303	46705466	46710466
NR_027472	chr9	-	43140536	43145484	LOC642929	4948	43142984	43147984
NR_111003	chr9	+	95644848	95651837	LOC642943	6989	95642348	95647348
NR_110588	chr2	+	160471804	160474553	LOC643072	2749	160469304	160474304
NR_036494	chr5	-	175570087	175626298	LOC643201	56211	175623798	175628798
NR_147844	chr6	+	3455936	3469244	LOC643327	13308	3453436	3458436
NR_040096	chr12	-	93397533	93771512	LOC643339	373979	93769012	93774012
NR_026923	chr2	+	239140326	239142985	LOC643387	2659	239137826	239142826
NR_029405	chr20	+	5451841	5457780	LOC643406	5939	5449341	5454341
NR_038846	chr1	-	113739403	113748875	LOC643441	9472	113746375	113751375
NR_033921	chr18	+	65183782	65566856	LOC643542	383074	65181282	65186282
NR_077241	chr12	-	98107189	98147376	LOC643711	40187	98144876	98149876
NR_034078	chr11	-	104772275	104788902	LOC643733	16627	104786402	104791402
NM_001347693	chr16	-	53399303	53405124	LOC643802	5821	53402624	53407624
NR_003935	chr4	+	56686236	56703430	LOC644145	17194	56683736	56688736
NR_130929	chr5	-	86614231	86619445	LOC644285	5214	86616945	86621945
NR_040013	chr19	+	38308050	38317278	LOC644554	9228	38305550	38310550
NR_027417	chr18	-	15313554	15325918	LOC644669	12364	15323418	15328418
NR_027356	chr1	+	148928312	148951595	LOC645166	23283	148925812	148930812
NM_001321724	chr12	+	25150495	25205380	LOC645177	54885	25147995	25152995
NR_135046	chr12	+	30908007	30933673	LOC645485	25666	30905507	30910507
NR_037630	chr4	+	120375937	120420747	LOC645513	44810	120373437	120378437
NR_027024	chr15	-	78206558	78219188	LOC645752	12630	78216688	78221688
NR_130930	chr11	+	77282133	77286707	LOC646029	4574	77279633	77284633
NR_146737	chr17	-	29361765	29386127	LOC646030	24362	29383627	29388627
NR_027053	chr15	-	21932513	21940739	LOC646214	8226	21938239	21943239
NR_024498	chr1	-	26146444	26150097	LOC646471	3653	26147597	26152597
NR_120444	chr11	-	133653565	133680271	LOC646522	26706	133677771	133682771
NR_135825	chr14	+	70653824	70699300	LOC646548	45476	70651324	70656324
NR_136190	chr3	+	141382040	141439916	LOC646730	57876	141379540	141384540
NR_046102	chr2	+	227007509	227044778	LOC646736	37269	227005009	227010009
NR_033930	chr2	-	131294142	131307488	LOC646743	13346	131304988	131309988
NR_024278	chr7	-	29685537	29724754	LOC646762	39217	29722254	29727254
NR_024504	chr11	+	50368317	50379802	LOC646813	11485	50365817	50370817
NR_026578	chr5	-	70370029	70388897	LOC647859	18868	70386397	70391397
NR_104651	chr5	-	43014830	43067541	LOC648987	52711	43065041	43070041
NR_038829	chr11	-	120120467	120136641	LOC649133	16174	120134141	120139141
NR_029420	chr7	-	56491396	56516068	LOC650226	24672	56513568	56518568
NR_147508	chr9	-	140678524	140682858	LOC651337	4334	140680358	140685358
NR_015441	chr16	+	2653384	2680495	LOC652276	27111	2650884	2655884
NR_146391	chr5	+	69140495	69293540	LOC653080	153045	69137995	69142995
NR_037869	chr1	-	35441299	35444307	LOC653160	3008	35441807	35446807
NR_034179	chr3	-	128580350	128590384	LOC653712	10034	128587884	128592884
NR_003676	chr16	+	22557018	22588186	LOC653786	31168	22554518	22559518
NR_027238	chr2	-	91824708	91847975	LOC654342	23267	91845475	91850475
NR_147175	chr16	-	84226163	84230659	LOC654780	4496	84228159	84233159
NR_102371	chr2	-	228085767	228189880	LOC654841	104113	228187380	228192380
NR_102747	chr15	-	83140203	83182973	LOC727751	42770	83180473	83185473
NR_026659	chr18	-	2943212	2946621	LOC727896	3409	2944121	2949121
NR_109897	chr5	+	168440231	168465003	LOC728095	24772	168437731	168442731
NR_147706	chr11	+	111381326	111384613	LOC728196	3287	111378826	111383826
NM_001294306	chr19	+	37264019	37267980	LOC728485	3961	37261519	37266519
NR_003615	chr5	+	177302261	177311269	LOC728554	9008	177299761	177304761
NR_003713	chr5	-	1597671	1634120	LOC728613	36449	1631620	1636620
NR_144634	chr12	-	9549652	9560010	LOC728715	10358	9557510	9562510
NR_037875	chr2	+	39664556	39828484	LOC728730	163928	39662056	39667056
NR_027237	chr7	+	150102839	150109558	LOC728743	6719	150100339	150105339
NR_024442	chr1	-	146490894	146514599	LOC728989	23705	146512099	146517099
NR_146579	chrX	-	3803315	3838783	LOC729162	35468	3836283	3841283
NR_109983	chr4	+	119512898	119556180	LOC729218	43282	119510398	119515398
NR_135244	chr2	-	202952277	202981781	LOC729224	29504	202979281	202984281
NR_109916	chr20	+	58662740	58676442	LOC729296	13702	58660240	58665240
NR_147836	chr11	+	134605838	134633705	LOC729305	27867	134603338	134608338
NR_003288	chr6	+	160514113	160517244	LOC729603	3131	160511613	160516613
NR_024440	chrX	-	20004934	20007897	LOC729609	2963	20005397	20010397
NR_135198	chr16	-	2514950	2518214	LOC729652	3264	2515714	2520714
NR_047662	chr8	-	12394587	12523120	LOC729732	128533	12520620	12525620
NR_039983	chr1	-	134772	140566	LOC729737	5794	138066	143066
NR_136624	chr10	-	81266125	81270738	LOC729815	4613	81268238	81273238
NR_123725	chr1	-	160171988	160178659	LOC729867	6671	160176159	160181159
NR_036575	chr19	-	18360759	18366229	LOC729966	5470	18363729	18368729
NR_033998	chr1	+	95393583	95428826	LOC729970	35243	95391083	95396083
NR_135237	chr2	+	51259738	52635055	LOC730100	1375317	51257238	51262238
NR_024403	chr6	+	52529198	52533951	LOC730101	4753	52526698	52531698
NR_037167	chr1	-	177975274	178007142	LOC730102	31868	178004642	178009642
NR_146388	chr7	+	45844827	45847509	LOC730234	2682	45842327	45847327
NR_134575	chr7	-	46727476	46736720	LOC730338	9244	46734220	46739220
NR_027240	chr22	+	46402495	46406657	LOC730668	4162	46399995	46404995
NM_001291904	chr17	+	18992773	19000876	LOC79999	8103	18990273	18995273
NR_026954	chr3	+	128226677	128229429	LOC90246	2752	128224177	128229177
NR_027107	chr4	-	183059812	183065668	LOC90768	5856	183063168	183068168
NR_026984	chr2	-	86247338	86250991	LOC90784	3653	86248491	86253491
NR_027003	chr19	+	46713498	46718094	LOC93429	4596	46710998	46715998
NR_135202	chr2	-	237957241	237964810	LOC93463	7569	237962310	237967310
NM_001276480	chr19	-	5691844	5720463	LONP1	28619	5717963	5722963
NM_001348078	chr16	+	48278077	48396910	LONP2	118833	48275577	48280577
NM_001329976	chr8	-	12579403	12612951	LONRF1	33548	12610451	12615451
NM_198461	chr2	-	100889752	100939195	LONRF2	49443	100936695	100941695
NR_110311	chrX	+	118108576	118152318	LONRF3	43742	118106076	118111076
NM_002317	chr5	-	121398889	121414196	LOX	15307	121411696	121416696
NM_144612	chr18	-	44057216	44236996	LOXHD1	179780	44234496	44239496
NM_005576	chr15	+	74218798	74244482	LOXL1	25684	74216298	74221298
NR_040069	chr15	-	74209808	74220589	LOXL1-AS1	10781	74218089	74223089
NM_002318	chr8	-	23154409	23261722	LOXL2	107313	23259222	23264222
NM_032603	chr2	-	74759385	74781122	LOXL3	21737	74778622	74783622
NM_032211	chr10	-	100007442	100028007	LOXL4	20565	100025507	100030507
NM_005577	chr6	-	160952514	161087407	LPA	134893	161084907	161089907
NR_028093	chr6	-	160887586	160932156	LPAL2	44570	160929656	160934656
NM_001351397	chr9	-	113635531	113801539	LPAR1	166008	113799039	113804039
NM_004720	chr19	-	19734465	19739039	LPAR2	4574	19736539	19741539
NM_012152	chr1	-	85279085	85358896	LPAR3	79811	85356396	85361396
NM_005296	chrX	+	78003205	78012578	LPAR4	9373	78000705	78005705
NM_020400	chr12	-	6728000	6745297	LPAR5	17297	6742797	6747797
NM_005767	chr13	-	48985181	49018840	LPAR6	33659	49016340	49021340
NM_024830	chr5	-	1461537	1524092	LPCAT1	62555	1521592	1526592
NM_017839	chr16	+	55542912	55620582	LPCAT2	77670	55540412	55545412
NM_005768	chr12	-	7085346	7125842	LPCAT3	40496	7123342	7128342
NM_153613	chr15	-	34651088	34659395	LPCAT4	8307	34656895	34661895
NM_014873	chr1	-	211916798	212004114	LPGAT1	87316	212001614	212006614
NM_001261428	chr2	+	11817669	11967533	LPIN1	149864	11815169	11820169
NM_014646	chr18	-	2916991	3011945	LPIN2	94954	3009445	3014445
NR_126051	chr20	+	39969492	39989225	LPIN3	19733	39966992	39971992
NM_000237	chr8	+	19796581	19824770	LPL	28189	19794081	19799081
NR_027647	chr17	+	56315786	56345879	LPO	30093	56313286	56318286
NM_001167672	chr3	+	187871660	188608460	LPP	736800	187869160	187874160
NR_046623	chr3	-	188280024	188286454	LPP-AS1	6430	188283954	188288954
NR_036497	chr3	-	187868993	187871876	LPP-AS2	2883	187869376	187874376
NM_001307951	chr11	-	58294343	58345712	LPXN	51369	58343212	58348212
NM_001301645	chr4	+	155661992	155674271	LRAT	12279	155659492	155664492
NM_006726	chr4	-	151185810	151936649	LRBA	750839	151934149	151939149
NM_001164213	chr13	+	47127295	47327175	LRCH1	199880	47124795	47129795
NM_020871	chrX	-	114345182	114468635	LRCH2	123453	114466135	114471135
NM_032773	chr3	+	197518096	197598456	LRCH3	80360	197515596	197520596
NM_001289934	chr7	-	100171633	100183811	LRCH4	12178	100181311	100186311
NM_001195520	chr12	-	133179735	133187037	LRCOL1	7302	133184537	133189537
NM_020862	chr19	-	39797456	39805976	LRFN1	8520	39803476	39808476
NM_020737	chr6	-	40359372	40555203	LRFN2	195831	40552703	40557703
NM_024509	chr19	+	36428021	36436097	LRFN3	8076	36425521	36430521
NM_024036	chr11	+	66624875	66627946	LRFN4	3071	66622375	66627375
NM_152447	chr14	+	42076058	42373752	LRFN5	297694	42073558	42078558
NM_052972	chr19	-	4537226	4540036	LRG1	2810	4537536	4542536
NM_144648	chr7	+	133812104	133949343	LRGUK	137239	133809604	133814604
NM_018372	chr1	-	111489811	111506566	LRIF1	16755	111504066	111509066
NM_015541	chr3	-	66429220	66550845	LRIG1	121625	66548345	66553345
NM_014813	chr1	+	113615791	113667824	LRIG2	52033	113613291	113618291
NM_153377	chr12	-	59265936	59314319	LRIG3	48383	59311819	59316819
NM_015613	chr10	-	85991275	86001217	LRIT1	9942	85998717	86003717
NM_001284223	chr10	-	85980248	85985345	LRIT2	5097	85982845	85987845
NM_198506	chr4	+	110769339	110793471	LRIT3	24132	110766839	110771839
NM_001305581	chr10	+	77191403	78317133	LRMDA	1125730	77188903	77193903
NM_001204127	chr12	+	25205180	25261269	LRMP	56089	25202680	25207680
NM_002332	chr12	+	57522281	57607125	LRP1	84844	57519781	57524781
NR_131938	chr12	-	57538402	57541402	LRP1-AS	3000	57538902	57543902
NM_001329226	chr14	+	23340925	23350920	LRP10	9995	23338425	23343425
NM_032832	chr6	-	150139893	150185480	LRP11	45587	150182980	150187980
NM_013437	chr8	-	105501458	105601252	LRP12	99794	105598752	105603752
NM_018557	chr2	-	140988995	142889270	LRP1B	1900275	142886770	142891770
NM_004525	chr2	-	169983618	170219122	LRP2	235504	170216622	170221622
NM_018409	chr4	-	186285031	186300152	LRP2BP	15121	186297652	186302652
NM_002333	chr19	+	33685598	33699773	LRP3	14175	33683098	33688098
NM_002334	chr11	-	46878267	46940173	LRP4	61906	46937673	46942673
NR_038909	chr11	+	46867961	46895967	LRP4-AS1	28006	46865461	46870461
NM_002335	chr11	+	68080076	68216743	LRP5	136667	68077576	68082576
NM_001135772	chr22	-	25747384	25777544	LRP5L	30160	25775044	25780044
NM_002336	chr12	-	12268960	12419811	LRP6	150851	12417311	12422311
NM_004631	chr1	-	53708040	53793821	LRP8	85781	53791321	53796321
NM_002337	chr4	-	3505323	3534224	LRPAP1	28901	3531724	3536724
NM_133259	chr2	-	44113362	44223144	LRPPRC	109782	44220644	44225644
NR_037793	chr14	+	50065414	50081390	LRR1	15976	50062914	50067914
NM_018214	chr6	+	53659777	53788919	LRRC1	129142	53657277	53662277
NM_201550	chr12	-	70002344	70004942	LRRC10	2598	70002442	70007442
NM_001272036	chr8	+	145743348	145750559	LRRC14	7211	145740848	145745848
NM_001080478	chr5	+	191625	196449	LRRC14B	4824	189125	194125
NM_001135057	chr3	-	194075975	194090472	LRRC15	14497	194087972	194092972
NM_001031692	chr7	+	102553343	102585556	LRRC17	32213	102550843	102555843
NM_001006939	chr10	-	50117528	50122280	LRRC18	4752	50119780	50124780
NM_022901	chr9	-	26993134	27005691	LRRC19	12557	27003191	27008191
NM_024512	chr3	-	46556877	46608040	LRRC2	51163	46605540	46610540
NR_103467	chr10	-	72058725	72142406	LRRC20	83681	72139906	72144906
NM_001135217	chr12	+	7013896	7023406	LRRC23	9510	7011396	7016396
NM_001024678	chr8	-	145747760	145752416	LRRC24	4656	145749916	145754916
NM_145256	chr19	-	18501953	18508415	LRRC25	6462	18505915	18510915
NM_030626	chr10	+	134145613	134195010	LRRC27	49397	134143113	134148113
NM_001321678	chr15	+	99791566	99930937	LRRC28	139371	99789066	99794066
NM_001004055	chr16	-	67241041	67260901	LRRC29	19860	67258401	67263401
NM_030891	chr21	+	45875368	45882079	LRRC3	6711	45872868	45877868
NR_047476	chr21	-	45870868	45875167	LRRC3-AS1	4299	45872667	45877667
NM_001277128	chr3	-	169557028	169587723	LRRC31	30695	169585223	169590223
NM_001128922	chr11	-	76368567	76381791	LRRC32	13224	76379291	76384291
NM_001172779	chr3	-	169511215	169530574	LRRC34	19359	169528074	169533074
NM_018296	chr16	+	67360746	67419109	LRRC36	58363	67358246	67363246
NM_014834	chr17_ctg5_hap1	-	415626	458604	LRRC37A	42978	456104	461104
NR_033753	chr17	+	37186158	37209458	LRRC37A11P	23300	37183658	37188658
NM_001006607	chr17_ctg5_hap1	-	197705	240669	LRRC37A2	42964	238169	243169
NM_001303255	chr17	-	62850251	62915609	LRRC37A3	65358	62913109	62918109
NR_002940	chr17_ctg5_hap1	-	197720	424115	LRRC37A4P	226395	421615	426615
NR_034087	chr9	-	114365110	114375833	LRRC37A5P	10723	114373333	114378333
NR_003525	chr10	-	27534781	27541235	LRRC37A6P	6454	27538735	27543735
NR_126038	chr17	-	34231223	34238027	LRRC37A8P	6804	34235527	34240527
NM_001321350	chr17	+	30334890	30380519	LRRC37B	45629	30332390	30337390
NM_001010847	chr1	-	13801444	13840242	LRRC38	38798	13837742	13842742
NM_001256386	chr1	-	100614003	100643829	LRRC39	29826	100641329	100646329
NM_052953	chr3	+	26664296	26752265	LRRC3B	87969	26661796	26666796
NM_001195545	chr17	+	38097726	38100987	LRRC3C	3261	38095226	38100226
NM_022143	chr7	-	127667123	127671002	LRRC4	3879	127668502	127673502
NM_017768	chr1	-	70610484	70671361	LRRC40	60877	70668861	70673861
NM_006369	chr1	-	46744071	46769038	LRRC41	24967	46766538	46771538
NM_001256409	chr1	+	54411998	54433841	LRRC42	21843	54409498	54414498
NM_152759	chr12	+	122652265	122688018	LRRC43	35753	122649765	122654765
NM_144999	chr17	+	79981177	79989027	LRRC45	7850	79978677	79983677
NM_033413	chr17	+	45908992	45915079	LRRC46	6087	45906492	45911492
NM_020710	chr1	-	3696783	3713068	LRRC47	16285	3710568	3715568
NM_001284357	chr15	+	71145577	71342436	LRRC49	196859	71143077	71148077
NM_001080457	chr19	-	51020149	51071302	LRRC4B	51153	51068802	51073802
NM_020929	chr11	-	40135750	41481186	LRRC4C	1345436	41478686	41483686
NM_001005214	chr1	+	165513477	165533185	LRRC52	19708	165510977	165515977
NM_001005210	chr11	+	56949220	56959188	LRRC55	9968	56946720	56951720
NM_198075	chr11	+	537521	554916	LRRC56	17395	535021	540021
NM_153260	chr15	-	42834719	42841002	LRRC57	6283	42838502	42843502
NM_001099678	chr3	-	120043575	120068186	LRRC58	24611	120065686	120070686
NM_018509	chr17	-	48458593	48474914	LRRC59	16321	48472414	48477414
NM_001321962	chr8	-	133582666	133687863	LRRC6	105197	133685363	133690363
NM_001142928	chr7	+	150020295	150035245	LRRC61	14950	150017795	150022795
NM_001282460	chr13	+	46786077	46850938	LRRC63	64861	46783577	46788577
NM_001024611	chr4	-	52859807	52883786	LRRC66	23979	52881286	52886286
NM_001129890	chr8	+	92114846	92231464	LRRC69	116618	92112346	92117346
NM_001330635	chr1	+	70032867	70589171	LRRC7	556304	70030367	70035367
NM_181506	chr5	+	61874561	61877275	LRRC70	2714	61872061	61877061
NM_144702	chr1	+	156890423	156902880	LRRC71	12457	156887923	156892923
NM_001195280	chr7	+	16566504	16621114	LRRC72	54610	16564004	16569004
NM_001271882	chr6	-	43474702	43478081	LRRC73	3379	43475581	43480581
NM_194287	chr14	+	77292724	77336645	LRRC74A	43921	77290224	77295224
NM_001291006	chr22	+	21400248	21418457	LRRC74B	18209	21397748	21402748
NM_001113567	chr17	-	16345318	16395505	LRRC75A	50187	16393005	16398005
NR_027175	chr17	+	16342300	16373962	LRRC75A-AS1	31662	16339800	16344800
NM_207644	chr22	-	24981590	24989035	LRRC75B	7445	24986535	24991535
NR_033843	chr3	+	167613735	167641797	LRRC77P	28062	167611235	167616235
NM_001127245	chr9	+	131644390	131680317	LRRC8A	35927	131641890	131646890
NM_001134476	chr1	+	89990396	90063420	LRRC8B	73024	89987896	89992896
NM_032270	chr1	+	90098643	90185094	LRRC8C	86451	90096143	90101143
NM_001134479	chr1	+	90286572	90401989	LRRC8D	115417	90284072	90289072
NM_001268285	chr19	+	7953389	7966908	LRRC8E	13519	7950889	7955889
NR_075071	chr14	+	60386430	60530277	LRRC9	143847	60383930	60388930
NM_033402	chr8	+	86019322	86058314	LRRCC1	38992	86016822	86021822
NM_001161528	chr7	-	91774197	91794590	LRRD1	20393	91792090	91797090
NM_001137550	chr2	+	238536223	238690290	LRRFIP1	154067	238533723	238538723
NM_001134369	chr3	-	37094116	37217851	LRRFIP2	123735	37215351	37220351
NM_001079910	chr12	+	85430098	85638883	LRRIQ1	208785	85427598	85432598
NM_001322315	chr1	-	74491701	74663871	LRRIQ3	172170	74661371	74666371
NM_001080460	chr3	+	169539678	169555560	LRRIQ4	15882	169537178	169542178
NM_024652	chr15	+	101459419	101613094	LRRK1	153675	101456919	101461919
NM_198578	chr12	+	40618812	40763086	LRRK2	144274	40616312	40621312
NM_001324189	chr3	+	3841114	3891518	LRRN1	50404	3838614	3843614
NM_201630	chr1	-	204586302	204654597	LRRN2	68295	204652097	204657097
NM_018334	chr7	+	110731061	110765509	LRRN3	34448	110728561	110733561
NM_152611	chr20	-	6021191	6034726	LRRN4	13535	6032226	6037226
NM_203422	chr11	-	62453873	62457371	LRRN4CL	3498	62454871	62459871
NM_015564	chr5	-	138205078	138211057	LRRTM2	5979	138208557	138213557
NM_178011	chr10	+	68685791	68861309	LRRTM3	175518	68683291	68688291
NM_001282924	chr2	-	76974849	77749559	LRRTM4	774710	77747059	77752059
NM_138361	chr9	+	130213764	130265780	LRSAM1	52016	130211264	130216264
NM_001304389	chr3	-	54952380	55001115	LRTM1	48735	54998615	55003615
NM_001039029	chr12	+	1929432	1945918	LRTM2	16486	1926932	1931932
NM_001145308	chr11	+	71791376	71821828	LRTOMT	30452	71788876	71793876
NM_152892	chr7	+	102105329	102113615	LRWD1	8286	102102829	102107829
NM_002338	chr3	-	115521209	116164385	LSAMP	643176	116161885	116166885
NR_109998	chr3	+	116078870	116088932	LSAMP-AS1	10062	116076370	116081370
NM_018385	chr3	-	194361516	194393206	LSG1	31690	194390706	194395706
NR_145480	chr5	+	2712704	2715351	LSINCT5	2647	2710204	2715204
NR_045492	chr8	-	38020838	38034248	LSM1	13410	38031748	38036748
NM_032881	chr1	-	36859020	36863560	LSM10	4540	36861060	36866060
NM_173491	chr5	+	157170702	157187717	LSM11	17015	157168202	157173202
NM_152344	chr17	-	42112002	42144987	LSM12	32985	42142487	42147487
NM_001114093	chr19	+	34663351	34720420	LSM14A	57069	34660851	34665851
NM_144703	chr20	+	60697516	60710434	LSM14B	12918	60695016	60700016
NM_021177	chr6_cox_hap2	-	3274736	3284332	LSM2	9596	3281832	3286832
NM_014463	chr3	+	14220227	14239869	LSM3	19642	14217727	14222727
NM_012321	chr19	-	18417039	18434001	LSM4	16962	18431501	18436501
NM_001130710	chr7	-	32524944	32534870	LSM5	9926	32532370	32537370
NM_007080	chr4	+	147096834	147111213	LSM6	14379	147094334	147099334
NM_016199	chr19	-	2321519	2328614	LSM7	7095	2326114	2331114
NM_016200	chr7	+	117824085	117844093	LSM8	20008	117821585	117826585
NM_001134468	chr7	+	112120907	112130943	LSMEM1	10036	112118407	112123407
NM_153215	chr3	+	50316457	50325545	LSMEM2	9088	50313957	50318957
NM_002339	chr11	+	1874199	1913493	LSP1	39294	1871699	1876699
NM_001260490	chr19	+	35739558	35758867	LSR	19309	35737058	35742058
NM_001001438	chr21	-	47608359	47648738	LSS	40379	47646238	47651238
NR_029462	chr6_dbb_hap3	+	2839498	2842231	LST1	2733	2836998	2841998
NM_001256644	chr12	-	96394530	96437298	LTA4H	42768	96434798	96439798
NM_001143919	chr14	+	24780704	24787242	LTB4R	6538	24778204	24783204
NM_206943	chr2	+	33172368	33624575	LTBP1	452207	33169868	33174868
NM_000428	chr14	-	74964885	75079034	LTBP2	114149	75076534	75081534
NM_021070	chr11	-	65306029	65325699	LTBP3	19670	65323199	65328199
NM_003573	chr19	+	41099071	41135725	LTBP4	36654	41096571	41101571
NM_001270987	chr12	+	6484533	6500737	LTBR	16204	6482033	6487033
NM_145867	chr5	+	179220985	179223513	LTC4S	2528	179218485	179223485
NM_001321122	chr3	-	46477495	46526724	LTF	49229	46524224	46529224
NM_206961	chr15	-	41795839	41806085	LTK	10246	41803585	41808585
NM_001320766	chr21	-	30300466	30365280	LTN1	64814	30362780	30367780
NM_001329953	chr6	+	144164409	144184949	LTV1	20540	144161909	144166909
NR_132442	chr6	+	147480060	147502128	LUADT1	22068	147477560	147482560
NR_038276	chr7	-	43548326	43562141	LUARIS	13815	43559641	43564641
NM_001320226	chr16	-	238967	279481	LUC7L	40514	276981	281981
NM_001244585	chr7	+	139025104	139108203	LUC7L2	83099	139022604	139027604
NM_001330330	chr17	+	48796904	48833574	LUC7L3	36670	48794404	48799404
NR_103548	chr5	-	90598802	90610219	LUCAT1	11417	90607719	90612719
NM_002345	chr12	-	91497231	91505542	LUM	8311	91503042	91508042
NR_126487	chr15	+	99557932	99574275	LUNAR1	16343	99555432	99560432
NM_001013615	chr1	+	46669005	46686928	LURAP1	17923	46666505	46671505
NM_203403	chr9	+	12775011	12823059	LURAP1L	48048	12772511	12777511
NR_125775	chr9	-	12699998	12814388	LURAP1L-AS1	114390	12811888	12816888
NM_001142546	chr1	-	23410515	23495351	LUZP1	84836	23492851	23497851
NM_001252010	chr11	+	24518515	25104186	LUZP2	585671	24516015	24521015
NM_001318840	chrX	+	114524282	114542123	LUZP4	17841	114521782	114526782
NM_001128619	chr7	-	135611502	135662204	LUZP6	50702	135659704	135664704
NM_173800	chr5	+	115298150	115363299	LVRN	65149	115295650	115300650
NM_020169	chr3	-	158384202	158390482	LXN	6280	158387982	158392982
NM_001127213	chr8	+	144099901	144103827	LY6E	3926	144097401	144102401
NM_025262	chr6_dbb_hap3	-	2930040	2933731	LY6G5C	3691	2931231	2936231
NM_025261	chr6	-	31686424	31689511	LY6G6C	3087	31687011	31692011
NM_001003693	chr6_mann_hap4	+	3017531	3021351	LY6G6F	3820	3015031	3020031
NM_001353334	chr6_ssto_hap7	+	3005458	3016431	LY6G6F-LY6G6D	10973	3002958	3007958
NM_001130478	chr8	-	144239330	144242053	LY6H	2723	144239553	144244553
NM_001160354	chr8	+	143781528	143785584	LY6K	4056	143779028	143784028
NM_002349	chr2	-	160659867	160761267	LY75	101400	160758767	160763767
NM_001198759	chr2	-	160625138	160761267	LY75-CD302	136129	160758767	160763767
NM_004271	chr6	+	6588933	6655216	LY86	66283	6586433	6591433
NR_026970	chr6	-	6346697	6623059	LY86-AS1	276362	6620559	6625559
NM_001261456	chr1	+	160765863	160798045	LY9	32182	160763363	160768363
NM_001195797	chr8	+	74903563	74941307	LY96	37744	74901063	74906063
NM_017816	chr4	-	4269428	4291896	LYAR	22468	4289396	4294396
NM_174898	chr2	-	99900700	99917639	LYG1	16939	99915139	99920139
NM_175735	chr2	-	99858710	99871570	LYG2	12860	99869070	99874070
NM_005583	chr19	-	13209841	13213974	LYL1	4133	13211474	13216474
NM_002350	chr8	+	56792385	56925006	LYN	132621	56789885	56794885
NM_023946	chr8	-	143845751	143859264	LYNX1	13513	143856764	143861764
NM_001077427	chr2	-	133400852	133429152	LYPD1	28300	133426652	133431652
NM_014400	chr19	-	43964945	43969831	LYPD3	4886	43967331	43972331
NM_173506	chr19	-	42341147	42348736	LYPD4	7589	42346236	42351236
NM_182573	chr19	-	44300078	44324808	LYPD5	24730	44322308	44327308
NM_001195685	chr2	+	150186498	150330659	LYPD6	144161	150183998	150188998
NM_177964	chr2	+	149894980	150071772	LYPD6B	176792	149892480	149897480
NM_001279357	chr8	-	54958926	55014577	LYPLA1	55651	55012077	55017077
NM_007260	chr1	+	24117645	24122029	LYPLA2	4384	24115145	24120145
NM_001300769	chr1	+	219347172	219386207	LYPLAL1	39035	219344672	219349672
NR_038845	chr1	-	219254316	219347130	LYPLAL1-AS1	92814	219344630	219349630
NM_020424	chr16	+	20911189	20936331	LYRM1	25142	20908689	20913689
NM_020466	chr6	-	90341942	90348474	LYRM2	6532	90345974	90350974
NM_001318783	chr6	-	5068560	5261183	LYRM4	192623	5258683	5263683
NR_126015	chr6	+	5004049	5240729	LYRM4-AS1	236680	5001549	5006549
NM_181705	chr5	+	130506606	130541119	LYRM7	34513	130504106	130509106
NM_001076680	chr17	-	26205339	26220409	LYRM9	15070	26217909	26222909
NM_001136543	chr1	-	151132223	151138424	LYSMD1	6201	151135924	151140924
NM_001143917	chr15	-	52015260	52043650	LYSMD2	28390	52041150	52046150
NM_001286812	chr5	-	89811444	89825401	LYSMD3	13957	89822901	89827901
NM_001284422	chr15	-	100267605	100273649	LYSMD4	6044	100271149	100276149
NM_001301365	chr1	-	235824330	236047008	LYST	222678	236044508	236049508
NM_006691	chr11	-	10579412	10590365	LYVE1	10953	10587865	10592865
NM_000239	chr12	+	69742133	69748013	LYZ	5880	69739633	69744633
NM_032517	chr10	+	29577989	29600158	LYZL1	22169	29575489	29580489
NM_183058	chr10	-	30900707	30918647	LYZL2	17940	30916147	30921147
NM_144634	chr3	-	42438569	42452094	LYZL4	13525	42449594	42454594
NM_020426	chr17	-	34261521	34270714	LYZL6	9193	34268214	34273214
NM_001316975	chr1	-	9982170	10003485	LZIC	21315	10000985	10005985
NM_001276379	chr3	-	45864809	45957216	LZTFL1	92407	45954716	45959716
NM_006767	chr22	+	21336557	21353326	LZTR1	16769	21334057	21339057
NM_021020	chr8	-	20103675	20112803	LZTS1	9128	20110303	20115303
NR_047509	chr8	+	20133283	20147969	LZTS1-AS1	14686	20130783	20135783
NM_032429	chr10	+	102756822	102767593	LZTS2	10771	102754322	102759322
NM_001282533	chr20	-	3143262	3154238	LZTS3	10976	3151738	3156738
NM_001281296	chr2	-	74785009	74875465	M1AP	90456	74872965	74877965
NM_002355	chr12	-	9092956	9102357	M6PR	9401	9099857	9104857
NM_001320317	chr3	+	119421868	119485949	MAATS1	64081	119419368	119424368
NM_005584	chr13	-	36047925	36050832	MAB21L1	2907	36048332	36053332
NM_006439	chr4	+	151503076	151505845	MAB21L2	2769	151500576	151505576
NM_152367	chr1	+	116654375	116677861	MAB21L3	23486	116651875	116656875
NM_182762	chr7	-	20174278	20257013	MACC1	82735	20254513	20259513
NR_046756	chr7	+	20181538	20193154	MACC1-AS1	11616	20179038	20184038
NM_012090	chr1	+	39549838	39952810	MACF1	402972	39547338	39552338
NM_014067	chr11	-	63766029	63933585	MACROD1	167556	63931085	63936085
NM_080676	chr20	+	13976145	16033841	MACROD2	2057696	13973645	13978645
NR_037841	chr20	-	14864898	14910164	MACROD2-AS1	45266	14907664	14912664
NR_104193	chr20	+	14535029	14609554	MACROD2-IT1	74525	14532529	14537529
NM_003550	chr7	-	1855427	2272583	MAD1L1	417156	2270083	2275083
NM_002358	chr4	-	120980578	120988013	MAD2L1	7435	120985513	120990513
NM_001003690	chr6	+	43597278	43608688	MAD2L1BP	11410	43594778	43599778
NM_001127325	chr1	-	11734536	11751678	MAD2L2	17142	11749178	11754178
NM_130762	chr19	+	496489	505343	MADCAM1	8854	493989	498989
NM_130470	chr11	+	47290926	47351582	MADD	60656	47288426	47293426
NR_123716	chr4	+	1283638	1333936	MAEA	50298	1281138	1286138
NM_001286378	chr1	+	166944818	166991449	MAEL	46631	166942318	166947318
NM_001031804	chr16	-	79627744	79634622	MAF	6878	79632122	79637122
NM_032272	chr8	+	145159304	145162515	MAF1	3211	145156804	145161804
NM_005461	chr20	-	39314487	39317880	MAFB	3393	39315380	39320380
NM_001161574	chr22	+	38597938	38612517	MAFF	14579	38595438	38600438
NM_002359	chr17	-	79876144	79885587	MAFG	9443	79883087	79888087
NR_015454	chr17	+	79885704	79888629	MAFG-AS1	2925	79883204	79888204
NR_046439	chr4_gl000194_random	-	53588	115073	MAFIP	61485	112573	117573
NM_002360	chr7	+	1570367	1582679	MAFK	12312	1567867	1572867
NR_104663	chr16	-	79755208	79804429	MAFTRR	49221	79801929	79806929
NM_001199216	chr19	+	35782988	35804709	MAG	21721	35780488	35785488
NM_004988	chrX	-	152481521	152486116	MAGEA1	4595	152483616	152488616
NM_001011543	chrX	-	151301782	151307050	MAGEA10	5268	151304550	151309550
NM_001204811	chrX	-	151282520	151307050	MAGEA10-MAGEA5	24530	151304550	151309550
NM_001011544	chrX	+	148769902	148798928	MAGEA11	29026	148767402	148772402
NM_001166387	chrX	-	151899292	151903184	MAGEA12	3892	151900684	151905684
NM_001282501	chrX	+	151883074	151887096	MAGEA2	4022	151880574	151885574
NM_001321404	chrX	+	151883074	151887096	MAGEA2B	4022	151880574	151885574
NM_005362	chrX	-	151934651	151938240	MAGEA3	3589	151935740	151940740
NM_001011548	chrX	+	151081360	151093642	MAGEA4	12282	151078860	151083860
NM_021049	chrX	-	151282520	151286411	MAGEA5	3891	151283911	151288911
NM_005363	chrX	+	151867231	151870825	MAGEA6	3594	151864731	151869731
NM_001166400	chrX	+	149009940	149014609	MAGEA8	4669	149007440	149012440
NR_102703	chrX	-	149007562	149025779	MAGEA8-AS1	18217	149023279	149028279
NM_005365	chrX	-	148663308	148669109	MAGEA9	5801	148666609	148671609
NM_001080790	chrX	-	148663308	148669116	MAGEA9B	5808	148666616	148671616
NM_177415	chrX	+	30261847	30270155	MAGEB1	8308	30259347	30264347
NM_182506	chrX	+	27826106	27841131	MAGEB10	15025	27823606	27828606
NM_001099921	chrX	+	35816458	35821852	MAGEB16	5394	35813958	35818958
NM_001277307	chrX	+	16185603	16189516	MAGEB17	3913	16183103	16188103
NM_002364	chrX	+	30233674	30238206	MAGEB2	4532	30231174	30236174
NM_002365	chrX	+	30248552	30255610	MAGEB3	7058	30246052	30251052
NM_173523	chrX	+	26210556	26213763	MAGEB6	3207	26208056	26213056
NM_005462	chrX	+	140991641	140997187	MAGEC1	5546	140989141	140994141
NM_016249	chrX	-	141290127	141293076	MAGEC2	2949	141290576	141295576
NM_138702	chrX	+	140926101	140985618	MAGEC3	59517	140923601	140928601
NM_001005332	chrX	+	51546154	51645450	MAGED1	99296	51543654	51548654
NM_177433	chrX	+	54834031	54842448	MAGED2	8417	54831531	54836531
NM_001272063	chrX	+	51927918	51935366	MAGED4	7448	51925418	51930418
NM_177537	chrX	-	51804922	51812368	MAGED4B	7446	51809868	51814868
NM_020932	chrX	+	75648045	75651746	MAGEE1	3701	75645545	75650545
NM_019066	chr15	-	23888695	23892993	MAGEL2	4298	23890493	23895493
NM_001033057	chr3	-	65339905	66024509	MAGI1	684604	66022009	66027009
NR_046575	chr3	+	65879490	65910972	MAGI1-AS1	31482	65876990	65881990
NR_145422	chr3	-	65858488	65940233	MAGI1-IT1	81745	65937733	65942733
NM_012301	chr7	-	77646373	79082890	MAGI2	1436517	79080390	79085390
NR_046689	chr7	+	78638303	78641593	MAGI2-AS2	3290	78635803	78640803
NR_038346	chr7	+	79082272	79100524	MAGI2-AS3	18252	79079772	79084772
NM_001142782	chr1	+	113933474	114228545	MAGI3	295071	113930974	113935974
NM_001099681	chrX	+	49019180	49024495	MAGIX	5315	49016680	49021680
NM_002370	chr1	-	53692563	53704282	MAGOH	11719	53701782	53706782
NM_018048	chr12	-	10756788	10766208	MAGOHB	9420	10763708	10768708
NM_032121	chrX	-	77081861	77151065	MAGT1	69204	77148565	77153565
NM_024520	chr2	+	200820039	200828847	MAIP1	8808	200817539	200822539
NM_001318808	chr11	-	64705701	64739563	MAJIN	33862	64737063	64742063
NR_134935	chr6	-	10762955	10838788	MAK	75833	10836288	10841288
NM_032509	chr8	+	33342684	33358778	MAK16	16094	33340184	33345184
NM_022439	chr2	+	95691399	95719737	MAL	28338	95688899	95693899
NM_052886	chr8	+	120220609	120257914	MAL2	37305	120218109	120223109
NR_002819	chr11	+	65265208	65273983	MALAT1	8775	65262708	65267708
NM_005434	chr2	-	110841446	110874143	MALL	32697	110871643	110876643
NM_001142308	chr10	+	19337699	20023407	MALRD1	685708	19335199	19340199
NM_138446	chr7	+	23338939	23349180	MALSU1	10241	23336439	23341439
NM_173844	chr18	+	56338617	56417371	MALT1	78754	56336117	56341117
NM_153267	chr9	+	72658496	72841888	MAMDC2	183392	72655996	72660996
NR_040076	chr9	-	72768049	72790804	MAMDC2-AS1	22755	72788304	72793304
NM_206920	chr9	+	139746818	139755251	MAMDC4	8433	139744318	139749318
NM_014757	chr5	+	179159850	179204287	MAML1	44437	179157350	179162350
NM_032427	chr11	-	95709756	96076344	MAML2	366588	96073844	96078844
NM_018717	chr4	-	140637545	141075233	MAML3	437688	141072733	141077733
NM_001177465	chrX	+	149531544	149682448	MAMLD1	150904	149529044	149534044
NM_001130915	chr19	-	49216254	49222976	MAMSTR	6722	49220476	49225476
NM_005907	chr6	-	119498365	119670931	MAN1A1	172566	119668431	119673431
NM_006699	chr1	+	117910084	118068320	MAN1A2	158236	117907584	117912584
NR_045720	chr9	+	139981378	140003639	MAN1B1	22261	139978878	139983878
NM_001289010	chr1	+	25943958	26112698	MAN1C1	168740	25941458	25946458
NM_002372	chr5	+	109025066	109205326	MAN2A1	180260	109022566	109027566
NM_001320977	chr15	+	91445447	91465815	MAN2A2	20368	91442947	91447947
NM_001173498	chr19	-	12757321	12777591	MAN2B1	20270	12775091	12780091
NM_001292038	chr4	+	6576900	6624131	MAN2B2	47231	6574400	6579400
NM_006715	chr15	-	75648132	75660968	MAN2C1	12836	75658468	75663468
NM_005908	chr4	-	103552642	103682151	MANBA	129509	103679651	103684651
NM_022077	chr20	+	35918050	35945663	MANBAL	27613	35915550	35920550
NM_024641	chr6	+	96025372	96057328	MANEA	31956	96022872	96027872
NR_104136	chr6	-	96007971	96025327	MANEA-AS1	17356	96022827	96027827
NM_001113482	chr1	+	38259773	38267278	MANEAL	7505	38257273	38262273
NM_006010	chr3	+	51422667	51426828	MANF	4161	51420167	51425167
NM_018050	chr12	-	12482217	12503169	MANSC1	20952	12500669	12505669
NM_001146221	chr12	-	27915598	27924209	MANSC4	8611	27921709	27926709
NM_000240	chrX	+	43514154	43606071	MAOA	91917	43511654	43516654
NM_000898	chrX	-	43625856	43741721	MAOB	115865	43739221	43744221
NM_019090	chr1	+	232940637	232946092	MAP10	5455	232938137	232943137
NM_002373	chr15	+	43809805	43823818	MAP1A	14013	43807305	43812305
NM_005909	chr5	+	71403094	71505397	MAP1B	102303	71400594	71405594
NM_181509	chr20	+	33134687	33148149	MAP1LC3A	13462	33132187	33137187
NM_022818	chr16	+	87425800	87438380	MAP1LC3B	12580	87423300	87428300
NM_001085481	chr12	+	116997185	117014425	MAP1LC3B2	17240	116994685	116999685
NM_001004343	chr1	-	242158791	242162385	MAP1LC3C	3594	242159885	242164885
NM_018174	chr19	+	17830260	17845324	MAP1S	15064	17827760	17832760
NM_001039538	chr2	+	210288770	210598834	MAP2	310064	210286270	210291270
NM_002755	chr15	+	66679210	66783882	MAP2K1	104672	66676710	66681710
NM_030662	chr19	-	4090319	4124126	MAP2K2	33807	4121626	4126626
NM_145109	chr17	+	21187967	21218551	MAP2K3	30584	21185467	21190467
NM_003010	chr17	+	11924134	12047148	MAP2K4	123014	11921634	11926634
NR_029423	chrX	-	72744110	72782921	MAP2K4P1	38811	72780421	72785421
NM_002757	chr15	+	67835020	68099455	MAP2K5	264435	67832520	67837520
NM_002758	chr17	+	67410837	67538470	MAP2K6	127633	67408337	67413337
NM_145185	chr19	+	7968664	7979368	MAP2K7	10704	7966164	7971164
NM_005921	chr5	+	56110899	56191978	MAP3K1	81079	56108399	56113399
NM_002446	chr19	+	40697650	40721482	MAP3K10	23832	40695150	40700150
NM_002419	chr11	-	65365225	65381720	MAP3K11	16495	65379220	65384220
NM_006301	chr12	-	53874275	53893444	MAP3K12	19169	53890944	53895944
NM_001242317	chr3	+	185000728	185206882	MAP3K13	206154	184998228	185003228
NM_003954	chr17	-	43340485	43394430	MAP3K14	53945	43391930	43396930
NR_110326	chr17	+	43325291	43345997	MAP3K14-AS1	20706	43322791	43327791
NM_001001671	chrX	-	19378175	19533379	MAP3K15	155204	19530879	19535879
NM_001018044	chr2	-	135722060	135782248	MAP3K19	60188	135779748	135784748
NM_006609	chr2	-	128056244	128100805	MAP3K2	44561	128098305	128103305
NM_016653	chr2	+	173940564	174132737	MAP3K20	192173	173938064	173943064
NR_033882	chr2	-	174062440	174146764	MAP3K20-AS1	84324	174144264	174149264
NM_032435	chr1	+	233463513	233520894	MAP3K21	57381	233461013	233466013
NM_001330431	chr17	+	61699784	61773670	MAP3K3	73886	61697284	61702284
NM_001291958	chr6	+	161412758	161538417	MAP3K4	125659	161410258	161415258
NM_005923	chr6	-	136878186	137113656	MAP3K5	235470	137111156	137116156
NM_001297609	chr1	-	27681669	27693357	MAP3K6	11688	27690857	27695857
NM_145332	chr6	-	91223291	91297020	MAP3K7	73729	91294520	91299520
NM_020152	chr21	+	30449791	30548210	MAP3K7CL	98419	30447291	30452291
NM_005204	chr10	+	30722949	30750762	MAP3K8	27813	30720449	30725449
NM_001284230	chr14	-	71189242	71275888	MAP3K9	86646	71273388	71278388
NM_002375	chr3	-	47892179	48130769	MAP4	238590	48128269	48133269
NM_007181	chr19	-	39078279	39108675	MAP4K1	30396	39106175	39111175
NM_004579	chr11	-	64556572	64570726	MAP4K2	14154	64568226	64573226
NM_001270425	chr2	-	39476406	39664453	MAP4K3	188047	39661953	39666953
NM_004834	chr2	+	102314164	102511152	MAP4K4	196988	102311664	102316664
NM_006575	chr14	-	50885210	50999376	MAP4K5	114166	50996876	51001876
NM_033063	chr11	-	75297962	75379479	MAP6	81517	75376979	75381979
NM_024871	chr3	-	183533663	183543393	MAP6D1	9730	183540893	183545893
NM_003980	chr6	-	136663418	136871957	MAP7	208539	136869457	136874457
NM_018067	chr1	+	36621565	36646451	MAP7D1	24886	36619065	36624065
NM_152780	chrX	-	20024830	20135114	MAP7D2	110284	20132614	20137614
NM_001173516	chrX	-	135298973	135338641	MAP7D3	39668	135336141	135341141
NM_001039580	chr4	-	156263811	156298122	MAP9	34311	156295622	156300622
NM_002745	chr22	-	22113946	22221970	MAPK1	108024	22219470	22224470
NM_002753	chr4	-	86933448	87374283	MAPK10	440835	87371783	87376783
NR_110887	chr22	-	50702141	50708822	MAPK11	6681	50706322	50711322
NM_001303252	chr22	-	50691329	50700239	MAPK12	8910	50697739	50702739
NM_002754	chr6	+	36098260	36112301	MAPK13	14041	36095760	36100760
NM_139014	chr6	+	35995453	36079013	MAPK14	83560	35992953	35997953
NM_139021	chr8	+	144798506	144804633	MAPK15	6127	144796006	144801006
NM_144578	chr14	+	55518361	55536912	MAPK1IP1L	18551	55515861	55520861
NM_001109891	chr16	-	30125425	30134630	MAPK3	9205	30132130	30137130
NM_001292039	chr18	+	48086483	48258196	MAPK4	171713	48083983	48088983
NM_002748	chr15	+	52311410	52358462	MAPK6	47052	52308910	52313910
NM_139032	chr17	+	19281033	19286857	MAPK7	5824	19278533	19283533
NM_001323329	chr10	+	49514681	49647402	MAPK8	132721	49512181	49517181
NM_005456	chr11	+	45907046	45928016	MAPK8IP1	20970	45904546	45909546
NM_012324	chr22	+	51039113	51052409	MAPK8IP2	13296	51036613	51041613
NM_001318852	chr16	+	1756183	1820318	MAPK8IP3	64135	1753683	1758683
NM_139068	chr5	-	179660594	179719071	MAPK9	58477	179716571	179721571
NM_024117	chr9	-	128199672	128469513	MAPKAP1	269841	128467013	128472013
NM_032960	chr1	+	206858364	206907630	MAPKAPK2	49266	206855864	206860864
NM_001243926	chr3	+	50649292	50686728	MAPKAPK3	37436	50646792	50651792
NM_003668	chr12	+	112280031	112331228	MAPKAPK5	51197	112277531	112282531
NR_015404	chr12	-	112277572	112280706	MAPKAPK5-AS1	3134	112278206	112283206
NR_049761	chr15	+	42066631	42120053	MAPKBP1	53422	42064131	42069131
NM_012325	chr20	+	31407698	31438211	MAPRE1	30513	31405198	31410198
NM_001143826	chr18	+	32556891	32723432	MAPRE2	166541	32554391	32559391
NM_012326	chr2	+	27193238	27250087	MAPRE3	56849	27190738	27195738
NM_005910	chr17	+	43971747	44105699	MAPT	133952	43969247	43974247
NR_024559	chr17	-	43920721	43972879	MAPT-AS1	52158	43970379	43975379
NR_024560	chr17	+	43973148	43976164	MAPT-IT1	3016	43970648	43975648
NM_022746	chr1	+	220960038	220987741	MARC1	27703	220957538	220962538
NM_001317338	chr1	+	220921587	220958157	MARC2	36570	220919087	220924087
NM_001166373	chr4	-	164445449	165304407	MARCH1	858958	165301907	165306907
NM_152598	chr17	-	60778674	60885742	MARCH10	107068	60883242	60888242
NM_001102562	chr5	-	16067414	16179897	MARCH11	112483	16177397	16182397
NM_016496	chr19	+	8478186	8503899	MARCH2	25713	8475686	8480686
NM_178450	chr5	-	126203405	126366500	MARCH3	163095	126364e3	126369e3
NM_020814	chr2	-	217122584	217236750	MARCH4	114166	217234250	217239250
NM_017824	chr10	+	94050919	94113721	MARCH5	62802	94048419	94053419
NM_001270660	chr5	+	10353750	10440500	MARCH6	86750	10351250	10356250
NM_022826	chr2	+	160568967	160625094	MARCH7	56127	160566467	160571467
NM_145021	chr10	-	45950032	46090354	MARCH8	140322	46087854	46092854
NM_138396	chr12	+	58148880	58154193	MARCH9	5313	58146380	58151380
NM_002356	chr6	+	114178513	114184652	MARCKS	6139	114176013	114181013
NM_006770	chr2	+	119699744	119752236	MARCO	52492	119697244	119702244
NM_001184999	chr16	-	15688225	15737023	MARF1	48798	15734523	15739523
NM_018650	chr1	+	220701524	220837799	MARK1	136275	220699024	220704024
NM_004954	chr11	+	63606399	63678492	MARK2	72093	63603899	63608899
NM_001128918	chr14	+	103851700	103970166	MARK3	118466	103849200	103854200
NM_001199867	chr19	+	45754515	45808541	MARK4	54026	45752015	45757015
NM_004990	chr12	+	57881735	57910438	MARS	28703	57879235	57884235
NM_138395	chr2	+	198570027	198573114	MARS2	3087	198567527	198572527
NM_031484	chr10	+	99473464	99477909	MARVELD1	4445	99470964	99475964
NM_001038603	chr5	+	68710938	68737890	MARVELD2	26952	68708438	68713438
NM_001271329	chr16	+	71660055	71675868	MARVELD3	15813	71657555	71662555
NM_001879	chr3	-	186933872	187009810	MASP1	75938	187007310	187012310
NM_006610	chr1	-	11086579	11107296	MASP2	20717	11104796	11109796
NM_014975	chr19	+	12949258	12985766	MAST1	36508	12946758	12951758
NM_001324320	chr1	+	46269278	46501796	MAST2	232518	46266778	46271778
NM_015016	chr19	+	18208602	18262499	MAST3	53897	18206102	18211102
NM_001164664	chr5	+	65892175	66465423	MAST4	573248	65889675	65894675
NR_111908	chr5	-	66297445	66299982	MAST4-AS1	2537	66297482	66302482
NM_032844	chr10	+	27443752	27476882	MASTL	33130	27441252	27446252
NM_000429	chr10	-	82031575	82049434	MAT1A	17859	82046934	82051934
NM_005911	chr2	+	85766100	85772403	MAT2A	6303	85763600	85768600
NM_182796	chr5	+	162930069	162946359	MAT2B	16290	162927569	162932569
NM_002378	chr19	-	3777966	3801810	MATK	23844	3799310	3804310
NM_002379	chr1	-	31184123	31196432	MATN1	12309	31193932	31198932
NR_034182	chr1	+	31191618	31199593	MATN1-AS1	7975	31189118	31194118
NM_002380	chr8	+	98881248	99048946	MATN2	167698	98878748	98883748
NM_002381	chr2	-	20191812	20212455	MATN3	20643	20209955	20214955
NM_003833	chr20	-	43922085	43937169	MATN4	15084	43934669	43939669
NM_199189	chr5	+	138609440	138667366	MATR3	57926	138606940	138611940
NM_015329	chr19	+	19431629	19469563	MAU2	37934	19429129	19434129
NM_001206491	chr20	+	3827445	3856770	MAVS	29325	3824945	3829945
NM_001271069	chr14	-	65472818	65569262	MAX	96444	65566762	65571762
NM_001276275	chr16	+	29817416	29822504	MAZ	5088	29814916	29819916
NM_203377	chr22	-	36002810	36019401	MB	16591	36016901	36021901
NM_138441	chr6	-	74134855	74162043	MB21D1	27188	74159543	74164543
NM_178496	chr3	-	192514604	192635950	MB21D2	121346	192633450	192638450
NM_001323951	chr18	-	47793251	47808144	MBD1	14893	47805644	47810644
NM_003927	chr18	-	51677970	51751158	MBD2	73188	51748658	51753658
NM_001281453	chr19	-	1576669	1592760	MBD3	16091	1590260	1595260
NM_001276273	chr3	-	129149786	129159022	MBD4	9236	129156522	129161522
NM_018328	chr2	+	148778579	149271044	MBD5	492465	148776079	148781079
NM_052897	chr12	+	57916658	57923931	MBD6	7273	57914158	57919158
NM_001308110	chr14	-	36767763	36789882	MBIP	22119	36787382	36792382
NR_002724	chr10	+	81679933	81682875	MBL1P	2942	81677433	81682433
NM_000242	chr10	-	54525139	54531460	MBL2	6321	54528960	54533960
NM_203406	chr5	-	89754019	89770585	MBLAC2	16566	89768085	89773085
NM_021038	chr3	+	151986256	152183569	MBNL1	197313	151983756	151988756
NR_027038	chr3	-	151980404	151987415	MBNL1-AS1	7011	151984915	151989915
NM_001306070	chr13	+	97874542	98046374	MBNL2	171832	97872042	97877042
NM_001170704	chrX	-	131503342	131623996	MBNL3	120654	131621496	131626496
NM_001080480	chr6	-	20099915	20212695	MBOAT1	112780	20210195	20215195
NM_001321266	chr2	-	8992819	9143879	MBOAT2	151060	9141379	9146379
NM_001100916	chr8	-	29989186	30002200	MBOAT4	13014	29999700	30004700
NM_024298	chr19	-	54677105	54693733	MBOAT7	16628	54691233	54696233
NM_001025101	chr18	-	74690788	74844774	MBP	153986	74842274	74847274
NM_017643	chr17	-	49254785	49337427	MBTD1	82642	49334927	49339927
NM_003791	chr16	-	84087365	84150548	MBTPS1	63183	84148048	84153048
NM_015884	chrX	+	21857655	21903541	MBTPS2	45886	21855155	21860155
NM_002386	chr16	+	89984286	89987385	MC1R	3099	89981786	89986786
NM_001291911	chr18	-	13882042	13915706	MC2R	33664	13913206	13918206
NM_006500	chr11	-	119179233	119187840	MCAM	8607	119185340	119190340
NM_173467	chr22	-	43528211	43539403	MCAT	11192	43536903	43541903
NM_001085377	chr5	-	112357795	112824527	MCC	466732	112822027	112827027
NM_020166	chr3	-	182733005	182817375	MCCC1	84370	182814875	182819875
NM_022132	chr5	+	70883114	70954530	MCCC2	71416	70880614	70885614
NM_032601	chr2	-	71336805	71357394	MCEE	20589	71354894	71359894
NM_174918	chr19	+	7741942	7744719	MCEMP1	2777	7739442	7744442
NM_001099855	chrX	-	138663929	138790381	MCF2	126452	138787881	138792881
NM_001112732	chr13	+	113623534	113754053	MCF2L	130519	113621034	113626034
NM_015078	chr3	-	182895791	183146057	MCF2L2	250266	183143557	183148557
NM_001171511	chr2	-	47129008	47168994	MCFD2	39986	47166494	47171494
NM_005297	chr22	+	41075181	41078818	MCHR1	3637	41072681	41077681
NM_032503	chr6	-	100367785	100442114	MCHR2	74329	100439614	100444614
NR_038384	chr6	+	100441913	100524295	MCHR2-AS1	82382	100439413	100444413
NM_001190787	chr5	-	54515424	54523143	MCIDAS	7719	54520643	54525643
NM_182763	chr1	-	150547026	150552214	MCL1	5188	150549714	150554714
NM_018518	chr10	+	13203553	13253104	MCM10	49551	13201053	13206053
NR_073375	chr3	+	127317199	127341278	MCM2	24079	127314699	127319699
NM_001270472	chr6	-	52128811	52149679	MCM3	20868	52147179	52152179
NM_003906	chr21	-	47655038	47705308	MCM3AP	50270	47702808	47707808
NR_002776	chr21	+	47649144	47671615	MCM3AP-AS1	22471	47646644	47651644
NM_005914	chr8	+	48872762	48890719	MCM4	17957	48870262	48875262
NM_006739	chr22	+	35796115	35820495	MCM5	24380	35793615	35798615
NM_005915	chr2	-	136597195	136634047	MCM6	36852	136631547	136636547
NM_001278595	chr7	-	99690350	99699563	MCM7	9213	99697063	99702063
NM_001281521	chr20	+	5931297	5975852	MCM8	44555	5928797	5933797
NR_110101	chr20	-	5971440	5986467	MCM8-AS1	15027	5983967	5988967
NM_017696	chr6	-	119134611	119252903	MCM9	118292	119250403	119255403
NM_001256379	chr10	-	121588915	121633140	MCMBP	44225	121630640	121635640
NM_173518	chr8	+	67782983	67834283	MCMDC2	51300	67780483	67785483
NM_020533	chr19	+	7587495	7598895	MCOLN1	11400	7584995	7589995
NM_153259	chr1	-	85391265	85462805	MCOLN2	71540	85460305	85465305
NM_001253693	chr1	-	85483764	85514223	MCOLN3	30459	85511723	85516723
NM_001322042	chr8	+	6264112	6506026	MCPH1	241914	6261612	6266612
NR_125386	chr8	-	6473123	6565730	MCPH1-AS1	92607	6563230	6568230
NM_001288798	chr17	-	79780236	79791170	MCRIP1	10934	79788670	79793670
NM_138418	chr16	+	691803	698474	MCRIP2	6671	689303	694303
NM_001278341	chr12	-	49952076	49961928	MCRS1	9852	49959428	49964428
NM_024717	chr5	-	94041241	94620279	MCTP1	579038	94617779	94622779
NM_001159643	chr15	+	94841429	95027181	MCTP2	185752	94838929	94843929
NM_014060	chrX	+	119737743	119755016	MCTS1	17273	119735243	119740243
NR_073062	chr10	+	74451888	74647452	MCU	195564	74449388	74454388
NM_017918	chr4	+	110481354	110608872	MCUB	127518	110478854	110483854
NM_001031713	chr6	-	13786780	13814792	MCUR1	28012	13812292	13817292
NM_014641	chr6	-	30667583	30685458	MDC1	17875	30682958	30687958
NR_133647	chr6	+	30670843	30680961	MDC1-AS1	10118	30668343	30673343
NM_001300804	chr6	+	41604914	41621982	MDFI	17068	41602414	41607414
NM_001166345	chr7	+	114562208	114659970	MDFIC	97762	114559708	114564708
NM_153487	chr6	-	37600283	37665766	MDGA1	65483	37663266	37668266
NM_001113498	chr14	-	47308827	48144157	MDGA2	835330	48141657	48146657
NM_005917	chr2	+	63815742	63834330	MDH1	18588	63813242	63818242
NR_104261	chr2	-	207602488	207630273	MDH1B	27785	207627773	207632773
NM_001282403	chr7	+	75677336	75696827	MDH2	19491	75674836	75679836
NM_001270550	chr11	+	46402333	46405387	MDK	3054	46399833	46404833
NM_017440	chr12	-	68688345	68726161	MDM1	37816	68723661	68728661
NM_002392	chr12	+	69201951	69239324	MDM2	37373	69199451	69204451
NM_002393	chr1	+	204485506	204527248	MDM4	41742	204483006	204488006
NM_014611	chr6	-	90352493	90529513	MDN1	177020	90527013	90532013
NM_001348075	chr1	+	23953823	23967058	MDS2	13235	23951323	23956323
NM_002395	chr6	-	83920109	84140938	ME1	220829	84138438	84143438
NM_002396	chr18	+	48405431	48476162	ME2	70731	48402931	48407931
NM_001161586	chr11	-	86152149	86383678	ME3	231529	86381178	86386178
NM_001318943	chr6	-	42979750	42984624	MEA1	4874	42982124	42987124
NR_073092	chr1	-	37955560	37980420	MEAF6	24860	37977920	37982920
NR_131926	chr6	-	165206865	165235552	MEAT6	28687	165233052	165238052
NM_001205194	chr3	-	168801286	169381563	MECOM	580277	169379063	169384063
NM_004992	chrX	-	153287263	153363188	MECP2	75925	153360688	153365688
NM_001349711	chr1	-	29519168	29557470	MECR	38302	29554970	29559970
NM_004774	chr17	-	37560537	37607527	MED1	46990	37605027	37610027
NM_032286	chr5	-	6372038	6378639	MED10	6601	6376139	6381139
NM_005120	chrX	+	70338405	70362304	MED12	23899	70335905	70340905
NM_053002	chr3	+	150804584	151154465	MED12L	349881	150802084	150807084
NM_005121	chr17	-	60019965	60142643	MED13	122678	60140143	60145143
NM_015335	chr12	-	116396380	116714991	MED13L	318611	116712491	116717491
NM_004229	chrX	-	40508794	40594804	MED14	86010	40592304	40597304
NM_001289773	chrX	+	40594647	40597953	MED14OS	3306	40592147	40597147
NM_015889	chr22	+	20861828	20941919	MED15	80091	20859328	20864328
NR_033903	chr2	+	130887195	130896986	MED15P9	9791	130884695	130889695
NM_005481	chr19	-	867961	893218	MED16	25257	890718	895718
NM_004268	chr11	+	93517404	93546496	MED17	29092	93514904	93519904
NM_001127350	chr1	+	28655512	28662478	MED18	6966	28653012	28658012
NM_001317078	chr11	-	57471180	57479795	MED19	8615	57477295	57482295
NM_001305455	chr6	-	41873090	41888885	MED20	15795	41886385	41891385
NM_004264	chr12	+	27175454	27183606	MED21	8152	27172954	27177954
NM_181491	chr9	-	136207750	136215011	MED22	7261	136212511	136217511
NM_001270521	chr6	-	131895105	131949379	MED23	54274	131946879	131951879
NM_001330211	chr17	-	38175349	38210995	MED24	35646	38208495	38213495
NM_030973	chr19	+	50321535	50340237	MED25	18702	50319035	50324035
NM_004831	chr19	-	16685717	16739015	MED26	53298	16736515	16741515
NM_004269	chr9	-	134735496	134955274	MED27	219778	134952774	134957774
NM_025205	chr4	+	17616250	17627251	MED28	11001	17613750	17618750
NR_133915	chr19	+	39881942	39891277	MED29	9335	39879442	39884442
NM_001282986	chr8	+	118532951	118552501	MED30	19550	118530451	118535451
NM_016060	chr17	-	6546632	6554954	MED31	8322	6552454	6557454
NM_001270629	chr13	-	48649863	48669277	MED4	19414	48666777	48671777
NR_046511	chr13	+	48651272	48654129	MED4-AS1	2857	48648772	48653772
NM_001284210	chr14	-	71049937	71067407	MED6	17470	71064907	71069907
NM_004270	chr5	-	156565450	156569921	MED7	4471	156567421	156572421
NM_001001653	chr1	-	43849578	43855483	MED8	5905	43852983	43857983
NM_018019	chr17	+	17380299	17396534	MED9	16235	17377799	17382799
NM_032849	chr13	+	31480311	31499709	MEDAG	19398	31477811	31482811
NM_001352617	chr15	+	100105805	100256693	MEF2A	150888	100103305	100108305
NM_001145785	chr19	-	19256375	19281098	MEF2B	24723	19278598	19283598
NM_001131005	chr5	-	88014057	88199922	MEF2C	185865	88197422	88202422
NR_136218	chr5	+	88179146	88763398	MEF2C-AS1	584252	88176646	88181646
NR_146284	chr5	+	87972035	88018648	MEF2C-AS2	46613	87969535	87974535
NM_005920	chr1	-	156433512	156470634	MEF2D	37122	156468134	156473134
NM_000243	chr16	-	3292027	3306627	MEFV	14600	3304127	3309127
NR_002766	chr14	+	101292444	101327360	MEG3	34916	101289944	101294944
NR_146000	chr14	+	101355985	101465450	MEG8	109465	101353485	101358485
NR_047664	chr14	+	101536247	101539273	MEG9	3026	101533747	101538747
NM_032446	chr5	+	126626455	126796910	MEGF10	170455	126623955	126628955
NM_032445	chr15	-	66187633	66546075	MEGF11	358442	66543575	66548575
NM_001409	chr1	-	3404505	3528059	MEGF6	123554	3525559	3530559
NM_001410	chr19	+	42829760	42882921	MEGF8	53161	42827260	42832260
NM_001080497	chr9	-	123363195	123476765	MEGF9	113570	123474265	123479265
NM_152513	chr22	+	42095517	42195459	MEI1	99942	42093017	42098017
NM_001282136	chr6	+	78359990	78636759	MEI4	276769	78357490	78362490
NR_147060	chr10	+	15001353	15030046	MEIG1	28693	14998853	15003853
NM_001303622	chr5	-	131142683	131281391	MEIKIN	138708	131278891	131283891
NM_001163560	chr16	-	1883983	1922179	MEIOB	38196	1919679	1924679
NM_001145080	chr17	+	42733761	42753165	MEIOC	19404	42731261	42736261
NM_002398	chr2	+	66662531	66799891	MEIS1	137360	66660031	66665031
NR_046438	chr2	-	66650474	66660602	MEIS1-AS3	10128	66658102	66663102
NM_002399	chr15	-	37183221	37393500	MEIS2	210279	37391e3	37396e3
NM_001346148	chr19	-	47906374	47925490	MEIS3	19116	47922990	47927990
NR_002211	chr17	+	15690163	15693019	MEIS3P1	2856	15687663	15692663
NM_001256690	chr9	+	36572858	36677680	MELK	104822	36570358	36575358
NM_005929	chr3	-	196728611	196756687	MELTF	28076	196754187	196759187
NR_126034	chr2	-	32092878	32236121	MEMO1	143243	32233621	32238621
NM_130803	chr11	-	64570985	64578766	MEN1	7781	64576266	64581266
NM_001040002	chr17	-	41717757	41739262	MEOX1	21505	41736762	41741762
NM_005924	chr7	-	15650836	15726308	MEOX2	75472	15723808	15728808
NR_110094	chr7	+	15728002	15736517	MEOX2-AS1	8515	15725502	15730502
NM_005588	chr6	+	46761093	46807519	MEP1A	46426	46758593	46763593
NM_001308171	chr18	+	29769986	29800366	MEP1B	30380	29767486	29772486
NM_001194992	chr7	+	100026412	100031749	MEPCE	5337	100023912	100028912
NM_001184694	chr4	+	88742549	88767968	MEPE	25419	88740049	88745049
NM_006343	chr2	+	112656190	112786945	MERTK	130755	112653690	112658690
NR_126328	chr15	-	81239667	81282219	MESD	42552	81279719	81284719
NM_001253901	chr7	+	130126015	130146138	MEST	20123	130123515	130128515
NR_004382	chr7	-	130126897	130131013	MESTIT1	4116	130128513	130133513
NM_001324402	chr7	+	116312412	116438440	MET	126028	116309912	116314912
NM_015143	chr4	+	99916787	99983960	METAP1	67173	99914287	99919287
NR_136273	chr2	+	172864803	172947157	METAP1D	82354	172862303	172867303
NM_001330246	chr12	+	95867821	95909613	METAP2	41792	95865321	95870321
NM_024042	chr16	+	765172	769655	METRN	4483	762672	767672
NM_001004431	chr17	+	81037566	81052871	METRNL	15305	81035066	81040066
NM_023033	chr12	-	58162350	58165914	METTL1	3564	58163414	58168414
NM_001136107	chr1	+	170115187	170136923	METTL11B	21736	170112687	170117687
NM_015935	chr1	+	171750760	171766856	METTL13	16096	171748260	171753260
NM_020961	chr4	+	119606524	119633425	METTL14	26901	119604024	119609024
NM_152636	chr11	+	28129797	28355054	METTL15	225257	28127297	28132297
NM_024086	chr17	-	2319347	2415200	METTL16	95853	2412700	2417700
NM_022734	chr14	+	21457964	21465194	METTL17	7230	21455464	21460464
NM_001330132	chr2	-	208445354	208490777	METTL21A	45423	208488277	208493277
NM_001010977	chr13	-	103338096	103346871	METTL21C	8775	103344371	103349371
NR_026965	chr13	+	103532448	103548383	METTL21EP	15935	103529948	103534948
NM_024109	chr16	+	8715496	8740079	METTL22	24583	8712996	8717996
NM_001206985	chr17	+	74722911	74729963	METTL23	7052	74720411	74725411
NM_001123364	chr6	-	110565097	110679475	METTL24	114378	110676975	110681975
NM_001319675	chr12	+	82752275	82873016	METTL25	120741	82749775	82754775
NM_152559	chr7	-	73248920	73256855	METTL27	7935	73254355	73259355
NM_181725	chr17	+	60501245	60527454	METTL2A	26209	60498745	60503745
NM_018396	chr7	+	128116782	128142978	METTL2B	26196	128114282	128119282
NM_019852	chr14	-	21966274	21979517	METTL3	13243	21977017	21982017
NM_022840	chr18	-	2537523	2571502	METTL4	33979	2569002	2574002
NM_001293187	chr2	-	170668266	170681441	METTL5	13175	170678941	170683941
NM_152396	chr3	-	15451266	15469054	METTL6	17788	15466554	15471554
NM_014033	chr12	+	51318533	51326300	METTL7A	7767	51316033	51321033
NM_152637	chr12	+	56075329	56078394	METTL7B	3065	56072829	56077829
NM_024770	chr2	-	172172255	172291313	METTL8	119058	172288813	172293813
NM_001288659	chr16	+	21608541	21668794	METTL9	60253	21606041	21611041
NM_001093725	chr1	-	156041803	156051789	MEX3A	9986	156049289	156054289
NM_032246	chr15	-	82334118	82338484	MEX3B	4366	82335984	82340984
NM_016626	chr18	-	48700919	48724051	MEX3C	23132	48721551	48726551
NM_001174118	chr19	-	1554667	1568057	MEX3D	13390	1565557	1570557
NM_005926	chr15	-	44096732	44116951	MFAP1	20219	44114451	44119451
NM_017459	chr1	-	17300998	17308081	MFAP2	7083	17305581	17310581
NM_005927	chr5	+	153418518	153437014	MFAP3	18496	153416018	153421018
NM_021647	chr4	-	170907747	170947581	MFAP3L	39834	170945081	170950081
NM_002404	chr17	-	19286754	19290532	MFAP4	3778	19288032	19293032
NM_001297712	chr12	-	8798538	8815484	MFAP5	16946	8812984	8817984
NM_001277061	chr2	+	228189866	228222552	MFF	32686	228187366	228192366
NM_005928	chr15	-	89441913	89456700	MFGE8	14787	89454200	89459200
NM_004225	chr8	-	8641998	8751131	MFHAS1	109133	8748631	8753631
NM_033540	chr3	+	179065479	179111008	MFN1	45529	179062979	179067979
NM_014874	chr1	+	12040237	12073572	MFN2	33335	12037737	12042737
NR_029413	chr22	-	37865100	37882478	MFNG	17378	37879978	37884978
NM_031433	chr11	-	119209643	119217383	MFRP	7740	119214883	119219883
NM_001167903	chr3	+	158519714	158547508	MFSD1	27794	158517214	158522214
NM_001146069	chr4	-	2932287	2936586	MFSD10	4299	2934086	2939086
NM_001242534	chr17	+	74732646	74774899	MFSD11	42253	74730146	74735146
NM_174983	chr19	-	3544196	3557582	MFSD12	13386	3555082	3560082
NM_024789	chr10	+	104221169	104236802	MFSD13A	15633	104218669	104223669
NR_136333	chr16	+	22397089	22418918	MFSD13B	21829	22394589	22399589
NM_033055	chr1	+	100503788	100548929	MFSD14A	45141	100501288	100506288
NM_032558	chr9	+	97136832	97223202	MFSD14B	86370	97134332	97139332
NR_002894	chr9	-	99708326	99775862	MFSD14C	67536	99773362	99778362
NR_109896	chr1	+	40420783	40435640	MFSD2A	14857	40418283	40423283
NM_001346880	chr2	+	24232956	24249645	MFSD2B	16689	24230456	24235456
NM_181644	chr1	+	205538111	205572046	MFSD4A	33935	205535611	205540611
NM_153369	chr6	+	111580481	111590261	MFSD4B	9780	111577981	111582981
NM_001170790	chr12	+	53645369	53648190	MFSD5	2821	53642869	53647869
NM_017694	chr2	+	191273080	191367041	MFSD6	93961	191270580	191275580
NM_001294341	chr4	-	675612	683230	MFSD7	7618	680730	685730
NM_152778	chr4	-	128838959	128887139	MFSD8	48180	128884639	128889639
NM_001322080	chr2	-	103331084	103353347	MFSD9	22263	103350847	103355847
NM_001164273	chr15	+	41952609	42062141	MGA	109532	41950109	41955109
NM_004668	chr7	+	141695678	141806547	MGAM	110869	141693178	141698178
NM_001293626	chr7	+	141811548	141922124	MGAM2	110576	141809048	141814048
NM_032623	chr4	-	140187316	140201492	MGARP	14176	140198992	140203992
NM_001114617	chr5	-	180217540	180237137	MGAT1	19597	180234637	180239637
NM_002408	chr14	+	50087488	50090199	MGAT2	2711	50084988	50089988
NM_002409	chr22	+	39853324	39888199	MGAT3	34875	39850824	39855824
NM_012214	chr2	-	99235568	99347589	MGAT4A	112021	99345089	99350089
NM_014275	chr5	-	179224597	179233952	MGAT4B	9355	179231452	179236452
NM_001351285	chr12	-	86367072	87232783	MGAT4C	865711	87230283	87235283
NM_001277353	chr4	-	141364528	141419531	MGAT4D	55003	141417031	141422031
NR_038135	chr1	+	202789384	202796341	MGAT4EP	6957	202786884	202791884
NM_002410	chr2	+	135011829	135212192	MGAT5	200363	135009329	135014329
NM_144677	chr17	+	74864797	74946471	MGAT5B	81674	74862297	74867297
NR_026897	chr15	-	62929370	62937380	MGC15885	8010	62934880	62939880
NR_026914	chr17	-	72206134	72209460	MGC16275	3326	72206960	72211960
NR_046216	chr7	-	127937737	127947816	MGC27345	10079	127945316	127950316
NR_027310	chr1	+	78695282	78835147	MGC27382	139865	78692782	78697782
NR_051996	chr5	-	121772191	121814782	MGC32805	42591	121812282	121817282
NR_147499	chr7	-	10489446	10819571	MGC4859	330125	10817071	10822071
NR_003682	chr17_gl000205_random	+	116622	119732	MGC70870	3110	114122	119122
NM_012215	chr10	-	103544199	103578222	MGEA5	34023	103575722	103580722
NM_001003794	chr3	-	127407904	127542093	MGLL	134189	127539593	127544593
NM_001310338	chr20	+	17949533	17971765	MGME1	22232	17947033	17952033
NM_002412	chr10	+	131265447	131565884	MGMT	300437	131262947	131267947
NM_000900	chr12	-	15033797	15038996	MGP	5199	15036496	15041496
NM_015246	chr16	+	4674824	4740975	MGRN1	66151	4672324	4677324
NM_001267598	chr12	+	16500576	16530123	MGST1	29547	16498076	16503076
NM_001204367	chr4	+	140586921	140661899	MGST2	74978	140584421	140589421
NM_004528	chr1	+	165600109	165625372	MGST3	25263	165597609	165602609
NR_037775	chr19	+	41281441	41302849	MIA-RAB4B	21408	41278941	41283941
NM_001329214	chr14	+	39703113	39820397	MIA2	117284	39700613	39705613
NM_001324062	chr1	+	222791443	222841354	MIA3	49911	222788943	222793943
NR_003491	chr22	+	27053445	27072440	MIAT	18995	27050945	27055945
NR_110543	chr22	+	27068805	27176856	MIATNB	108051	27066305	27071305
NM_020774	chr18	+	19321289	19450918	MIB1	129629	19318789	19323789
NM_080875	chr1	+	1550794	1565990	MIB2	15196	1548294	1553294
NM_001289153	chr6_qbl_hap6	+	2661006	2676636	MICA	15630	2658506	2663506
NM_001286613	chr6	-	109765265	109787171	MICAL1	21906	109784671	109789671
NM_001346296	chr11	+	12132122	12285337	MICAL2	153215	12129622	12134622
NM_015241	chr22	-	18270415	18507325	MICAL3	236910	18504825	18509825
NM_032867	chr11	+	12308446	12380691	MICALCL	72245	12305946	12310946
NM_033386	chr22	+	38302154	38338465	MICALL1	36311	38299654	38304654
NM_182924	chr7	-	1473994	1499109	MICALL2	25115	1496609	1501609
NM_001289160	chr6_qbl_hap6	+	2461711	2772598	MICB	310887	2459211	2464211
NM_001195518	chr10	-	74127083	74385949	MICU1	258866	74383449	74388449
NM_152726	chr13	-	22066827	22178355	MICU2	111528	22175855	22180855
NM_181723	chr8	+	16884746	16980148	MICU3	95402	16882246	16887246
NM_033290	chrX	-	10413349	10851809	MID1	438460	10849309	10854309
NM_001098790	chrX	+	38660684	38665783	MID1IP1	5099	38658184	38663184
NR_046706	chrX	-	38660500	38663136	MID1IP1-AS1	2636	38660636	38665636
NM_012216	chrX	+	107069083	107174867	MID2	105784	107066583	107071583
NM_177401	chr19	+	1248551	1259142	MIDN	10591	1246051	1251051
NM_001304564	chr22	+	39896104	39914139	MIEF1	18035	39893604	39898604
NM_001144900	chr17	+	18163847	18169095	MIEF2	5248	18161347	18166347
NM_001146110	chr1	+	67390577	67454302	MIER1	63725	67388077	67393077
NM_017550	chr19	-	305574	344841	MIER2	39267	342341	347341
NM_001297599	chr5	-	56215428	56247957	MIER3	32529	56245457	56250457
NR_038911	chr22	-	24235896	24241117	MIF-AS1	5221	24238617	24243617
NM_001242498	chr17	-	73262309	73267311	MIF4GD	5002	73264811	73269811
NM_198549	chr1	+	78245308	78345225	MIGA1	99917	78242808	78247808
NR_138421	chr9	+	131798789	131834361	MIGA2	35572	131796289	131801289
NM_021933	chr1	+	12079298	12092106	MIIP	12808	12076798	12081798
NM_001291316	chr17	+	62461568	62464760	MILR1	3192	62459068	62464068
NR_024059	chr19	+	57352269	57359922	MIMT1	7653	57349769	57354769
NM_018379	chr1	-	150969300	150980854	MINDY1	11554	150978354	150983354
NM_001040450	chr15	+	59063390	59154098	MINDY2	90708	59060890	59065890
NM_001318330	chr10	-	15820167	15902532	MINDY3	82365	15900032	15905032
NM_032222	chr7	+	30811032	30932002	MINDY4	120970	30808532	30813532
NM_001351281	chr3	-	150588831	150608847	MINDY4B	20016	150606347	150611347
NM_015716	chr17	+	4736634	4801356	MINK1	64722	4734134	4739134
NM_001032363	chr1	+	19923470	19956315	MINOS1	32845	19920970	19925970
NM_001204088	chr1	+	19923470	19984949	MINOS1-NBL1	61479	19920970	19925970
NM_004897	chr10	+	89264222	89313218	MINPP1	48996	89261722	89266722
NM_019005	chr7	+	7606615	7647110	MIOS	40495	7604115	7609115
NM_017584	chr22	+	50925212	50928750	MIOX	3538	50922712	50927712
NM_012064	chr12	-	56843285	56848435	MIP	5150	56845935	56850935
NM_005932	chr13	-	24304327	24463587	MIPEP	159260	24461087	24466087
NR_046461	chr13	+	21872263	21967061	MIPEPP3	94798	21869763	21874763
NM_138731	chr14	+	37667117	38020464	MIPOL1	353347	37664617	37669617
NM_001302812	chr20	+	61147659	61167971	MIR1-1HG	20312	61145159	61150159
NR_137179	chr11	-	121959810	122293579	MIR100HG	333769	122291079	122296079
NR_109792	chr8	+	65285884	65300061	MIR124-2HG	14177	65283384	65288384
NR_031672	chr9	+	131114325	131424415	MIR1268A	310090	131111825	131116825
NR_128706	chr1	+	240640408	240912217	MIR1273E	271809	240637908	240642908
NR_110369	chr18	-	19405439	19411367	MIR133A1HG	5928	19408867	19413867
NR_046105	chr1	-	98453555	98515249	MIR137HG	61694	98512749	98517749
NR_001458	chr21	+	26934456	26947480	MIR155HG	13024	26931956	26936956
NR_027349	chr13	+	92000073	92006829	MIR17HG	6756	91997573	92002573
NR_040073	chr1	-	198777131	198906558	MIR181A1HG	129427	198904058	198909058
NR_038975	chr9	+	127420714	127460907	MIR181A2HG	40193	127418214	127423214
NR_132983	chr16	+	14396144	14420374	MIR193BHG	24230	14393644	14398644
NR_133640	chr11	-	64655929	64660921	MIR194-2HG	4992	64658421	64663421
NR_033830	chr8	+	75512100	75670587	MIR2052HG	158487	75509600	75514600
NR_145433	chr1	+	209602164	209605892	MIR205HG	3728	209599664	209604664
NR_038262	chr11	-	565656	568457	MIR210HG	2801	565957	570957
NR_146952	chr17	+	41522074	41528565	MIR2117HG	6491	41519574	41524574
NR_126406	chr2	-	56190540	56274461	MIR217HG	83921	56271961	56276961
NR_028503	chr17	-	1614797	1619566	MIR22HG	4769	1617066	1622066
NR_132748	chr5	+	159895257	159914433	MIR3142HG	19176	159892757	159897757
NR_036121	chr6	+	152469761	152546267	MIR3163	76506	152467261	152472261
NR_027054	chr9	-	21454266	21559697	MIR31HG	105431	21557197	21562197
NR_110402	chrX	-	75878198	76234957	MIR325HG	356759	76232457	76237457
NR_132742	chr1	-	9208069	9242397	MIR34AHG	34328	9239897	9244897
NR_121651	chr10	-	118913031	118928566	MIR3663HG	15535	118926066	118931066
NR_110196	chr2	+	12147241	12718474	MIR3681HG	571233	12144741	12149741
NR_104192	chr14	+	101511493	101518132	MIR381HG	6639	101508993	101513993
NR_110997	chr5	-	131646968	131705608	MIR3936HG	58640	131703108	131708108
NR_132989	chr4	-	185764449	185776806	MIR3945HG	12357	185774306	185779306
NR_038839	chr18	+	5748817	5795900	MIR3976HG	47083	5746317	5751317
NR_038882	chr9	-	92782935	92803781	MIR4290HG	20846	92801281	92806281
NR_120571	chr11	-	81590892	82114955	MIR4300HG	524063	82112455	82117455
NR_110041	chr14	+	27342338	27383949	MIR4307HG	41611	27339838	27344838
NR_146283	chr1	+	55683533	55699850	MIR4422HG	16317	55681033	55686033
NR_132992	chr2	-	60586350	60618510	MIR4432HG	32160	60616010	60621010
NR_136162	chr2	-	111953443	112252738	MIR4435-2HG	299295	112250238	112255238
NR_039989	chr5	+	8457799	8463209	MIR4458HG	5410	8455299	8460299
NR_039664	chr11	+	72590964	72604767	MIR4459	13803	72588464	72593464
NR_033829	chr13	-	88096241	88323218	MIR4500HG	226977	88320718	88325718
NR_147192	chr18	+	44812094	45120918	MIR4527HG	308824	44809594	44814594
NR_024344	chr11	-	133766329	133771635	MIR4697HG	5306	133769135	133774135
NR_146310	chr15	+	51329684	51586109	MIR4713HG	256425	51327184	51332184
NR_038310	chr17	-	6919136	6922973	MIR497HG	3837	6920473	6925473
NR_024607	chrX	-	133677406	133680660	MIR503HG	3254	133678160	133683160
NR_039970	chr16	+	48344528	48658037	MIR5095	313509	48342028	48347028
NR_039973	chr1	+	235676124	235881413	MIR5096	205289	235673624	235678624
NR_030330	chr3	-	103903475	103946105	MIR548A3	42630	103943605	103948605
NR_037516	chr1	+	100154610	100178513	MIR548AA1	23903	100152110	100157110
NR_039621	chr3	+	23375625	23648882	MIR548AC	273257	23373125	23378125
NR_049853	chr2	-	107766120	107965981	MIR548AU	199861	107963481	107968481
NR_031644	chr1	+	218610974	219281452	MIR548F3	670478	218608474	218613474
NR_031662	chr3	-	99273152	99717059	MIR548G	443907	99714559	99719559
NR_031678	chr3	+	151347319	151542394	MIR548H2	195075	151344819	151349819
NR_031679	chr6	-	97537842	97862283	MIR548H3	324441	97859783	97864783
NR_031680	chr15	+	69116302	69489862	MIR548H4	373560	69113802	69118802
NR_031666	chr2	+	179246804	179541009	MIR548N	294205	179244304	179249304
NR_036093	chr7	+	147626684	148043927	MIR548T	417243	147624184	147629184
NR_109925	chr21	-	19933582	20132130	MIR548XHG	198548	20129630	20134630
NR_132993	chr6	+	10434561	10457012	MIR5689HG	22451	10432061	10437061
NR_049880	chr6	-	126433836	126443762	MIR5695	9926	126441262	126446262
NR_026677	chr9	-	125871772	125877756	MIR600HG	5984	125875256	125880256
NR_046099	chr20	+	58713547	58897314	MIR646HG	183767	58711047	58716047
NR_040095	chr20	-	26167654	26189869	MIR663AHG	22215	26187369	26192369
NR_027148	chr19	+	4769116	4772568	MIR7-3HG	3452	4766616	4771616
NR_110942	chr16	+	30886780	30906539	MIR762HG	19759	30884280	30889280
NR_133001	chr15	+	89904809	89941718	MIR9-3HG	36909	89902309	89907309
NR_024391	chr18	-	36786887	37331959	MIR924HG	545072	37329459	37334459
NR_136541	chr21	+	17442807	18004046	MIR99AHG	561239	17440307	17445307
NR_027033	chr22	+	46481876	46509808	MIRLET7BHG	27932	46479376	46484376
NR_046163	chr9	-	96938851	96966848	MIRLET7DHG	27997	96964348	96969348
NM_001258217	chr17	+	5389693	5394130	MIS12	4437	5387193	5392193
NM_018944	chr21	-	33640529	33651376	MIS18A	10847	33648876	33653876
NM_018353	chr14	-	45672392	45722605	MIS18BP1	50213	45720105	45725105
NM_173481	chr19	+	751112	764319	MISP	13207	748612	753612
NM_138798	chr2	-	99785725	99797524	MITD1	11799	99795024	99800024
NM_198159	chr3	+	69788585	70017488	MITF	228903	69786085	69791085
NM_001282402	chr1	+	226411318	226414756	MIXL1	3438	226408818	226413818
NM_002417	chr10	-	129894924	129924468	MKI67	29544	129921968	129926968
NM_170784	chr20	-	10385427	10414887	MKKS	29460	10412387	10417387
NM_001282661	chr22	-	40806284	41032723	MKL1	226439	41030223	41035223
NM_014048	chr16	+	14165169	14360636	MKL2	195467	14162669	14167669
NM_001145354	chr7	+	130794854	131181398	MKLN1	386544	130792354	130797354
NR_125364	chr7	-	130994502	131012538	MKLN1-AS	18036	131010038	131015038
NR_146512	chr1	-	47023078	47069973	MKNK1	46895	47067473	47072473
NR_038403	chr1	+	47004367	47035927	MKNK1-AS1	31560	47001867	47006867
NM_017572	chr19	-	2037469	2051243	MKNK2	13774	2048743	2053743
NM_013446	chr7	-	140152839	140179369	MKRN1	26530	140176869	140181869
NM_014160	chr3	+	12598512	12625210	MKRN2	26698	12596012	12601012
NM_001195279	chr3	-	12581279	12586963	MKRN2OS	5684	12584463	12589463
NM_005664	chr15	+	23810453	23813166	MKRN3	2713	23807953	23812953
NM_001165927	chr17	-	56282796	56296966	MKS1	14170	56294466	56299466
NM_001242702	chr10	-	27961802	28034778	MKX	72976	28032278	28037278
NR_121652	chr10	+	28033543	28056728	MKX-AS1	23185	28031043	28036043
NM_005511	chr9	+	5890908	5909822	MLANA	18914	5888408	5893408
NM_015166	chr22	-	50497819	50524358	MLC1	26539	50521858	50526858
NM_001303628	chr12	+	121124926	121139667	MLEC	14741	121122426	121127426
NM_001130156	chr3	+	158288952	158324249	MLF1	35297	158286452	158291452
NR_026581	chr12	-	6857157	6862636	MLF2	5479	6860136	6865136
NM_000249	chr3	+	37034840	37092337	MLH1	57497	37032340	37037340
NM_001040108	chr14	-	75480466	75518235	MLH3	37769	75515735	75520735
NM_138569	chr6	+	53883713	54131078	MLIP	247365	53881213	53886213
NR_046832	chr6	+	53863687	53871950	MLIP-IT1	8263	53861187	53866187
NM_152649	chr16	-	74705752	74735046	MLKL	29294	74732546	74737546
NM_005934	chr19	-	6210391	6279959	MLLT1	69568	6277459	6282459
NM_001324297	chr10	+	21822277	22032559	MLLT10	210282	21819777	21824777
NM_006818	chr1	+	151032150	151040973	MLLT11	8823	151029650	151034650
NM_004529	chr9	-	20341662	20622542	MLLT3	280880	20620042	20625042
NM_005937	chr17	+	36861872	36886056	MLLT6	24184	36859372	36864372
NM_002418	chr6	-	33762448	33771793	MLN	9345	33769293	33774293
NM_001281474	chr2	+	238395052	238463961	MLPH	68909	238392552	238397552
NR_147904	chr16	+	2255177	2259455	MLST8	4278	2252677	2257677
NM_198204	chr17	+	40719077	40725221	MLX	6144	40716577	40721577
NM_014938	chr12	+	122516633	122631894	MLXIP	115261	122514133	122519133
NR_134541	chr7	-	73007523	73038873	MLXIPL	31350	73036373	73041373
NM_012213	chr16	+	83932729	83949787	MLYCD	17058	83930229	83935229
NM_172250	chr4	+	146540539	146581187	MMAA	40648	146538039	146543039
NM_052845	chr12	-	109991520	110011358	MMAB	19838	110008858	110013858
NM_015506	chr1	+	45965855	45976739	MMACHC	10884	45963355	45968355
NM_015702	chr2	-	150426146	150444330	MMADHC	18184	150441830	150446830
NM_012329	chr17	-	53469973	53499341	MMD	29368	53496841	53501841
NR_072989	chr7	-	4931875	4998844	MMD2	66969	4996344	5001344
NM_000902	chr3	+	154797435	154901518	MME	104083	154794935	154799935
NM_033467	chr1	-	2522080	2564481	MMEL1	42401	2561981	2566981
NM_001330000	chrX	-	135042746	135056222	MMGT1	13476	135053722	135058722
NM_001145938	chr11	-	102660640	102668966	MMP1	8326	102666466	102671466
NM_002425	chr11	-	102641232	102651359	MMP10	10127	102648859	102653859
NR_133013	chr22	+	24115005	24126503	MMP11	11498	24112505	24117505
NM_002426	chr11	-	102733459	102745764	MMP12	12305	102743264	102748264
NM_002427	chr11	-	102813720	102826463	MMP13	12743	102823963	102828963
NM_004995	chr14	+	23305741	23316808	MMP14	11067	23303241	23308241
NM_002428	chr16	+	58059469	58080804	MMP15	21335	58056969	58061969
NM_005941	chr8	-	89049459	89339717	MMP16	290258	89337217	89342217
NM_016155	chr12	+	132312937	132336316	MMP17	23379	132310437	132315437
NR_073606	chr12	-	56229213	56236767	MMP19	7554	56234267	56239267
NM_001302508	chr16	+	55512741	55540603	MMP2	27862	55510241	55515241
NR_147198	chr16	-	55460708	55496209	MMP2-AS1	35501	55493709	55498709
NM_004771	chr11	-	102447565	102496063	MMP20	48498	102493563	102498563
NM_147191	chr10	-	127455026	127464390	MMP21	9364	127461890	127466890
NM_006690	chr20	+	33814538	33864804	MMP24	50266	33812038	33817038
NM_022468	chr16	+	3096681	3110724	MMP25	14043	3094181	3099181
NR_123723	chr16	-	3102125	3109371	MMP25-AS1	7246	3106871	3111871
NM_021801	chr11	+	5009420	5013659	MMP26	4239	5006920	5011920
NM_022122	chr11	-	102562414	102576468	MMP27	14054	102573968	102578968
NR_111988	chr17	-	34083267	34122711	MMP28	39444	34120211	34125211
NM_002422	chr11	-	102706527	102714420	MMP3	7893	102711920	102716920
NM_002423	chr11	-	102391238	102401484	MMP7	10246	102398984	102403984
NM_001304441	chr11	-	102582525	102595685	MMP8	13160	102593185	102598185
NM_004994	chr20	+	44637546	44645200	MMP9	7654	44635046	44640046
NM_007351	chr4	+	90816051	90875780	MMRN1	59729	90813551	90818551
NM_024756	chr10	-	88695297	88717425	MMRN2	22128	88714925	88719925
NM_001289405	chr10	-	99218080	99258551	MMS19	40471	99256051	99261051
NM_001350599	chr6	-	97590036	97731153	MMS22L	141117	97728653	97733653
NM_002430	chr22	-	28144264	28197486	MN1	53222	28194986	28199986
NM_002431	chr14	+	61201458	61435398	MNAT1	233940	61198958	61203958
NR_045605	chr4	+	154265800	154336247	MND1	70447	154263300	154268300
NM_002432	chr1	+	158801092	158819294	MNDA	18202	158798592	158803592
NM_018365	chr15	-	56720928	56757335	MNS1	36407	56754835	56759835
NM_020310	chr17	-	2287353	2304258	MNT	16905	2301758	2306758
NM_005515	chr7	-	156797546	156803347	MNX1	5801	156800847	156805847
NR_038835	chr7	+	156803550	156809118	MNX1-AS1	5568	156801050	156806050
NM_022151	chr14	-	93648540	93651249	MOAP1	2709	93648749	93653749
NM_018221	chr2	-	74379724	74406094	MOB1A	26370	74403594	74408594
NM_173468	chr4	+	71768056	71853891	MOB1B	85835	71765556	71770556
NM_001172223	chr11	-	1490677	1508009	MOB2	17332	1505509	1510509
NM_130807	chr19	-	2071034	2096269	MOB3A	25235	2093769	2098769
NM_024761	chr9	-	27325206	27529850	MOB3B	204644	27527350	27532350
NM_201403	chr1	-	47073386	47082563	MOB3C	9177	47080063	47085063
NM_199482	chr2	+	198380294	198418423	MOB4	38129	198377794	198382794
NR_103504	chr3	+	39509063	39570988	MOBP	61925	39506563	39511563
NM_017947	chr18	+	33767172	33848685	MOCOS	81513	33764672	33769672
NR_033233	chr6	-	39872033	39902290	MOCS1	30257	39899790	39904790
NM_176806	chr5	-	52391508	52405602	MOCS2	14094	52403102	52408102
NM_014484	chr20	+	49575350	49578399	MOCS3	3049	49572850	49577850
NM_206809	chr6_cox_hap2	+	1143558	1158951	MOG	15393	1141058	1146058
NM_058165	chr2	+	223536456	223574649	MOGAT1	38193	223533956	223538956
NM_025098	chr11	+	75428863	75444003	MOGAT2	15140	75426363	75431363
NM_001287147	chr7	-	100839011	100844302	MOGAT3	5291	100841802	100846802
NM_006302	chr2	-	74688183	74692537	MOGS	4354	74690037	74695037
NM_001272011	chr14	-	102695157	102771537	MOK	76380	102769037	102774037
NM_001142501	chr3	-	49946301	49967445	MON1A	21144	49964945	49969945
NM_001286639	chr16	+	77224815	77233543	MON1B	8728	77222315	77227315
NM_001278471	chr12	+	62860596	62991363	MON2	130767	62858096	62863096
NM_014429	chr3	-	108677086	108836993	MORC1	159907	108834493	108839493
NR_144461	chr3	+	108820302	108829187	MORC1-AS1	8885	108817802	108822802
NM_001303256	chr22	-	31321116	31364273	MORC2	43157	31361773	31366773
NR_026920	chr22	+	31318294	31322640	MORC2-AS1	4346	31315794	31320794
NM_015358	chr21	+	37692486	37748944	MORC3	56458	37689986	37694986
NM_024657	chrX	-	106183963	106243474	MORC4	59511	106240974	106245974
NM_006791	chr15	+	79165122	79190081	MORF4L1	24959	79162622	79167622
NM_001142432	chrX	-	102930425	102943086	MORF4L2	12661	102940586	102945586
NR_038978	chrX	+	102942211	102947484	MORF4L2-AS1	5273	102939711	102944711
NM_024848	chr1	-	2252691	2323190	MORN1	70499	2320690	2325690
NM_001145450	chr2	+	39103102	39109850	MORN2	6748	39100602	39105602
NM_173855	chr12	-	122089292	122107560	MORN3	18268	122105060	122110060
NM_001098831	chr10	-	99374309	99393913	MORN4	19604	99391413	99396413
NM_001286828	chr9	+	124922186	124962367	MORN5	40181	124919686	124924686
NM_001306188	chrX	-	134021655	134049374	MOSPD1	27719	134046874	134051874
NM_001330241	chrX	+	14891526	14940288	MOSPD2	48762	14889026	14894026
NM_001040097	chr7	+	100209724	100213000	MOSPD3	3276	100207224	100212224
NM_020963	chr1	+	113216933	113243368	MOV10	26435	113214433	113219433
NM_018995	chr22	+	50528434	50600116	MOV10L1	71682	50525934	50530934
NM_015529	chr6	-	132617193	132722673	MOXD1	105480	132720173	132725173
NR_024346	chr7	-	141940555	141946886	MOXD2P	6331	141944386	141949386
NR_073093	chr6	-	166778407	166796501	MPC1	18094	166794001	166799001
NM_015415	chr1	-	167885912	167906307	MPC2	20395	167903807	167908807
NR_024603	chr17	+	7486964	7491527	MPDU1	4563	7484464	7489464
NM_001330637	chr9	-	13105702	13279712	MPDZ	174010	13277212	13282212
NM_001039396	chr11	-	58975982	58980494	MPEG1	4512	58977994	58982994
NM_001015054	chr16	+	127017	135850	MPG	8833	124517	129517
NM_005791	chr2	+	71357443	71377232	MPHOSPH10	19789	71354943	71359943
NM_005792	chr16	-	82181766	82203829	MPHOSPH6	22063	82201329	82206329
NM_017520	chr13	+	20207787	20247599	MPHOSPH8	39812	20205287	20210287
NM_022782	chr12	-	123640942	123717785	MPHOSPH9	76843	123715285	123720285
NM_001330372	chr15	+	75182345	75191798	MPI	9453	75179845	75184845
NM_025260	chr6_mann_hap4	+	3034009	3037375	MPIG6B	3366	3031509	3036509
NM_005373	chr1	+	43803474	43820135	MPL	16661	43800974	43805974
NM_001300862	chr19	+	4343523	4360083	MPND	16560	4341023	4346023
NM_000250	chr17	-	56347216	56358296	MPO	11080	56355796	56360796
NM_002436	chrX	-	154006958	154033802	MPP1	26844	154031302	154036302
NM_001278371	chr17	-	41952726	41987079	MPP2	34353	41984579	41989579
NM_001330233	chr17	-	41878166	41910562	MPP3	32396	41908062	41913062
NM_033066	chr2	-	202509596	202563417	MPP4	53821	202560917	202565917
NM_022474	chr14	+	67708011	67802778	MPP5	94767	67705511	67710511
NM_016447	chr7	+	24612964	24733322	MPP6	120358	24610464	24615464
NR_134517	chr10	-	28339922	28591995	MPP7	252073	28589495	28594495
NR_040242	chr18	-	11883470	11908796	MPPE1	25326	11906296	11911296
NM_001044370	chr22	+	43808019	43902800	MPPED1	94781	43805519	43810519
NM_001145399	chr11	-	30406039	30607930	MPPED2	201891	30605430	30610430
NM_015134	chr17	+	16946073	17095962	MPRIP	149889	16943573	16948573
NM_001130517	chr22	+	37415682	37425863	MPST	10181	37413182	37418182
NM_002437	chr2	-	27532359	27545969	MPV17	13610	27543469	27548469
NM_173803	chr16	+	15489610	15503543	MPV17L	13933	15487110	15492110
NM_032683	chr19	+	18304039	18307550	MPV17L2	3511	18301539	18306539
NM_001315491	chr1	-	161274524	161279762	MPZ	5238	161277262	161282262
NM_024569	chr1	+	167691186	167761156	MPZL1	69970	167688686	167693686
NM_005797	chr11	-	118124130	118135251	MPZL2	11121	118132751	118137751
NR_104404	chr11	-	118097404	118123083	MPZL3	25679	118120583	118125583
NM_001310213	chr1	+	181002560	181031074	MR1	28514	181000060	181005060
NM_206898	chr21	+	33664123	33687094	MRAP	22971	33661623	33666623
NM_138409	chr6	+	84743377	84800605	MRAP2	57228	84740877	84745877
NM_001252091	chr3	+	138066489	138124377	MRAS	57888	138063989	138068989
NM_002438	chr10	+	17851341	18200091	MRC1	348750	17848841	17853841
NM_006039	chr17	+	60704761	60770962	MRC2	66201	60702261	60707261
NM_001330347	chr11	-	94150470	94227074	MRE11	76604	94224574	94229574
NM_018000	chr2	-	216807313	216878346	MREG	71033	216875846	216880846
NM_001272053	chr4	+	6641817	6644470	MRFAP1	2653	6639317	6644317
NR_136405	chr20	+	61427756	61433090	MRGBP	5334	61425256	61430256
NM_001039165	chr11	-	3249040	3253616	MRGPRE	4576	3251116	3256116
NM_145015	chr11	-	68771861	68780850	MRGPRF	8989	68778350	68783350
NR_120541	chr11	+	68779821	68785916	MRGPRF-AS1	6095	68777321	68782321
NR_027138	chr11	+	3239561	3244361	MRGPRG-AS1	4800	3237061	3242061
NM_054030	chr11	-	19076002	19082228	MRGPRX2	6226	19079728	19084728
NM_054031	chr11	+	18142501	18160027	MRGPRX3	17526	18140001	18145001
NM_032285	chr19	+	13875327	13885096	MRI1	9769	13872827	13877827
NM_001304732	chr10	-	61496747	61513203	MRLN	16456	61510703	61515703
NM_024864	chr17	+	34958024	34965407	MRM1	7383	34955524	34960524
NM_013393	chr7	-	2273925	2281833	MRM2	7908	2279333	2284333
NM_018146	chr17	+	685568	695749	MRM3	10181	683068	688068
NM_016175	chr5	-	179264265	179285840	MRNIP	21575	179283340	179288340
NM_001127174	chr18	-	48321489	48351754	MRO	30265	48349254	48354254
NM_032450	chr8	+	145202918	145316843	MROH1	113925	145200418	145205418
NM_001287395	chr2	+	234684324	234742069	MROH2A	57745	234681824	234686824
NM_173489	chr5	-	40998121	41071444	MROH2B	73323	41068944	41073944
NR_147176	chr1	+	200898071	200935796	MROH3P	37725	200895571	200900571
NM_207414	chr8	-	142443928	142517330	MROH5	73402	142514830	142519830
NM_001100878	chr8	-	144648362	144654928	MROH6	6566	144652428	144657428
NR_026782	chr1	+	55107412	55175940	MROH7	68528	55104912	55109912
NR_037640	chr1	+	55107412	55208328	MROH7-TTC4	100916	55104912	55109912
NM_152503	chr20	-	35729628	35807991	MROH8	78363	35805491	35810491
NM_001163629	chr1	+	170904611	171033906	MROH9	129295	170902111	170907111
NM_020236	chr4	+	78783804	78873944	MRPL1	90140	78781304	78786304
NM_145255	chr17	-	45900637	45908907	MRPL10	8270	45906407	45911407
NM_016050	chr11	-	66202545	66206319	MRPL11	3774	66203819	66208819
NM_002949	chr17	+	79670399	79674556	MRPL12	4157	79667899	79672899
NM_014078	chr8	-	121408082	121457647	MRPL13	49565	121455147	121460147
NM_001318771	chr6	-	44081190	44095228	MRPL14	14038	44092728	44097728
NM_014175	chr8	+	55047780	55061074	MRPL15	13294	55045280	55050280
NM_017840	chr11	-	59573607	59578345	MRPL16	4738	59575845	59580845
NM_022061	chr11	-	6701615	6704632	MRPL17	3017	6702132	6707132
NR_134864	chr6	+	160210843	160219461	MRPL18	8618	160208343	160213343
NM_014763	chr2	+	75873908	75889334	MRPL19	15426	75871408	75876408
NM_001300848	chr6	-	43021766	43027283	MRPL2	5517	43024783	43029783
NM_017971	chr1	-	1337275	1342693	MRPL20	5418	1340193	1345193
NM_181515	chr11	-	68658745	68671303	MRPL21	12558	68668803	68673803
NM_014180	chr5	+	154320632	154348971	MRPL22	28339	154318132	154323132
NM_021134	chr11	+	1968501	1977839	MRPL23	9338	1966001	1971001
NR_024471	chr11	-	2004438	2011150	MRPL23-AS1	6712	2008650	2013650
NM_145729	chr1	-	156707093	156710923	MRPL24	3830	156708423	156713423
NM_016504	chr17	-	48445227	48450562	MRPL27	5335	48448062	48453062
NM_006428	chr16	-	417383	420569	MRPL28	3186	418069	423069
NM_007208	chr3	-	131181044	131221860	MRPL3	40816	131219360	131224360
NR_028356	chr2	+	99797541	99816020	MRPL30	18479	99795041	99800041
NM_031903	chr7	+	42971938	42977453	MRPL32	5515	42969438	42974438
NM_145330	chr2	+	27994583	28002608	MRPL33	8025	27992083	27997083
NM_016622	chr2	+	86426555	86440477	MRPL35	13922	86424055	86429055
NM_001330602	chr1	+	54665839	54691162	MRPL37	25323	54663339	54668339
NM_032478	chr17	-	73894723	73901181	MRPL38	6458	73898681	73903681
NM_017446	chr21	-	26957967	26979801	MRPL39	21834	26977301	26982301
NM_146388	chr19	+	10362639	10370736	MRPL4	8097	10360139	10365139
NM_003776	chr22	+	19419424	19423601	MRPL40	4177	19416924	19421924
NM_014050	chr12	+	93861265	93897548	MRPL42	36283	93858765	93863765
NM_176792	chr10	-	102737578	102747272	MRPL43	9694	102744772	102749772
NM_022915	chr2	+	224822120	224832431	MRPL44	10311	224819620	224824620
NM_001278279	chr17	+	36452988	36479101	MRPL45	26113	36450488	36455488
NR_033934	chr17	-	45527592	45569986	MRPL45P2	42394	45567486	45572486
NM_022163	chr15	-	89002708	89010633	MRPL46	7925	89008133	89013133
NM_177988	chr3	-	179306254	179322434	MRPL47	16180	179319934	179324934
NM_001318498	chr11	+	73498916	73575656	MRPL48	76740	73496416	73501416
NR_037567	chr11	+	64889654	64894841	MRPL49	5187	64887154	64892154
NM_019051	chr9	-	104152248	104160919	MRPL50	8671	104158419	104163419
NM_181307	chr14	+	23299091	23304246	MRPL52	5155	23296591	23301591
NM_172251	chr19	+	3762664	3767563	MRPL54	4899	3760164	3765164
NM_181456	chr1	-	228294379	228297013	MRPL55	2634	228294513	228299513
NM_024026	chr13	+	21750371	21753220	MRPL57	2849	21747871	21752871
NM_001303265	chr17	+	73008758	73017356	MRPL58	8598	73006258	73011258
NM_001300733	chr1	-	151732118	151736392	MRPL9	4274	151733892	151738892
NM_018141	chr6	-	42174538	42185633	MRPS10	11095	42183133	42188133
NM_001321972	chr15	+	89010683	89023998	MRPS11	13315	89008183	89013183
NR_037606	chr1	-	174982093	174992591	MRPS14	10498	174990091	174995091
NM_031280	chr1	-	36921361	36930040	MRPS15	8679	36927540	36932540
NM_016065	chr10	-	75008600	75012451	MRPS16	3851	75009951	75014951
NM_015969	chr7	+	56019610	56023033	MRPS17	3423	56017110	56022110
NM_001193343	chr6	-	43638933	43655549	MRPS18A	16616	43653049	43658049
NM_014046	chr6	+	30585485	30594174	MRPS18B	8689	30582985	30587985
NM_001297770	chr4	+	84377084	84382876	MRPS18C	5792	84374584	84379584
NR_051970	chr9	+	138392476	138396519	MRPS2	4043	138389976	138394976
NM_018997	chr1	+	150266261	150281414	MRPS21	15153	150263761	150268761
NM_020191	chr3	+	139062860	139075887	MRPS22	13027	139060360	139065360
NM_016070	chr17	-	55916286	55927433	MRPS23	11147	55924933	55929933
NM_032014	chr7	-	43906156	43909145	MRPS24	2989	43906645	43911645
NR_135247	chr3	-	15083757	15106844	MRPS25	23087	15104344	15109344
NM_001286748	chr5	-	71515235	71616084	MRPS27	100849	71613584	71618584
NM_014018	chr8	-	80831094	80942506	MRPS28	111412	80940006	80945006
NM_016640	chr5	+	44809026	44815618	MRPS30	6592	44806526	44811526
NM_005830	chr13	-	41303431	41345347	MRPS31	41916	41342847	41347847
NR_051965	chr13	-	52741844	52768602	MRPS31P5	26758	52766102	52771102
NM_053035	chr7	-	140705960	140714781	MRPS33	8821	140712281	140717281
NM_021821	chr12	+	27863705	27909237	MRPS35	45532	27861205	27866205
NM_033281	chr5	+	68513572	68525985	MRPS36	12413	68511072	68516072
NR_136152	chr2	-	95751135	95787772	MRPS5	36637	95785272	95790272
NM_032476	chr21	+	35445822	35515334	MRPS6	69512	35443322	35448322
NM_015971	chr17	+	73257748	73262457	MRPS7	4709	73255248	73260248
NM_182640	chr2	+	105654482	105716418	MRPS9	61936	105651982	105656982
NM_138777	chr9	+	125026881	125087594	MRRF	60713	125024381	125029381
NR_104423	chr6	+	24403135	24426422	MRS2	23287	24400635	24405635
NR_024072	chr12	-	72242073	72244763	MRS2P2	2690	72242263	72247263
NM_016183	chr1	+	19578074	19586622	MRTO4	8548	19575574	19580574
NM_001206881	chr11	-	10594637	10715535	MRVI1	120898	10713035	10718035
NR_046375	chr11	+	10562782	10621479	MRVI1-AS1	58697	10560282	10565282
NM_152866	chr11	+	60223281	60238225	MS4A1	14944	60220781	60225781
NM_206893	chr11	+	60552820	60568778	MS4A10	15958	60550320	60555320
NM_017716	chr11	+	60260250	60274901	MS4A12	14651	60257750	60262750
NM_001278320	chr11	+	60282885	60310191	MS4A13	27306	60280385	60285385
NR_049734	chr11	+	60163486	60185228	MS4A14	21742	60160986	60165986
NM_152717	chr11	+	60524339	60544204	MS4A15	19865	60521839	60526839
NM_001310141	chr11	+	60491481	60511686	MS4A18	20205	60488981	60493981
NM_001256916	chr11	+	59856136	59865940	MS4A2	9804	59853636	59858636
NM_001031666	chr11	+	59824100	59838588	MS4A3	14488	59821600	59826600
NM_024021	chr11	+	60048013	60076445	MS4A4A	28432	60045513	60050513
NM_001351235	chr11	-	59968725	60010561	MS4A4E	41836	60008061	60013061
NM_023945	chr11	+	60197061	60215265	MS4A5	18204	60194561	60199561
NM_152852	chr11	-	59939079	59952139	MS4A6A	13060	59949639	59954639
NM_139249	chr11	+	60102354	60108441	MS4A6E	6087	60099854	60104854
NM_206938	chr11	+	60145957	60163426	MS4A7	17469	60143457	60148457
NM_031457	chr11	+	60467046	60483285	MS4A8	16239	60464546	60469546
NM_001330620	chr4	+	3246095	3258340	MSANTD1	12245	3243595	3248595
NM_001308027	chr11	-	124636393	124670300	MSANTD2	33907	124667800	124672800
NM_001198807	chr9	+	103189494	103214016	MSANTD3	24522	103186994	103191994
NM_001198812	chr9	+	103204187	103339918	MSANTD3-TMEFF1	135731	103201687	103206687
NM_032424	chr11	-	105878647	105893014	MSANTD4	14367	105890514	105895514
NM_005098	chr8	-	72753776	72756731	MSC	2955	72754231	72759231
NR_033652	chr8	+	72755357	72968547	MSC-AS1	213190	72752857	72757857
NM_000251	chr2	+	47630205	47710367	MSH2	80162	47627705	47632705
NM_002439	chr5	+	79950466	80172634	MSH3	222168	79947966	79952966
NM_002440	chr1	+	76262555	76378923	MSH4	116368	76260055	76265055
NM_002441	chr6_mcf_hap5	+	3087408	3110152	MSH5	22744	3084908	3089908
NR_037846	chr6_mcf_hap5	+	3087408	3112321	MSH5-SAPCD1	24913	3084908	3089908
NM_001281493	chr2	+	48010220	48034092	MSH6	23872	48007720	48012720
NM_002442	chr12	-	120779132	120806983	MSI1	27851	120804483	120809483
NM_001322250	chr17	+	55333211	55762050	MSI2	428839	55330711	55335711
NM_001012241	chr17	+	38278789	38293045	MSL1	14256	38276289	38281289
NM_018133	chr3	-	135867759	135914688	MSL2	46929	135912188	135917188
NM_078629	chrX	+	11776277	11793872	MSL3	17595	11773777	11778777
NR_024322	chr2	-	234774089	234777055	MSL3P1	2966	234774555	234779555
NM_001177355	chr16	+	810764	818865	MSLN	8101	808264	813264
NM_002443	chr10	+	51549552	51562518	MSMB	12966	51547052	51552052
NM_006745	chr4	+	166248817	166264314	MSMO1	15497	166246317	166251317
NM_002444	chrX	+	64887510	64961793	MSN	74283	64885010	64890010
NM_138716	chr8	-	15965386	16050300	MSR1	84914	16047800	16052800
NM_001135670	chr8	+	9911778	10286401	MSRA	374623	9909278	9914278
NM_016332	chr16	-	1988229	1993327	MSRB1	5098	1990827	1995827
NM_012228	chr10	+	23384426	23410942	MSRB2	26516	23381926	23386926
NM_001193460	chr12	+	65672422	65860687	MSRB3	188265	65669922	65674922
NM_001024593	chr10	-	75183336	75193319	MSS51	9983	75190819	75195819
NM_020998	chr3	-	49721379	49726196	MST1	4817	49723696	49728696
NM_001271733	chr1	-	17081128	17090975	MST1L	9847	17088475	17093475
NR_027504	chr1	+	16972068	16976915	MST1P2	4847	16969568	16974568
NR_134919	chr3	-	49924435	49941070	MST1R	16635	49938570	49943570
NM_005259	chr2	-	190920425	190927455	MSTN	7030	190924955	190929955
NM_018116	chr1	+	155579960	155584758	MSTO1	4798	155577460	155582460
NR_024117	chr1	+	155715558	155720479	MSTO2P	4921	155713058	155718058
NM_002448	chr4	+	4861391	4865660	MSX1	4269	4858891	4863891
NM_002449	chr5	+	174151574	174157902	MSX2	6328	174149074	174154074
NM_032935	chr16	+	56598960	56602869	MT4	3909	56596460	56601460
NM_001203258	chr14	+	105886185	105937057	MTA1	50872	105883685	105888685
NM_004739	chr11	-	62360674	62369312	MTA2	8638	62366812	62371812
NM_001282755	chr2	+	42721708	42984087	MTA3	262379	42719208	42724208
NM_002451	chr9	+	21802634	21865969	MTAP	63335	21800134	21805134
NM_022045	chr8	+	121457637	121535875	MTBP	78238	121455137	121460137
NR_130739	chr6	-	36935910	36954327	MTCH1	18417	36951827	36956827
NM_014342	chr11	-	47638857	47664206	MTCH2	25349	47661706	47666706
NM_015210	chr18	+	8717368	8832775	MTCL1	115407	8714868	8719868
NM_001018025	chrX	-	154292308	154299547	MTCP1	7239	154297047	154302047
NM_178812	chr8	+	98656406	98742488	MTDH	86082	98653906	98658906
NM_001301135	chr7	-	91502190	91510034	MTERF1	7844	91507534	91512534
NM_025198	chr12	-	107371068	107380944	MTERF2	9876	107378444	107383444
NM_015942	chr8	-	97251625	97273841	MTERF3	22216	97271341	97276341
NR_138463	chr2	-	242013808	242041747	MTERF4	27939	242039247	242044247
NM_005955	chr1	-	38275238	38325292	MTF1	50054	38322792	38327792
NM_007358	chr1	+	93544791	93604638	MTF2	59847	93542291	93547291
NM_139242	chr15	-	65293849	65321977	MTFMT	28128	65319477	65324477
NM_016498	chr22	+	30821610	30825041	MTFP1	3431	30819110	30824110
NM_014637	chr8	+	66556887	66622798	MTFR1	65911	66554387	66559387
NM_001099627	chr1	+	26146396	26159433	MTFR1L	13037	26143896	26148896
NM_138419	chr6	-	136552167	136571473	MTFR2	19306	136568973	136573973
NM_138384	chr10	+	135207620	135234174	MTG1	26554	135205120	135210120
NM_015666	chr20	+	60758080	60777810	MTG2	19730	60755580	60760580
NM_005956	chr14	+	64854758	64926725	MTHFD1	71967	64852258	64857258
NM_015440	chr6	+	151186814	151423023	MTHFD1L	236209	151184314	151189314
NM_006636	chr2	+	74425689	74442424	MTHFD2	16735	74423189	74428189
NM_001351314	chr4	+	75023824	75168814	MTHFD2L	144990	75021324	75026324
NR_077228	chr3	-	95373266	95402037	MTHFD2P1	28771	95399537	95404537
NM_005957	chr1	-	11845786	11866160	MTHFR	20374	11863660	11868660
NM_001199758	chr15	-	80135888	80189627	MTHFS	53739	80187127	80192127
NM_001159378	chr16	-	86563781	86588841	MTHFSD	25060	86586341	86591341
NM_001321003	chr2	-	55463755	55496384	MTIF2	32629	55493884	55498884
NM_152912	chr13	-	28009775	28024739	MTIF3	14964	28022239	28027239
NM_000252	chrX	+	149737046	149841616	MTM1	104570	149734546	149739546
NM_003828	chrX	+	149861836	149933576	MTMR1	71740	149859336	149864336
NM_017762	chr15	-	31231143	31283807	MTMR10	52664	31281307	31286307
NM_001145862	chr1	-	149900542	149908791	MTMR11	8249	149906291	149911291
NM_001294344	chr5	-	32227112	32313114	MTMR12	86002	32310614	32315614
NM_022485	chr3	+	9691116	9744078	MTMR14	52962	9688616	9693616
NM_001243571	chr11	-	95566043	95657371	MTMR2	91328	95654871	95659871
NM_021090	chr22	+	30279157	30426857	MTMR3	147700	30276657	30281657
NM_004687	chr17	-	56566892	56595251	MTMR4	28359	56592751	56597751
NM_004685	chr13	-	25820340	25861704	MTMR6	41364	25859204	25864204
NM_004686	chr8	-	17154305	17271040	MTMR7	116735	17268540	17273540
NM_017677	chrX	-	63487960	63615333	MTMR8	127373	63612833	63617833
NM_015458	chr8	+	11141999	11185654	MTMR9	43655	11139499	11144499
NR_026850	chr1	-	32697260	32707311	MTMR9LP	10051	32704811	32709811
NM_005958	chr4	-	187454808	187476721	MTNR1A	21913	187474221	187479221
NM_005959	chr11	+	92702788	92715948	MTNR1B	13160	92700288	92705288
NM_012123	chr6	+	74171453	74211179	MTO1	39726	74168953	74173953
NM_004958	chr1	-	11166587	11322608	MTOR	156021	11320108	11325108
NR_046600	chr1	+	11203954	11209595	MTOR-AS1	5641	11201454	11206454
NM_018109	chr10	-	30598729	30638267	MTPAP	39538	30635767	30640767
NM_145808	chr7	-	135611502	135662204	MTPN	50702	135659704	135664704
NM_001291940	chr1	+	236958580	237067281	MTR	108701	236956080	236961080
NM_004294	chr13	-	41790515	41837713	MTRF1	47198	41835213	41840213
NM_019041	chr6	-	153308500	153323950	MTRF1L	15450	153321450	153326450
NR_134480	chr5	+	7869216	7901235	MTRR	32019	7866716	7871716
NM_001282974	chr8	-	125563010	125740748	MTSS1	177738	125738248	125743248
NM_138383	chr16	-	70695106	70719954	MTSS1L	24848	70717454	70722454
NM_000253	chr4	+	100485234	100545154	MTTP	59920	100482734	100487734
NM_152793	chr7	+	30174551	30202381	MTURN	27830	30172051	30177051
NM_001001924	chr8	-	17501302	17658426	MTUS1	157124	17655926	17660926
NM_001033602	chr13	+	29598747	30080084	MTUS2	481337	29596247	29601247
NR_046378	chr13	-	30050651	30061887	MTUS2-AS1	11236	30059387	30064387
NM_002455	chr1	+	155178489	155183630	MTX1	5141	155175989	155180989
NM_001319098	chr2	+	177134122	177202753	MTX2	68631	177131622	177136622
NM_001167741	chr5	-	79272538	79287088	MTX3	14550	79284588	79289588
NM_002456	chr1	-	155158299	155162706	MUC1	4407	155160206	155165206
NM_001164462	chr7	+	100612903	100662230	MUC12	49327	100610403	100615403
NM_033049	chr3	-	124624288	124653595	MUC13	29307	124651095	124656095
NM_001135091	chr11	-	26580578	26593815	MUC15	13237	26591315	26596315
NM_024690	chr19	-	8959519	9092018	MUC16	132499	9089518	9094518
NM_001040105	chr7	+	100663363	100702140	MUC17	38777	100660863	100665863
NM_173600	chr12	+	40787195	40964557	MUC19	177362	40784695	40789695
NM_002457	chr11	+	1074874	1104416	MUC2	29542	1072374	1077374
NM_001282506	chr3	+	195447752	195460424	MUC20	12672	195445252	195450252
NR_130720	chr6_qbl_hap6	+	2244469	2250864	MUC21	6395	2241969	2246969
NM_001318484	chr6_mann_hap4	+	2069705	2351537	MUC22	281832	2067205	2072205
NM_005960	chr7	+	100547051	100611619	MUC3A	64568	100544551	100549551
NM_018406	chr3	-	195473637	195538844	MUC4	65207	195536344	195541344
NM_001304359	chr11	+	1151579	1222366	MUC5AC	70787	1149079	1154079
NM_002458	chr11	+	1244294	1283406	MUC5B	39112	1241794	1246794
NM_005961	chr11	-	1012823	1036706	MUC6	23883	1034206	1039206
NM_001145006	chr4	+	71296208	71348714	MUC7	52506	71293708	71298708
NM_058173	chr12	+	55248298	55252174	MUCL1	3876	55245798	55250798
NM_024544	chr1	-	20825940	20834674	MUL1	8734	20832174	20837174
NM_032853	chr19	+	1354975	1378430	MUM1	23455	1352475	1357475
NM_152423	chrX	+	105412297	105452949	MUM1L1	40652	105409797	105414797
NR_146598	chr11	+	65627871	65635123	MUS81	7252	65625371	65630371
NM_001166280	chr9	+	113431050	113563278	MUSK	132228	113428550	113433550
NM_000255	chr6	-	49398072	49431041	MUT	32969	49428541	49433541
NM_001293190	chr1	-	45794913	45806142	MUTYH	11229	45803642	45808642
NM_001304547	chr19	+	17516494	17536148	MVB12A	19654	17513994	17518994
NM_033446	chr9	+	129089122	129269320	MVB12B	180198	129086622	129091622
NM_002461	chr16	-	88718347	88729557	MVD	11210	88727057	88732057
NM_000431	chr12	+	110011499	110035075	MVK	23576	110008999	110013999
NM_005115	chr16	+	29831714	29859360	MVP	27646	29829214	29834214
NM_001144925	chr21	+	42792484	42831141	MX1	38657	42789984	42794984
NM_002463	chr21	+	42733949	42780869	MX2	46920	42731449	42736449
NM_002357	chr2	+	70142172	70170076	MXD1	27904	70139672	70144672
NM_001142935	chr5	-	176732500	176739292	MXD3	6792	176736792	176741792
NM_006454	chr4	-	2249159	2263739	MXD4	14580	2261239	2266239
NM_130439	chr10	+	111967362	112047123	MXI1	79761	111964862	111969862
NM_015419	chrX	-	3226605	3264684	MXRA5	38079	3262184	3267184
NM_001008528	chr17	-	74669731	74707087	MXRA7	37356	74704587	74709587
NM_001282582	chr1	-	1288068	1298921	MXRA8	10853	1296421	1301421
NM_001290193	chr19	+	54368837	54379689	MYADM	10852	54366337	54371337
NM_001145113	chr17	-	79897520	79905109	MYADML2	7589	79902609	79907609
NR_134963	chr6	+	135502452	135540311	MYB	37859	135499952	135504952
NM_014520	chr17	-	4442190	4458681	MYBBP1A	16491	4456181	4461181
NM_001144755	chr8	-	67474409	67525484	MYBL1	51075	67522984	67527984
NM_001278610	chr20	+	42295658	42345136	MYBL2	49478	42293158	42298158
NM_002465	chr12	+	101988708	102079658	MYBPC1	90950	101986208	101991208
NM_004533	chr19	+	50936159	50969583	MYBPC2	33424	50933659	50938659
NM_000256	chr11	-	47352956	47374253	MYBPC3	21297	47371753	47376753
NM_004997	chr1	-	203136938	203144942	MYBPH	8004	203142442	203147442
NM_001265613	chr1	-	109834986	109849663	MYBPHL	14677	109847163	109852163
NM_002467	chr8	+	128748314	128753680	MYC	5366	128745814	128750814
NM_012333	chr1	-	39328161	39339050	MYCBP	10889	39336550	39341550
NM_015057	chr13	-	77618791	77901177	MYCBP2	282386	77898677	77903677
NR_046716	chr13	+	77649648	77661911	MYCBP2-AS1	12263	77647148	77652148
NM_032133	chr17	+	48585744	48608862	MYCBPAP	23118	48583244	48588244
NM_001033082	chr1	-	40361095	40367687	MYCL	6592	40365187	40370187
NM_001293228	chr2	+	16080559	16087129	MYCN	6570	16078059	16083059
NR_110230	chr2	-	16076386	16081845	MYCNOS	5459	16079345	16084345
NR_125783	chr2	+	16060520	16076140	MYCNUT	15620	16058020	16063020
NM_025107	chr6	+	153019029	153045715	MYCT1	26686	153016529	153021529
NM_002468	chr3	+	38179968	38184512	MYD88	4544	38177468	38182468
NM_019107	chr19	-	4657556	4670415	MYDGF	12859	4667915	4672915
NM_001301210	chr15	-	48431624	48470558	MYEF2	38934	48468058	48473058
NM_001300924	chr11	+	69061604	69064754	MYEOV	3150	69059104	69064104
NM_005593	chr12	+	81110707	81113447	MYF5	2740	81108207	81113207
NM_005963	chr17	-	10395626	10421859	MYH1	26233	10419359	10424359
NM_001256095	chr17	-	8377522	8534079	MYH10	156557	8531579	8536579
NM_001040113	chr16	-	15796991	15950887	MYH11	153896	15948387	15953387
NM_003802	chr17	-	10204182	10276322	MYH13	72140	10273822	10278822
NM_001145809	chr19	+	50706884	50813801	MYH14	106917	50704384	50709384
NM_014981	chr3	-	108099215	108248169	MYH15	148954	108245669	108250669
NR_002147	chr7	+	98870923	98895594	MYH16	24671	98868423	98873423
NM_017534	chr17	-	10424464	10453017	MYH2	28553	10450517	10455517
NM_002470	chr17	-	10531842	10560626	MYH3	28784	10558126	10563126
NM_017533	chr17	-	10346607	10372876	MYH4	26269	10370376	10375376
NM_002471	chr14	-	23851198	23877486	MYH6	26288	23874986	23879986
NM_000257	chr14	-	23881946	23904895	MYH7	22949	23902395	23907395
NM_020884	chr20	+	33543637	33590240	MYH7B	46603	33541137	33546137
NM_002472	chr17	-	10293641	10325267	MYH8	31626	10322767	10327767
NM_002473	chr22	-	36677322	36784112	MYH9	106790	36781612	36786612
NR_125367	chr17	+	10286448	10528857	MYHAS	242409	10283948	10288948
NM_079420	chr2	-	211154867	211179895	MYL1	25028	211177395	211182395
NM_138403	chr7	-	101256604	101272576	MYL10	15972	101270076	101275076
NM_001303048	chr18	+	3247479	3256235	MYL12A	8756	3244979	3249979
NM_033546	chr18	+	3262110	3278282	MYL12B	16172	3259610	3264610
NM_000432	chr12	-	111348623	111358404	MYL2	9781	111355904	111360904
NM_000258	chr3	-	46899356	46904973	MYL3	5617	46902473	46907473
NM_001002841	chr17	+	45286427	45301045	MYL4	14618	45283927	45288927
NM_002477	chr4	+	671710	675817	MYL5	4107	669210	674210
NM_079423	chr12	+	56552044	56555366	MYL6	3322	56549544	56554544
NM_001199629	chr12	+	56546203	56551771	MYL6B	5568	56543703	56548703
NM_181526	chr20	+	35169886	35178226	MYL9	8340	35167386	35172386
NM_013262	chr6	+	16129316	16148478	MYLIP	19162	16126816	16131816
NM_053027	chr3	-	123331142	123603149	MYLK	272007	123600649	123605649
NR_038266	chr3	+	123304359	123349666	MYLK-AS1	45307	123301859	123306859
NR_046629	chr3	+	123408490	123411254	MYLK-AS2	2764	123405990	123410990
NM_033118	chr20	+	30407177	30422500	MYLK2	15323	30404677	30409677
NM_001308301	chr16	-	46736193	46797158	MYLK3	60965	46794658	46799658
NM_001347872	chr6	-	2663862	2770564	MYLK4	106702	2768064	2773064
NM_001324459	chr16	+	30382254	30389312	MYLPF	7058	30379754	30384754
NM_001080483	chr9	-	136379707	136390068	MYMK	10361	136387568	136392568
NM_001185118	chr3	+	169490852	169507504	MYNN	16652	169488352	169493352
NM_012334	chr5	-	16662015	16936385	MYO10	274370	16933885	16938885
NM_016239	chr17	+	18012019	18083116	MYO15A	71097	18009519	18014519
NM_001309242	chr17	+	73584138	73622927	MYO15B	38789	73581638	73586638
NM_015011	chr13	+	109248499	109860355	MYO16	611856	109245999	109250999
NR_047700	chr13	-	109816252	109819651	MYO16-AS1	3399	109817151	109822151
NM_203318	chr17	-	27400527	27507407	MYO18A	106880	27504907	27509907
NM_032608	chr22	+	26138110	26427007	MYO18B	288897	26135610	26140610
NM_025109	chr17	-	34851598	34891305	MYO19	39707	34888805	34893805
NM_001256041	chr12	-	57422300	57444549	MYO1A	22249	57442049	57447049
NM_001330238	chr2	+	192110001	192290115	MYO1B	180114	192107501	192112501
NM_001080779	chr17	-	1367479	1396001	MYO1C	28522	1393501	1398501
NM_015194	chr17	-	30819539	31204191	MYO1D	384652	31201691	31206691
NM_004998	chr15	-	59428167	59665071	MYO1E	236904	59662571	59667571
NM_001348355	chr19	-	8585673	8642331	MYO1F	56658	8639831	8644831
NM_033054	chr7	-	45002259	45018704	MYO1G	16445	45016204	45021204
NM_001101421	chr12	+	109826523	109886176	MYO1H	59653	109824023	109829023
NM_017433	chr10	+	26223001	26501465	MYO3A	278464	26220501	26225501
NR_045684	chr2	+	171034654	171511674	MYO3B	477020	171032154	171037154
NM_000259	chr15	-	52599479	52821247	MYO5A	221768	52818747	52823747
NM_001080467	chr18	-	47349155	47721451	MYO5B	372296	47718951	47723951
NM_018728	chr15	-	52484514	52587995	MYO5C	103481	52585495	52590495
NM_001300899	chr6	+	76458892	76629254	MYO6	170362	76456392	76461392
NM_000260	chr11	+	76839309	76926286	MYO7A	86977	76836809	76841809
NM_001080527	chr2	+	128293377	128395303	MYO7B	101926	128290877	128295877
NM_006901	chr15	-	72118360	72410440	MYO9A	292080	72407940	72412940
NM_004145	chr19	+	17186590	17324104	MYO9B	137514	17184090	17189090
NM_000261	chr1	-	171604556	171621773	MYOC	17217	171619273	171624273
NM_153604	chr17	+	12569206	12672265	MYOCD	103059	12566706	12571706
NM_002478	chr11	+	17741109	17743678	MYOD1	2569	17738609	17743609
NM_013451	chr10	-	95066185	95242074	MYOF	175889	95239574	95244574
NM_002479	chr1	-	203052256	203055166	MYOG	2910	203052666	203057666
NM_003803	chr18	-	3066804	3220106	MYOM1	153302	3217606	3222606
NM_003970	chr8	+	1993157	2093380	MYOM2	100223	1990657	1995657
NM_152372	chr1	-	24382530	24438665	MYOM3	56135	24436165	24441165
NR_146555	chr2	+	208104534	208110611	MYOSLID	6077	208102034	208107034
NM_001300911	chr5	+	137203544	137223540	MYOT	19996	137201044	137206044
NM_021245	chr10	-	75391369	75401515	MYOZ1	10146	75399015	75404015
NM_016599	chr4	+	120056938	120108944	MYOZ2	52006	120054438	120059438
NM_133371	chr5	+	150040402	150058930	MYOZ3	18528	150037902	150042902
NR_045662	chr10	+	69865873	69971773	MYPN	105900	69863373	69868373
NM_001012643	chr19	-	46393280	46405862	MYPOP	12582	46403362	46408362
NM_001127392	chr11	+	61520108	61555990	MYRF	35882	61517608	61522608
NM_182530	chr12	+	70219102	70352505	MYRFL	133403	70216602	70221602
NM_001284423	chr3	+	39850404	40301811	MYRIP	451407	39847904	39852904
NM_001085487	chr1	-	59120410	59165747	MYSM1	45337	59163247	59168247
NM_004535	chr20	+	62795826	62873606	MYT1	77780	62793326	62798326
NM_015025	chr2	-	1792884	2335085	MYT1L	542201	2332585	2337585
NR_024468	chr2	+	2323003	2330880	MYT1L-AS1	7877	2320503	2325503
NM_152451	chr15	+	57884101	57977562	MYZAP	93461	57881601	57886601
NM_003422	chr19	-	59073283	59084942	MZF1	11659	59082442	59087442
NR_027334	chr19	+	59070552	59086164	MZF1-AS1	15612	59068052	59073052
NM_001071775	chr13	-	73282494	73301938	MZT1	19444	73299438	73304438
NM_001085365	chr2	-	132241532	132250064	MZT2A	8532	132247564	132252564
NM_001330282	chr2	+	130939494	130948302	MZT2B	8808	130936994	130941994
NM_153029	chr16	-	48572636	48644120	N4BP1	71484	48641620	48646620
NM_001318359	chr4	+	40058523	40159872	N4BP2	101349	40056023	40061023
NM_001286461	chr13	-	32974859	33002315	N4BP2L1	27456	32999815	33004815
NM_001278432	chr13	-	33006624	33113022	N4BP2L2	106398	33110522	33115522
NR_026928	chr13	-	33078642	33083532	N4BP2L2-IT2	4890	33081032	33086032
NM_015111	chr5	+	177540555	177553107	N4BP3	12552	177538055	177543055
NR_047510	chr21	-	30244512	30257695	N6AMT1	13183	30255195	30260195
NM_001256120	chrX	-	153195279	153200607	NAA10	5328	153198107	153203107
NM_032693	chr4	-	80238271	80247171	NAA11	8900	80244671	80249671
NM_057175	chr4	+	140222620	140311935	NAA15	89315	140220120	140225120
NM_024561	chr13	+	41885340	41951166	NAA16	65826	41882840	41887840
NM_181528	chr20	+	19997933	20014273	NAA20	16340	19995433	20000433
NM_024953	chr12	-	112464492	112546635	NAA25	82143	112544135	112549135
NM_001011713	chr14	+	57857270	57879466	NAA30	22196	57854770	57859770
NM_001321882	chr9	+	88556443	88640377	NAA35	83934	88553943	88558943
NM_001330111	chr17	-	7759998	7788706	NAA38	28708	7786206	7791206
NM_024771	chr11	+	63706441	63724791	NAA40	18350	63703941	63708941
NM_001308445	chr3	-	113435306	113465146	NAA50	29840	113462646	113467646
NM_001317093	chr16	+	3493610	3536963	NAA60	43353	3491110	3496110
NM_001042402	chr4	-	76831807	76862166	NAAA	30359	76859666	76864666
NM_005467	chr11	+	89867817	89925779	NAALAD2	57962	89865317	89870317
NM_005468	chr11	-	64812294	64826009	NAALADL1	13715	64823509	64828509
NM_207015	chr3	+	174577110	175523428	NAALADL2	946318	174574610	174579610
NR_046714	chr3	-	175491365	175494121	NAALADL2-AS1	2756	175491621	175496621
NR_046713	chr3	-	174952881	174988885	NAALADL2-AS2	36004	174986385	174991385
NR_046390	chr3	-	174797101	174833032	NAALADL2-AS3	35931	174830532	174835532
NM_001321313	chr2	+	191513620	191557492	NAB1	43872	191511120	191516120
NM_005967	chr12	+	57482676	57489259	NAB2	6583	57480176	57485176
NM_001254736	chr2	+	192542797	192553248	NABP1	10451	192540297	192545297
NM_024068	chr12	+	56618124	56623638	NABP2	5514	56615624	56620624
NM_001320194	chr12	-	57106210	57119326	NACA	13116	57116826	57121826
NM_001146334	chr7	-	45120035	45128493	NACAD	8458	45125993	45130993
NM_052876	chr19	+	13229101	13251961	NACC1	22860	13226601	13231601
NM_144653	chr9	-	138898382	138987131	NACC2	88749	138984631	138989631
NM_001198994	chr1	-	1682670	1711508	NADK	28838	1709008	1714008
NM_001287341	chr5	-	36192690	36242381	NADK2	49691	36239881	36244881
NM_018161	chr11	+	71164216	71212581	NADSYN1	48365	71161716	71166716
NM_001286500	chr16	-	66836780	66864879	NAE1	28099	66862379	66867379
NM_001128931	chr4	-	164047859	164088073	NAF1	40214	164085573	164090573
NM_000262	chr22	-	42454337	42466846	NAGA	12509	42464346	42469346
NM_017567	chr2	+	71295407	71305998	NAGK	10591	71292907	71297907
NM_000263	chr17	+	40687950	40696466	NAGLU	8516	40685450	40690450
NM_016256	chr16	-	5074844	5083942	NAGPA	9098	5081442	5086442
NR_038913	chr16	+	5083702	5092972	NAGPA-AS1	9270	5081202	5086202
NM_153006	chr17	+	42082031	42086436	NAGS	4405	42079531	42084531
NM_197956	chr9	-	130823511	130829599	NAIF1	6088	130827099	130832099
NM_022892	chr5	-	70264309	70320941	NAIP	56632	70318441	70323441
NM_052867	chr13	-	101706125	102068859	NALCN	362734	102066359	102071359
NR_047687	chr13	+	101360578	101711638	NALCN-AS1	351060	101358078	101363078
NR_102270	chr9	-	102117621	102137539	NAMA	19918	102135039	102140039
NM_005746	chr7	-	105888731	105925638	NAMPT	36907	105923138	105928138
NM_001297698	chr12	+	7941991	7948657	NANOG	6666	7939491	7944491
NM_001145465	chr12	+	7917811	7926717	NANOGNB	8906	7915311	7920311
NM_199461	chr10	+	120789227	120793244	NANOS1	4017	120786727	120791727
NR_146095	chr19	+	13972876	13991571	NANOS3	18695	13970376	13975376
NM_152667	chr20	-	25593572	25604648	NANP	11076	25602148	25607148
NM_018946	chr9	+	100818958	100845365	NANS	26407	100816458	100821458
NM_139207	chr12	-	76438524	76478813	NAP1L1	40289	76476313	76481313
NM_021963	chrX	-	72432136	72434710	NAP1L2	2574	72432210	72437210
NM_004538	chrX	-	92925924	92928682	NAP1L3	2758	92926182	92931182
NM_005969	chr11	-	2965659	3013607	NAP1L4	47948	3011107	3016107
NM_003827	chr19	-	47990890	48018515	NAPA	27625	48016015	48021015
NR_038452	chr19	+	47987538	48004854	NAPA-AS1	17316	47985038	47990038
NM_022080	chr20	-	23355155	23402156	NAPB	47001	23399656	23404656
NM_198990	chr7	-	102740022	102789569	NAPEPLD	49547	102787069	102792069
NM_003826	chr18	+	10525872	10552766	NAPG	26894	10523372	10528372
NM_001286829	chr8	-	144656954	144660521	NAPRT	3567	144658021	144663021
NM_004851	chr19	-	50861728	50869087	NAPSA	7359	50866587	50871587
NR_002798	chr19	-	50837056	50848005	NAPSB	10949	50845505	50850505
NM_001038618	chr17	+	80416059	80446143	NARF	30084	80413559	80418559
NM_001304799	chr16	-	779754	791038	NARFL	11284	788538	793538
NM_004539	chr18	-	55267893	55289177	NARS	21284	55286677	55291677
NM_001243251	chr11	-	78147006	78285909	NARS2	138903	78283409	78288409
NM_152298	chr1	+	46049659	46084578	NASP	34919	46047159	46052159
NM_001160179	chr8	+	18027970	18081198	NAT1	53228	18025470	18030470
NM_024662	chr11	+	34127110	34168458	NAT10	41348	34124610	34129610
NM_198571	chr7	-	100813773	100823557	NAT16	9784	100821057	100826057
NM_000015	chr8	+	18248754	18258723	NAT2	9969	18246254	18251254
NM_001200016	chr3	-	50333832	50336852	NAT6	3020	50334352	50339352
NM_178557	chr4	+	2061238	2070816	NAT8L	9578	2058738	2063738
NM_001305081	chr17	-	72766667	72772564	NAT9	5897	72770064	72775064
NM_152914	chr17	-	21142183	21156578	NATD1	14395	21154078	21159078
NM_020443	chr1	+	201617449	201796102	NAV1	178653	201614949	201619949
NM_001111018	chr11	+	19372270	20143147	NAV2	770877	19369770	19374770
NR_046672	chr11	-	20065320	20070849	NAV2-AS2	5529	20068349	20073349
NR_033989	chr11	-	19532439	19545625	NAV2-AS4	13186	19543125	19548125
NR_049725	chr11	-	19524219	19528776	NAV2-AS5	4557	19526276	19531276
NM_014903	chr12	+	78225068	78606792	NAV3	381724	78222568	78227568
NM_001242883	chr13	+	111267806	111292342	NAXD	24536	111265306	111270306
NM_144772	chr1	+	156561557	156564091	NAXE	2534	156559057	156564057
NM_015909	chr2	-	15307031	15701472	NBAS	394441	15698972	15703972
NR_034143	chr6	-	22134830	22147422	NBAT1	12592	22144922	22149922
NM_001348129	chrX	+	56755651	56845611	NBDY	89960	56753151	56758151
NM_015678	chr13	+	35516423	36246873	NBEA	730450	35513923	35518923
NM_001114132	chr2	+	203879601	204082717	NBEAL1	203116	203877101	203882101
NM_015175	chr3	+	47021172	47051194	NBEAL2	30022	47018672	47023672
NR_027992	chr15	-	20874796	20961480	NBEAP1	86684	20958980	20963980
NM_001278164	chr1	+	19969722	19984949	NBL1	15227	19967222	19972222
NM_001024688	chr8	-	90945563	90996952	NBN	51389	90994452	90999452
NM_017940	chr1	-	16888921	16940100	NBPF1	51179	16937600	16942600
NM_001039703	chr1	+	145293370	146466121	NBPF10	1172751	145290870	145295870
NM_183372	chr1	-	147574322	147624469	NBPF11	50147	147621969	147626969
NM_001278141	chr1	+	146373856	146467639	NBPF12	93783	146371356	146376356
NR_103466	chr1	-	146571065	146585928	NBPF13P	14863	146583428	146588428
NM_015383	chr1	-	148250248	148346756	NBPF14	96508	148344256	148349256
NM_001170755	chr1	+	148558187	148596267	NBPF15	38080	148555687	148560687
NR_103561	chr1	+	151990753	151994985	NBPF18P	4232	151988253	151993253
NM_001351365	chr1	+	144146811	146467744	NBPF19	2320933	144144311	144149311
NM_001278267	chr1	+	144146810	146467744	NBPF20	2320934	144144310	144149310
NR_003719	chr5	+	85578261	85593365	NBPF22P	15104	85575761	85580761
NR_104217	chr1	-	148250249	149109725	NBPF25P	859476	149107225	149112225
NM_001351372	chr1	-	148002925	148346791	NBPF26	343866	148344291	148349291
NM_001330381	chr1	+	21766582	21811393	NBPF3	44811	21764082	21769082
NM_001143989	chr1	-	108765962	108786703	NBPF4	20741	108784203	108789203
NM_001143987	chr1	+	108992903	109013260	NBPF6	20357	108990403	108995403
NM_001047980	chr1	-	120377387	120387503	NBPF7	10116	120385003	120390003
NM_001037501	chr1	+	144593687	144832249	NBPF8	238562	144591187	144596187
NM_001277444	chr1	+	144614958	145370304	NBPF9	755346	144612458	144617458
NM_031862	chr17	+	41322487	41363708	NBR1	41221	41319987	41324987
NR_138145	chr17	+	41277573	41305688	NBR2	28115	41275073	41280073
NM_001040630	chr8	-	102698769	103137135	NCALD	438366	103134635	103139635
NM_181351	chr11	+	112831968	113149158	NCAM1	317190	112829468	112834468
NR_034101	chr11	-	113140253	113144623	NCAM1-AS1	4370	113142123	113147123
NM_001352591	chr21	+	22370613	22915648	NCAM2	545035	22368113	22373113
NM_004386	chr19	+	19322781	19363061	NCAN	40280	19320281	19325281
NM_014865	chr12	+	6603297	6641132	NCAPD2	37835	6600797	6605797
NM_015261	chr11	-	134022336	134094426	NCAPD3	72090	134091926	134096926
NR_073124	chr4	+	17812435	17846487	NCAPG	34052	17809935	17814935
NM_001281932	chr7	-	158423860	158497522	NCAPG2	73662	158495022	158500022
NM_015341	chr2	+	97001478	97042833	NCAPH	41355	96998978	97003978
NM_001185011	chr22	+	50946644	50963209	NCAPH2	16565	50944144	50949144
NM_002486	chr9	+	100395704	100436029	NCBP1	40325	100393204	100398204
NM_007362	chr3	-	196662272	196669464	NCBP2	7192	196666964	196671964
NR_046630	chr3	+	196666747	196669405	NCBP2-AS1	2658	196664247	196669247
NM_001348372	chrX	+	107020962	107039007	NCBP2L	18045	107018462	107023462
NM_001114118	chr17	-	3710044	3749545	NCBP3	39501	3747045	3752045
NM_001001414	chr19	+	39687603	39692522	NCCRP1	4919	39685103	39690103
NM_001014839	chr1	+	36023392	36032380	NCDN	8988	36020892	36025892
NM_001146276	chr3	-	172348434	172429008	NCEH1	80574	172426508	172431508
NM_000265	chr7	+	74188308	74203720	NCF1	15412	74185808	74190808
NR_003186	chr7	+	72634673	72649979	NCF1B	15306	72632173	72637173
NR_003187	chr7	-	74572383	74587802	NCF1C	15419	74585302	74590302
NM_001127651	chr1	-	183524696	183560056	NCF2	35360	183557556	183562556
NM_013416	chr22	+	37257029	37274059	NCF4	17030	37254529	37259529
NR_147197	chr22	-	37243414	37266485	NCF4-AS1	23071	37263985	37268985
NM_001291999	chr3	+	136581049	136670452	NCK1	89403	136578549	136583549
NR_110175	chr3	-	136560817	136580905	NCK1-AS1	20088	136578405	136583405
NM_003581	chr2	+	106361519	106510730	NCK2	149211	106359019	106364019
NM_013436	chr2	-	183789578	183903586	NCKAP1	114008	183901086	183906086
NM_005337	chr12	+	54891494	54936899	NCKAP1L	45405	54888994	54893994
NM_207481	chr2	-	133429371	134326031	NCKAP5	896660	134323531	134328531
NM_001037806	chr12	-	50184928	50222208	NCKAP5L	37280	50219708	50224708
NM_016453	chr3	-	48711271	48723366	NCKIPSD	12095	48720866	48725866
NM_005381	chr2	-	232319458	232329205	NCL	9747	232326705	232331705
NM_001321463	chr19	+	3185874	3209573	NCLN	23699	3183374	3188374
NM_001010980	chr1	+	24882566	24935818	NCMAP	53252	24880066	24885066
NM_147223	chr2	+	24807345	24993570	NCOA1	186225	24804845	24809845
NM_001321703	chr8	-	71021996	71316473	NCOA2	294477	71313973	71318973
NM_001174088	chr20	+	46130600	46285621	NCOA3	155021	46128100	46133100
NM_001145263	chr10	+	51565107	51590734	NCOA4	25627	51562607	51567607
NM_020967	chr20	-	44689625	44718580	NCOA5	28955	44716080	44721080
NM_014071	chr20	-	33302577	33413452	NCOA6	110875	33410952	33415952
NM_001199620	chr6	+	126102306	126253176	NCOA7	150870	126099806	126104806
NR_126386	chr6	-	126119006	126140004	NCOA7-AS1	20998	126137504	126142504
NM_006311	chr17	-	15933407	16118874	NCOR1	185467	16116374	16121374
NR_003678	chr20	-	26084051	26094677	NCOR1P1	10626	26092177	26097177
NM_006312	chr12	-	124808956	125052010	NCOR2	243054	125049510	125054510
NM_001145457	chr19	+	55417507	55424439	NCR1	6932	55415007	55420007
NM_001199509	chr6	+	41303527	41318625	NCR2	15098	41301027	41306027
NM_147130	chr6	-	31556659	31560762	NCR3	4103	31558262	31563262
NM_001202439	chr11	+	17373308	17398868	NCR3LG1	25560	17370808	17375808
NR_126028	chr8	+	135850311	135854880	NCRNA00250	4569	135847811	135852811
NM_014286	chr9	+	132934856	132999583	NCS1	64727	132932356	132937356
NM_001290186	chr1	+	160313062	160328742	NCSTN	15680	160310562	160315562
NM_018087	chr1	-	54231133	54304225	NDC1	73092	54301725	54306725
NM_006101	chr18	+	2571509	2616634	NDC80	45125	2569009	2574009
NM_001143979	chr16	+	15737123	15820208	NDE1	83085	15734623	15739623
NM_001330129	chr17	+	8339169	8371495	NDEL1	32326	8336669	8341669
NM_030571	chr5	+	141488323	141534008	NDFIP1	45685	141485823	141490823
NM_019080	chr13	+	80055258	80130212	NDFIP2	74954	80052758	80057758
NR_046685	chr13	-	80051498	80055366	NDFIP2-AS1	3868	80052866	80057866
NM_024574	chr4	-	121956781	121993673	NDNF	36892	121991173	121996173
NM_001144027	chr9	+	140100118	140113813	NDOR1	13695	140097618	140102618
NM_000266	chrX	-	43808023	43832921	NDP	24898	43830421	43835421
NR_046631	chrX	+	43808977	43830798	NDP-AS1	21821	43806477	43811477
NM_001258432	chr8	-	134249413	134309547	NDRG1	60134	134307047	134312047
NM_001282211	chr14	-	21484921	21539031	NDRG2	54110	21536531	21541531
NM_022477	chr20	-	35280168	35374541	NDRG3	94373	35372041	35377041
NM_020465	chr16	+	58497548	58547523	NDRG4	49975	58495048	58500048
NM_001301063	chr5	+	149877339	149937773	NDST1	60434	149874839	149879839
NR_105061	chr5	-	149855078	149865555	NDST1-AS1	10477	149863055	149868055
NM_001330107	chr10	-	75561668	75571607	NDST2	9939	75569107	75574107
NR_146513	chr4	+	118954772	119179789	NDST3	225017	118952272	118957272
NM_022569	chr4	-	115748928	116035032	NDST4	286104	116032532	116037532
NM_004541	chrX	+	119005733	119010629	NDUFA1	4896	119003233	119008233
NR_136158	chr2	-	240831867	240964819	NDUFA10	132952	240962319	240967319
NM_001193375	chr19	-	5891286	5904024	NDUFA11	12738	5901524	5906524
NM_018838	chr12	-	95365103	95397489	NDUFA12	32386	95394989	95399989
NM_015965	chr19	+	19627018	19639013	NDUFA13	11995	19624518	19629518
NM_004542	chr19	+	54606159	54610281	NDUFA3	4122	54603659	54608659
NM_002489	chr7	-	10971579	10979813	NDUFA4	8234	10977313	10982313
NM_020142	chr12	-	57628685	57634475	NDUFA4L2	5790	57631975	57636975
NR_111926	chr7	-	123177051	123241705	NDUFA5	64654	123239205	123244205
NM_002490	chr22	-	42481529	42486959	NDUFA6	5430	42484459	42489459
NR_034118	chr22	+	42486936	42521354	NDUFA6-AS1	34418	42484436	42489436
NR_135539	chr19	-	8373486	8386297	NDUFA7	12811	8383797	8388797
NM_001318195	chr9	-	124894744	124922098	NDUFA8	27354	124919598	124924598
NM_005002	chr12	+	4758263	4796720	NDUFA9	38457	4755763	4760763
NM_005003	chr16	-	23592334	23607639	NDUFAB1	15305	23605139	23610139
NR_045620	chr15	-	41679546	41694658	NDUFAF1	15112	41692158	41697158
NM_174889	chr5	+	60240955	60448864	NDUFAF2	207909	60238455	60243455
NM_199074	chr3	+	49057907	49060926	NDUFAF3	3019	49055407	49060407
NM_014165	chr6	-	97337186	97345767	NDUFAF4	8581	97343267	97348267
NM_024120	chr20	+	13765671	13799067	NDUFAF5	33396	13763171	13768171
NM_001330582	chr8	+	96037202	96070944	NDUFAF6	33742	96034702	96039702
NR_146402	chr2	+	37458773	37498508	NDUFAF7	39735	37456273	37461273
NM_004545	chr14	-	92582467	92588153	NDUFB1	5686	92585653	92590653
NM_019056	chrX	-	47001614	47004609	NDUFB11	2995	47002109	47007109
NM_004546	chr7	+	140396480	140406446	NDUFB2	9966	140393980	140398980
NM_002491	chr2	+	201936461	201950473	NDUFB3	14012	201933961	201938961
NM_004547	chr3	+	120315127	120321258	NDUFB4	6131	120312627	120317627
NM_002492	chr3	+	179322574	179342288	NDUFB5	19714	179320074	179325074
NM_182739	chr9	-	32553523	32573182	NDUFB6	19659	32570682	32575682
NM_004146	chr19	-	14676889	14682889	NDUFB7	6000	14680389	14685389
NM_001284368	chr10	-	102283485	102289680	NDUFB8	6195	102287180	102292180
NM_001278646	chr8	+	125551342	125562227	NDUFB9	10885	125548842	125553842
NM_001184987	chr4	-	140211070	140223705	NDUFC1	12635	140221205	140226205
NM_001204055	chr11	-	77779392	77791265	NDUFC2	11873	77788765	77793765
NM_001203262	chr11	-	77726760	77791265	NDUFC2-KCTD14	64505	77788765	77793765
NM_001199983	chr2	-	206987802	207024243	NDUFS1	36441	207021743	207026743
NM_004550	chr1	+	161169104	161184184	NDUFS2	15080	161166604	161171604
NM_004551	chr11	+	47600561	47606115	NDUFS3	5554	47598061	47603061
NR_134475	chr5	+	52856462	52979171	NDUFS4	122709	52853962	52858962
NM_001184979	chr1	+	39491966	39500308	NDUFS5	8342	39489466	39494466
NM_004553	chr5	+	1801495	1816167	NDUFS6	14672	1798995	1803995
NM_024407	chr19	+	1383882	1395588	NDUFS7	11706	1381382	1386382
NM_002496	chr11	+	67798083	67804114	NDUFS8	6031	67795583	67800583
NM_001166102	chr11	+	67374322	67380012	NDUFV1	5690	67371822	67376822
NM_021074	chr18	+	9102627	9134343	NDUFV2	31716	9100127	9105127
NR_110772	chr18	-	9121262	9136718	NDUFV2-AS1	15456	9134218	9139218
NM_021075	chr21	+	44313377	44329773	NDUFV3	16396	44310877	44315877
NR_131012	chr11	+	65190268	65213009	NEAT1	22741	65187768	65192768
NM_001271208	chr2	-	152341852	152591001	NEB	249149	152588501	152593501
NM_001173484	chr10	-	21068902	21463116	NEBL	394214	21460616	21465616
NM_022351	chr8	+	91803920	91971630	NECAB1	167710	91801420	91806420
NM_001329748	chr16	+	84002236	84036379	NECAB2	34143	83999736	84004736
NM_031231	chr20	-	32244892	32262264	NECAB3	17372	32259764	32264764
NM_015509	chr12	+	8234806	8250373	NECAP1	15567	8232306	8237306
NM_018090	chr1	+	16767166	16786584	NECAP2	19418	16764666	16769666
NM_203285	chr11	-	119508807	119599435	NECTIN1	90628	119596935	119601935
NM_001042724	chr19	+	45349392	45392485	NECTIN2	43093	45346892	45351892
NM_001243288	chr3	+	110791014	110913016	NECTIN3	122002	110788514	110793514
NR_045114	chr3	-	110764162	110788806	NECTIN3-AS1	24644	110786306	110791306
NM_030916	chr1	-	161040780	161059385	NECTIN4	18605	161056885	161061885
NM_152905	chr12	+	97301000	97347469	NEDD1	46469	97298500	97303500
NM_006154	chr15	-	56119116	56285944	NEDD4	166828	56283444	56288444
NM_001144967	chr18	+	55711609	56068772	NEDD4L	357163	55709109	55714109
NM_006156	chr14	-	24686056	24701576	NEDD8	15520	24699076	24704076
NM_001199823	chr14	-	24683142	24701591	NEDD8-MDP1	18449	24699091	24704091
NM_001142393	chr6	-	11183530	11382581	NEDD9	199051	11380081	11385081
NM_021076	chr22	+	29876180	29887277	NEFH	11097	29873680	29878680
NM_006158	chr8	-	24808468	24814383	NEFL	5915	24811883	24816883
NM_005382	chr8	+	24771273	24776606	NEFM	5333	24768773	24773773
NM_173808	chr1	-	71868624	72748277	NEGR1	879653	72745777	72750777
NR_046218	chr1	-	72259914	72302695	NEGR1-IT1	42781	72300195	72305195
NM_024608	chr15	+	75639330	75647592	NEIL1	8262	75636830	75641830
NM_145043	chr8	+	11627133	11644864	NEIL2	17731	11624633	11629633
NM_018248	chr4	+	178230990	178284092	NEIL3	53102	178228490	178233490
NM_001199397	chr4	-	170314420	170533778	NEK1	219358	170531278	170536278
NM_152534	chr3	-	27152393	27410951	NEK10	258558	27408451	27413451
NM_001321221	chr3	+	130745693	131069309	NEK11	323616	130743193	130748193
NM_001204182	chr1	-	211831598	211848972	NEK2	17374	211846472	211851472
NM_002498	chr13	-	52706778	52733996	NEK3	27218	52731496	52736496
NM_001348414	chr3	-	52742464	52804965	NEK4	62501	52802465	52807465
NM_199289	chr13	-	52638899	52703228	NEK5	64329	52700728	52705728
NM_001166167	chr9	+	127019884	127114719	NEK6	94835	127017384	127022384
NM_133494	chr1	+	198126107	198291548	NEK7	165441	198123607	198128607
NM_178170	chr17	+	27055831	27069784	NEK8	13953	27053331	27058331
NM_033116	chr14	-	75548081	75593783	NEK9	45702	75591283	75596283
NM_005663	chr4	-	1984440	2010962	NELFA	26522	2008462	2013462
NM_015456	chr9	+	140149751	140168000	NELFB	18249	140147251	140152251
NM_198976	chr20	+	57556262	57570188	NELFCD	13926	57553762	57558762
NM_002904	chr6	-	31919863	31926864	NELFE	7001	31924364	31929364
NM_006157	chr11	+	20691096	21597229	NELL1	906133	20688596	20693596
NM_001145110	chr12	-	44902057	45307711	NELL2	405654	45305211	45310211
NM_001301732	chr14	-	50250238	50319921	NEMF	69683	50317421	50322421
NM_015257	chr12	-	57449425	57472574	NEMP1	23149	57470074	57475074
NR_136298	chr2	-	191371618	191399468	NEMP2	27850	191396968	191401968
NR_026598	chr1	+	212606228	212619721	NENF	13493	212603728	212608728
NM_001172623	chr15	+	73344824	73597547	NEO1	252723	73342324	73347324
NR_134969	chr3	-	112721291	112738580	NEPRO	17289	112736080	112741080
NM_006617	chr1	-	156638555	156647189	NES	8634	156644689	156649689
NM_001047160	chr10	+	5454513	5501019	NET1	46506	5452013	5457013
NM_001201465	chr18	-	70409548	70534810	NETO1	125262	70532310	70537310
NM_001201477	chr16	-	47115430	47177936	NETO2	62506	47175436	47180436
NM_000434	chr6	-	31826828	31830709	NEU1	3881	31828209	31833209
NM_006656	chr11	+	74699949	74718743	NEU3	18794	74697449	74702449
NM_001167601	chr2	+	242750159	242758739	NEU4	8580	242747659	242752659
NM_004210	chr10	+	105253734	105352309	NEURL1	98575	105251234	105256234
NR_120675	chr10	-	105239359	105277199	NEURL1-AS1	37840	105274699	105279699
NM_001308177	chr5	+	172068268	172118533	NEURL1B	50265	172065768	172070768
NM_001278535	chr20	-	44517110	44519926	NEURL2	2816	44517426	44522426
NR_104346	chr2	-	97163379	97173846	NEURL3	10467	97171346	97176346
NM_032442	chr17	-	7218950	7232638	NEURL4	13688	7230138	7235138
NR_146176	chr2	-	182533021	182545392	NEUROD1	12371	182542892	182547892
NM_006160	chr17	-	37760020	37764175	NEUROD2	4155	37761675	37766675
NM_021191	chr12	+	55413728	55423801	NEUROD4	10073	55411228	55416228
NM_022728	chr7	-	31377074	31380538	NEUROD6	3464	31378038	31383038
NM_024019	chr4	-	113434671	113437328	NEUROG2	2657	113434828	113439828
NM_001008537	chrX	-	73952690	74145287	NEXMIF	192597	74142787	74147787
NM_001172309	chr1	+	78354199	78409578	NEXN	55379	78351699	78356699
NR_103535	chr1	-	78347032	78355224	NEXN-AS1	8192	78352724	78357724
NM_001042492	chr17	+	29421944	29704695	NF1	282751	29419444	29424444
NR_028506	chr15	-	22133180	22145802	NF1P2	12622	22143302	22148302
NM_016418	chr22	+	29999544	30094589	NF2	95045	29997044	30002044
NM_145912	chr22	-	42776413	42828401	NFAM1	51988	42825901	42830901
NM_015090	chr1	+	204797781	204991950	NFASC	194169	204795281	204800281
NM_138713	chr16	+	69599868	69738569	NFAT5	138701	69597368	69602368
NM_001278670	chr18	+	77155771	77289323	NFATC1	133552	77153271	77158271
NM_001136021	chr20	-	50003493	50179370	NFATC2	175877	50176870	50181870
NM_032815	chr16	+	28962317	28977767	NFATC2IP	15450	28959817	28964817
NM_173163	chr16	+	68119268	68263162	NFATC3	143894	68116768	68121768
NM_001136022	chr14	+	24836116	24848811	NFATC4	12695	24833616	24838616
NM_001261461	chr12	-	54685890	54694821	NFE2	8931	54692321	54697321
NM_001330261	chr17	+	46125666	46138907	NFE2L1	13241	46123166	46128166
NM_001313903	chr2	-	178095030	178129859	NFE2L2	34829	178127359	178132359
NM_004289	chr7	+	26191846	26226756	NFE2L3	34910	26189346	26194346
NM_001145511	chr1	+	61542945	61928460	NFIA	385515	61540445	61545445
NR_104180	chr1	-	61714616	61719190	NFIA-AS1	4574	61716690	61721690
NR_110617	chr1	-	61405915	61436448	NFIA-AS2	30533	61433948	61438948
NM_001190738	chr9	-	14081841	14398982	NFIB	317141	14396482	14401482
NM_001245005	chr19	+	3359560	3469215	NFIC	109655	3357060	3362060
NM_001290000	chr9	-	94171326	94186908	NFIL3	15582	94184408	94189408
NM_002501	chr19	+	13106583	13209610	NFIX	103027	13104083	13109083
NM_001165412	chr4	+	103422485	103538459	NFKB1	115974	103419985	103424985
NM_001288724	chr10	+	104153866	104162286	NFKB2	8420	104151366	104156366
NM_020529	chr14	-	35870715	35873960	NFKBIA	3245	35871460	35876460
NM_001243116	chr19	+	39390339	39399534	NFKBIB	9195	39387839	39392839
NM_139239	chr19	-	36378853	36391564	NFKBID	12711	36389064	36394064
NM_004556	chr6	-	44225902	44233525	NFKBIE	7623	44231025	44236025
NM_001144963	chr6	+	31514627	31526606	NFKBIL1	11979	31512127	31517127
NM_001005474	chr3	+	101546833	101579869	NFKBIZ	33036	101544333	101549333
NM_001143835	chr11	-	129733669	129765490	NFRKB	31821	129762990	129767990
NM_021100	chr20	-	34256609	34287287	NFS1	30678	34284787	34289787
NM_015700	chr2	-	69623244	69664760	NFU1	41516	69662260	69667260
NM_001318758	chr9	+	33290414	33371161	NFX1	80747	33287914	33292914
NM_001278623	chr4	-	47849249	47916684	NFXL1	67435	47914184	47919184
NM_002505	chr6	+	41040706	41070146	NFYA	29440	41038206	41043206
NM_006166	chr12	-	104510857	104532040	NFYB	21183	104529540	104534540
NM_014223	chr1	+	41157241	41237275	NFYC	80034	41154741	41159741
NR_024567	chr1	-	41154751	41157933	NFYC-AS1	3182	41155433	41160433
NM_021257	chr14	-	77731833	77737655	NGB	5822	77735155	77740155
NM_015514	chr14	+	23938897	23947402	NGDN	8505	23936397	23941397
NM_019850	chr2	-	233743395	233877951	NGEF	134556	233875451	233880451
NM_002506	chr1	-	115828536	115880857	NGF	52321	115878357	115883357
NM_002507	chr17	+	47572654	47592382	NGFR	19728	47570154	47575154
NM_001145294	chr3	-	25760434	25831530	NGLY1	71096	25829030	25834030
NR_028052	chr15	+	90808894	90815443	NGRN	6549	90806394	90811394
NR_027994	chr6	-	137303295	137314368	NHEG1	11073	137311868	137316868
NM_024782	chr2	-	219940045	220025587	NHEJ1	85542	220023087	220028087
NM_005598	chr1	+	160336860	160342638	NHLH1	5778	160334360	160339360
NM_005599	chr1	-	116378998	116383747	NHLH2	4749	116381247	116386247
NM_198514	chr10	+	115614390	115672265	NHLRC2	57875	115611890	115616890
NR_073109	chr13	+	39612447	39624244	NHLRC3	11797	39609947	39614947
NM_001301159	chr16	+	616994	619495	NHLRC4	2501	614494	619494
NM_017838	chr5	-	177576464	177580961	NHP2	4497	177578461	177583461
NM_001291867	chrX	+	17393542	17754113	NHS	360571	17391042	17396042
NR_046632	chrX	-	17570469	17577248	NHS-AS1	6779	17574748	17579748
NM_020464	chr6	-	138743180	138893668	NHSL1	150488	138891168	138896168
NM_001013627	chrX	+	71130937	71363424	NHSL2	232487	71128437	71133437
NM_032316	chr3	-	49459765	49466757	NICN1	6992	49464257	49469257
NM_002508	chr1	-	236139131	236228481	NID1	89350	236225981	236230981
NM_007361	chr14	-	52471519	52535946	NID2	64427	52533446	52538446
NM_001136039	chr2	+	201754049	201768655	NIF3L1	14606	201751549	201756549
NM_032390	chr2	-	122484520	122494503	NIFK	9983	122492003	122497003
NR_037857	chr2	+	122407229	122486136	NIFK-AS1	78907	122404729	122409729
NM_153361	chr5	+	43192169	43280952	NIM1K	88783	43189669	43194669
NM_020921	chr14	-	51186480	51297839	NIN	111359	51295339	51300339
NM_004148	chr9	-	95883770	95896570	NINJ1	12800	95894070	95899070
NM_016533	chr12	-	673461	772907	NINJ2	99446	770407	775407
NM_001318226	chr20	-	25433332	25566167	NINL	132835	25563667	25568667
NM_016101	chr16	+	69373414	69377013	NIP7	3599	69370914	69375914
NM_001142275	chr15	-	23043278	23086843	NIPA1	43565	23084343	23089343
NM_001184888	chr15	-	23004683	23034427	NIPA2	29744	23031927	23036927
NM_207330	chr4	+	48018788	48042190	NIPAL1	23402	48016288	48021288
NM_001321636	chr8	-	99202053	99306621	NIPAL2	104568	99304121	99309121
NM_001322854	chr1	+	24739976	24799473	NIPAL3	59497	24737476	24742476
NM_001172292	chr5	+	156887026	156901730	NIPAL4	14704	156884526	156889526
NM_133433	chr5	+	36876860	37065921	NIPBL	189061	36874360	36879360
NR_046262	chr5	-	36871462	36876796	NIPBL-AS1	5334	36874296	36879296
NM_003634	chr22	-	29950797	29977326	NIPSNAP1	26529	29974826	29979826
NM_001483	chr7	+	56032269	56067875	NIPSNAP2	35606	56029769	56034769
NM_015469	chr9	+	107509848	107522405	NIPSNAP3A	12557	107507348	107512348
NR_130759	chr9	+	107526021	107540045	NIPSNAP3B	14024	107523521	107528521
NM_007184	chr3	+	52489523	52527088	NISCH	37565	52487023	52492023
NM_001185092	chr1	+	161087861	161095235	NIT1	7374	161085361	161090361
NM_020202	chr3	+	100053561	100074478	NIT2	20917	100051061	100056061
NM_024522	chr1	-	31652591	31712734	NKAIN1	60143	31710234	31715234
NM_153355	chr6	+	124124990	125146786	NKAIN2	1021796	124122490	124127490
NR_130764	chr8	+	63161500	63912211	NKAIN3	750711	63159e3	63164e3
NM_152864	chr20	-	61872135	61885892	NKAIN4	13757	61883392	61888392
NM_024528	chrX	-	119059012	119077735	NKAP	18723	119075235	119080235
NR_027131	chrX	-	119370308	119379122	NKAPP1	8814	119376622	119381622
NM_033119	chr16	+	50582240	50674771	NKD1	92531	50579740	50584740
NM_001271082	chr5	+	1009076	1038927	NKD2	29851	1006576	1011576
NR_131157	chr20	+	56285238	56287836	NKILA	2598	56282738	56287738
NM_020345	chr3	-	23933571	23958537	NKIRAS1	24966	23956037	23961037
NM_001001349	chr17	+	40169593	40177656	NKIRAS2	8063	40167093	40172093
NM_198478	chr19	-	45653007	45663408	NKPD1	10401	45660908	45665908
NM_017544	chrX	-	118722299	118739846	NKRF	17547	118737346	118742346
NM_005385	chr3	+	42642146	42690233	NKTR	48087	42639646	42644646
NM_001290079	chr4	-	1396719	1400230	NKX1-1	3511	1397730	1402730
NM_001146340	chr10	-	126133807	126138550	NKX1-2	4743	126136050	126141050
NM_001079668	chr14	-	36985603	36989430	NKX2-1	3827	36986930	36991930
NR_103710	chr14	+	36988482	36992221	NKX2-1-AS1	3739	36985982	36990982
NM_002509	chr20	-	21491659	21494664	NKX2-2	3005	21492164	21497164
NM_145285	chr10	+	101292689	101296280	NKX2-3	3591	101290189	101295189
NM_001166175	chr5	-	172659106	172662315	NKX2-5	3209	172659815	172664815
NM_001136271	chr8	-	23559963	23564111	NKX2-6	4148	23561611	23566611
NM_014360	chr14	-	37049215	37051819	NKX2-8	2604	37049319	37054319
NM_006167	chr8	-	23536205	23540450	NKX3-1	4245	23537950	23542950
NM_001189	chr4	-	13542453	13546114	NKX3-2	3661	13543614	13548614
NM_006168	chr4	-	85414435	85419387	NKX6-1	4952	85416887	85421887
NM_018096	chr17	-	33458340	33469334	NLE1	10994	33466834	33471834
NM_014932	chr3	+	173116237	174001139	NLGN1	884902	173113737	173118737
NR_046664	chr3	-	173628288	173638586	NLGN1-AS1	10298	173636086	173641086
NM_020795	chr17	+	7311501	7323183	NLGN2	11682	7309001	7314001
NM_001166660	chrX	+	70364680	70391051	NLGN3	26371	70362180	70367180
NM_001282145	chrX	-	5808066	6146923	NLGN4X	338857	6144423	6149423
NM_001206850	chrY	+	16634487	16955848	NLGN4Y	321361	16631987	16636987
NR_046504	chrY	-	16905521	16915913	NLGN4Y-AS1	10392	16913413	16918413
NM_016231	chr17	+	26369687	26523404	NLK	153717	26367187	26372187
NM_020726	chr5	+	65018022	65125111	NLN	107089	65015522	65020522
NM_178844	chr16	-	3589035	3627405	NLRC3	38370	3624905	3629905
NM_021209	chr2	-	32449517	32490812	NLRC4	41295	32488312	32493312
NM_001330552	chr16	+	57023396	57117436	NLRC5	94040	57020896	57025896
NM_001033053	chr17	-	5404718	5487832	NLRP1	83114	5485332	5490332
NM_176821	chr11	-	7981155	7985059	NLRP10	3904	7982559	7987559
NM_145007	chr19	-	56296762	56348128	NLRP11	51366	56345628	56350628
NM_001277129	chr19	-	54296854	54327657	NLRP12	30803	54325157	54330157
NM_001321057	chr19	-	56403057	56443702	NLRP13	40645	56441202	56446202
NM_176822	chr11	+	7041699	7092757	NLRP14	51058	7039199	7044199
NM_001174081	chr19	+	55476646	55512510	NLRP2	35864	55474146	55479146
NM_001319967	chrX	-	57703499	57706693	NLRP2B	3194	57704193	57709193
NM_001127461	chr1	+	247579457	247612406	NLRP3	32949	247576957	247581957
NM_134444	chr19	+	56347943	56393220	NLRP4	45277	56345443	56350443
NM_153447	chr19	+	56511091	56573174	NLRP5	62083	56508591	56513591
NM_138329	chr11	+	278569	285388	NLRP6	6819	276069	281069
NM_001127255	chr19	-	55434876	55458873	NLRP7	23997	55456373	55461373
NM_176811	chr19	+	56459197	56499995	NLRP8	40798	56456697	56461697
NM_176820	chr19	-	56219797	56249768	NLRP9	29971	56247268	56252268
NM_001282358	chr11	+	119039042	119054726	NLRX1	15684	119036542	119041542
NM_205858	chr15	-	85198359	85201802	NMB	3443	85199302	85204302
NM_001324308	chr6	-	142395620	142468242	NMBR	72622	142465742	142470742
NM_001320227	chr3	+	160939077	160971320	NMD3	32243	160936577	160941577
NM_000269	chr17	+	49230919	49239450	NME1	8531	49228419	49233419
NR_037149	chr17	+	49230896	49249105	NME1-NME2	18209	49228396	49233396
NM_001018137	chr17	+	49242795	49249105	NME2	6310	49240295	49245295
NM_001286436	chr16	+	446754	450754	NME4	4000	444254	449254
NM_003551	chr5	-	137450860	137475132	NME5	24272	137472632	137477632
NM_001308426	chr3	-	48333806	48343175	NME6	9369	48340675	48345675
NR_104229	chr1	-	169101767	169337201	NME7	235434	169334701	169339701
NM_016616	chr7	+	37888198	37940002	NME8	51804	37885698	37890698
NM_178130	chr3	-	137980278	138048728	NME9	68450	138046228	138051228
NM_004688	chr2	-	152126981	152146430	NMI	19449	152143930	152148930
NM_001297778	chr1	+	10002980	10045556	NMNAT1	42576	10000480	10005480
NM_015039	chr1	-	183217371	183387634	NMNAT2	170263	183385134	183390134
NM_001200047	chr3	-	139279024	139396892	NMNAT3	117868	139394392	139399392
NM_001351994	chr16	-	4511680	4526338	NMRAL1	14658	4523838	4528838
NR_033752	chr3	+	185677757	185698665	NMRAL2P	20908	185675257	185680257
NM_001330678	chr9	-	77675492	77703240	NMRK1	27748	77700740	77705740
NM_001289117	chr19	+	3933100	3942414	NMRK2	9314	3930600	3935600
NM_001011717	chr2	+	101086943	101099742	NMS	12799	101084443	101089443
NM_021079	chr17	+	43138666	43186382	NMT1	47716	43136166	43141166
NM_004808	chr10	-	15147770	15210695	NMT2	62925	15208195	15213195
NR_120489	chr4	-	56461395	56502865	NMU	41470	56500365	56505365
NM_006056	chr2	-	232387870	232395182	NMUR1	7312	232392682	232397682
NM_020167	chr5	-	151771101	151784840	NMUR2	13739	151782340	151787340
NM_006169	chr11	+	114166534	114183238	NNMT	16704	114164034	114169034
NM_012343	chr5	+	43602790	43705668	NNT	102878	43600290	43605290
NR_073113	chr5	-	43573286	43603332	NNT-AS1	30046	43600832	43605832
NM_032313	chr4	-	57829509	57843826	NOA1	14317	57841326	57846326
NM_014062	chr16	-	69775756	69788871	NOB1	13115	69786371	69791371
NM_001080413	chr7	-	144094332	144107320	NOBOX	12988	144104820	144109820
NM_015658	chr1	-	879582	894679	NOC2L	15097	892179	897179
NR_002826	chr2	-	132199733	132202467	NOC2LP2	2734	132199967	132204967
NM_022451	chr10	-	96092982	96122733	NOC3L	29751	96120233	96125233
NM_024078	chr12	+	132628971	132637018	NOC4L	8047	132626471	132631471
NM_012118	chr4	+	139936912	139967093	NOCT	30181	139934412	139939412
NM_006092	chr7	-	30464142	30518393	NOD1	54251	30515893	30520893
NM_022162	chr16	+	50731049	50766988	NOD2	35939	50728549	50733549
NM_001329906	chr10	-	72191691	72207704	NODAL	16013	72205204	72210204
NR_048552	chr2	-	10710891	10830113	NOL10	119222	10827613	10832613
NM_015462	chr17	+	65713948	65740324	NOL11	26376	65711448	65716448
NM_024313	chr22	+	38082343	38089485	NOL12	7142	38079843	38084843
NM_001276319	chr16	+	67204399	67209640	NOL3	5241	67201899	67206899
NM_001198548	chr18	-	31431063	31803515	NOL4	372452	31801015	31806015
NM_001256798	chr20	-	31030861	31172875	NOL4L	142014	31170375	31175375
NM_022917	chr9	-	33461350	33473941	NOL6	12591	33471441	33476441
NM_001317724	chr6	+	13615558	13632702	NOL7	17144	13613058	13618058
NM_017948	chr9	-	95059639	95087876	NOL8	28237	95085376	95090376
NM_024654	chr1	-	6581406	6614658	NOL9	33252	6612158	6617158
NM_001284388	chr10	+	103911932	103923628	NOLC1	11696	103909432	103914432
NM_138400	chr7	+	156742416	156765876	NOM1	23460	156739916	156744916
NM_014287	chr16	+	14927642	14990014	NOMO1	62372	14925142	14930142
NM_173614	chr16	-	18511181	18573434	NOMO2	62253	18570934	18575934
NM_001004067	chr16	+	16326388	16388668	NOMO3	62280	16323888	16328888
NM_001145408	chrX	+	70503041	70521018	NONO	17977	70500541	70505541
NM_001291979	chr4	-	2939663	2965233	NOP14	25570	2962733	2967733
NR_015453	chr4	+	2937272	2952800	NOP14-AS1	15528	2934772	2939772
NM_016391	chr5	-	175810939	175815928	NOP16	4989	175813428	175818428
NM_001258310	chr12	-	6666035	6677498	NOP2	11463	6674998	6679998
NM_015710	chr19	+	48248792	48260323	NOP53	11531	48246292	48251292
NR_132382	chr19	-	48260292	48272097	NOP53-AS1	11805	48269597	48274597
NM_006392	chr20	+	2633177	2639039	NOP56	5862	2630677	2635677
NM_015934	chr2	+	203130438	203168384	NOP58	37946	203127938	203132938
NM_001286367	chr14	+	24769059	24778332	NOP9	9273	24766559	24771559
NR_027451	chr20	-	34633539	34638882	NORAD	5343	34636382	34641382
NM_000620	chr12	-	117645946	117799607	NOS1	153661	117797107	117802107
NM_001164757	chr1	+	162039580	162339813	NOS1AP	300233	162037080	162042080
NM_000625	chr17	-	26083791	26127555	NOS2	43764	26125055	26130055
NR_144552	chr17	+	20340136	20350557	NOS2P3	10421	20337636	20342636
NM_000603	chr7	+	150688143	150711687	NOS3	23544	150685643	150690643
NM_001270960	chr19	-	50058724	50083829	NOSIP	25105	50081329	50086329
NM_001171631	chr2	+	169643048	169721849	NOSTRIN	78801	169640548	169645548
NM_017617	chr9	-	139388884	139440238	NOTCH1	51354	139437738	139442738
NM_024408	chr1	-	120454175	120612317	NOTCH2	158142	120609817	120614817
NM_203458	chr1	+	145209112	145286270	NOTCH2NL	77158	145206612	145211612
NM_000435	chr19	-	15270443	15311792	NOTCH3	41349	15309292	15314292
NR_134950	chr6_mann_hap4	-	3505440	3534689	NOTCH4	29249	3532189	3537189
NM_001134462	chr2	+	73429385	73438340	NOTO	8955	73426885	73431885
NM_178493	chr17	-	79910382	79919057	NOTUM	8675	79916557	79921557
NM_002514	chr8	+	120428551	120436678	NOV	8127	120426051	120431051
NM_002515	chr14	-	26915088	27066960	NOVA1	151872	27064460	27069460
NR_147061	chr14	+	27067852	27275673	NOVA1-AS1	207821	27065352	27070352
NM_002516	chr19	-	46436991	46476657	NOVA2	39666	46474157	46479157
NM_007052	chrX	-	100098312	100129334	NOX1	31022	100126834	100131834
NM_015718	chr6	-	155716501	155777037	NOX3	60536	155774537	155779537
NM_001143837	chr11	-	89057521	89322779	NOX4	265258	89320279	89325279
NR_033672	chr15	+	69222838	69349501	NOX5	126663	69220338	69225338
NM_006647	chr9	+	140317846	140328858	NOXA1	11012	140315346	140320346
NM_001267721	chr16	-	2028917	2031550	NOXO1	2633	2029050	2034050
NM_001113475	chr14	-	77860364	77889399	NOXRED1	29035	77886899	77891899
NM_018958	chr15	+	24920540	24928593	NPAP1	8053	24918040	24923040
NM_002517	chr19	+	47523100	47549033	NPAS1	25933	47520600	47525600
NM_002518	chr2	+	101436612	101613287	NPAS2	176675	101434112	101439112
NM_001164749	chr14	+	33408458	34273382	NPAS3	864924	33405958	33410958
NM_178864	chr11	+	66188474	66194177	NPAS4	5703	66185974	66190974
NM_001321307	chr11	-	108027941	108093365	NPAT	65424	108090865	108095865
NM_000271	chr18	-	21111462	21166581	NPC1	55119	21164081	21169081
NM_013389	chr7	-	44552134	44580914	NPC1L1	28780	44578414	44583414
NM_006432	chr14	-	74946642	74960084	NPC2	13442	74957584	74962584
NM_015392	chr9	-	139933908	139940676	NPDC1	6768	139938176	139943176
NM_001204873	chr20	+	57264186	57290900	NPEPL1	26714	57261686	57266686
NM_001330257	chr17	+	45600322	45700642	NPEPPS	100320	45597822	45602822
NM_022146	chr10	-	72014712	72043450	NPFFR1	28738	72040950	72045950
NM_004885	chr4	+	72897520	73013918	NPFFR2	116398	72895020	72900020
NM_207181	chr2	-	110880913	110962639	NPHP1	81726	110960139	110965139
NM_153240	chr3	-	132399452	132441303	NPHP3	41851	132438803	132443803
NR_037804	chr3	-	132276981	132441303	NPHP3-ACAD11	164322	132438803	132443803
NR_002811	chr3	+	132441185	132593050	NPHP3-AS1	151865	132438685	132443685
NR_111987	chr1	-	5922867	6052533	NPHP4	129666	6050033	6055033
NM_004646	chr19	-	36316273	36342895	NPHS1	26622	36340395	36345395
NM_014625	chr1	-	179519673	179545087	NPHS2	25414	179542587	179547587
NM_006985	chr16	+	15031299	15045917	NPIPA1	14618	15028799	15033799
NM_001277324	chr16	+	14805545	14820185	NPIPA2	14640	14803045	14808045
NM_001277323	chr16	+	14805545	14820195	NPIPA3	14650	14803045	14808045
NM_001277325	chr16	-	15457480	15472151	NPIPA5	14671	15469651	15474651
NM_001282507	chr16	-	18411775	18426519	NPIPA7	14744	18424019	18429019
NM_001349948	chr16	-	18411775	18429717	NPIPA8	17942	18427217	18432217
NM_001310137	chr16	-	29392638	29415123	NPIPB11	22485	29412623	29417623
NM_001321892	chr16	-	30234055	30259734	NPIPB13	25679	30257234	30262234
NM_001306094	chr16	+	74411849	74426012	NPIPB15	14163	74409349	74414349
NM_130464	chr16	-	21413454	21436658	NPIPB3	23204	21434158	21439158
NM_001310148	chr16	-	21845883	21869077	NPIPB4	23194	21866577	21871577
NM_001135865	chr16	+	22524843	22547841	NPIPB5	22998	22522343	22527343
NM_001282524	chr16	-	28353838	28374181	NPIPB6	20343	28371681	28376681
NM_001310136	chr16	+	28649681	28669951	NPIPB8	20270	28647181	28652181
NM_001287251	chr16	+	28763755	28784144	NPIPB9	20389	28761255	28766255
NM_030769	chr1	+	182758583	182799519	NPL	40936	182756083	182761083
NM_017921	chr17	-	79523910	79604179	NPLOC4	80269	79601679	79606679
NM_002520	chr5	+	170814707	170837888	NPM1	23181	170812207	170817207
NM_001286680	chr8	+	21881620	21894408	NPM2	12788	21879120	21884120
NM_001184691	chr4	+	106816596	106892828	NPNT	76232	106814096	106819096
NR_037806	chr1	+	11900375	11907673	NPPA-AS1	7298	11897875	11902875
NM_024409	chr2	-	232786803	232791113	NPPC	4310	232788613	232793613
NM_000906	chr1	+	153651163	153666468	NPR1	15305	153648663	153653663
NM_003995	chr9	+	35792405	35809728	NPR2	17323	35789905	35794905
NM_001204376	chr5	+	32710742	32791830	NPR3	81088	32708242	32713242
NM_006545	chr3	-	50384918	50388486	NPRL2	3568	50385986	50390986
NM_001039476	chr16	-	135803	188697	NPRL3	52894	186197	191197
NM_001030013	chr10	+	129347612	129350935	NPS	3323	129345112	129350112
NM_001300933	chr7	+	34697850	34917944	NPSR1	220094	34695350	34700350
NR_033664	chr7	-	34386123	34797884	NPSR1-AS1	411761	34795384	34800384
NM_001161364	chr15	-	73852343	73925753	NPTN	73410	73923253	73928253
NR_103844	chr15	-	73859278	73861884	NPTN-IT1	2606	73859384	73864384
NM_002522	chr17	-	78440632	78450404	NPTX1	9772	78447904	78452904
NM_002523	chr7	+	98246596	98259181	NPTX2	12585	98244096	98249096
NM_014293	chr22	-	39214455	39240017	NPTXR	25562	39237517	39242517
NM_022150	chr7	-	25264190	25268105	NPVF	3915	25265605	25270605
NM_000905	chr7	+	24323806	24331484	NPY	7678	24321306	24326306
NM_000909	chr4	-	164245116	164253947	NPY1R	8831	164251447	164256447
NM_000910	chr4	+	156129780	156138230	NPY2R	8450	156127280	156132280
NM_005972	chr10	+	47083533	47088320	NPY4R	4787	47081033	47086033
NM_001317092	chr4	+	164264998	164273086	NPY5R	8088	164262498	164267498
NR_002713	chr5	+	137136881	137146439	NPY6R	9558	137134381	137139381
NM_001286137	chr16	-	69743303	69760571	NQO1	17268	69758071	69763071
NM_001290221	chr6	+	3000049	3020110	NQO2	20061	2997549	3002549
NM_000475	chrX	-	30322538	30327495	NR0B1	4957	30324995	30329995
NM_021969	chr1	-	27237974	27240567	NR0B2	2593	27238067	27243067
NM_021724	chr17	-	38249036	38256978	NR1D1	7942	38254478	38259478
NR_110524	chr3	+	23986750	24022109	NR1D2	35359	23984250	23989250
NM_007121	chr19	+	50879679	50886285	NR1H2	6606	50877179	50882179
NM_001251935	chr11	+	47269850	47290584	NR1H3	20734	47267350	47272350
NM_001206978	chr12	+	100867550	100957645	NR1H4	90095	100865050	100870050
NM_033013	chr3	+	119499330	119537332	NR1I2	38002	119496830	119501830
NM_005122	chr1	-	161199455	161208000	NR1I3	8545	161205500	161210500
NM_003297	chr12	-	95414004	95467404	NR2C1	53400	95464904	95469904
NM_003298	chr3	+	14989090	15090786	NR2C2	101696	14986590	14991590
NM_003269	chr6	+	108487261	108510013	NR2E1	22752	108484761	108489761
NM_014249	chr15	+	72102887	72110597	NR2E3	7710	72100387	72105387
NM_005654	chr5	+	92919042	92930315	NR2F1	11273	92916542	92921542
NR_109824	chr5	-	92745061	92917026	NR2F1-AS1	171965	92914526	92919526
NM_001145155	chr15	+	96869156	96883492	NR2F2	14336	96866656	96871656
NR_125738	chr15	-	96670588	96870347	NR2F2-AS1	199759	96867847	96872847
NM_005234	chr19	-	17342693	17356151	NR2F6	13458	17353651	17358651
NM_001018077	chr5	-	142657495	142815077	NR3C1	157582	142812577	142817577
NM_001166104	chr4	-	148999914	149363672	NR3C2	363758	149361172	149366172
NM_001202233	chr12	+	52416615	52453291	NR4A1	36676	52414115	52419115
NM_006186	chr2	-	157180943	157189287	NR4A2	8344	157186787	157191787
NM_006981	chr9	+	102584136	102629173	NR4A3	45037	102581636	102586636
NM_004959	chr9	-	127243514	127269699	NR5A1	26185	127267199	127272199
NM_205860	chr1	+	199996729	200146550	NR5A2	149821	199994229	199999229
NM_033334	chr9	-	127279553	127533589	NR6A1	254036	127531089	127536089
NM_001261463	chr10	-	115348582	115423829	NRAP	75247	115421329	115426329
NM_001004354	chr9	-	140194082	140196703	NRARP	2621	140194203	140199203
NM_002524	chr1	-	115247084	115259515	NRAS	12431	115257015	115262015
NR_038854	chr12	-	120928140	120933749	NRAV	5609	120931249	120936249
NM_030759	chr10	+	64893006	64914791	NRBF2	21785	64890506	64895506
NM_001321357	chr2	+	27650656	27665124	NRBP1	14468	27648156	27653156
NM_178564	chr8	-	144915754	144923146	NRBP2	7392	144920646	144925646
NM_005010	chr7	-	107788070	108096841	NRCAM	308771	108094341	108099341
NM_002525	chr1	-	52254865	52344609	NRDC	89744	52342109	52347109
NM_017970	chr14	-	90744397	90798481	NRDE2	54084	90795981	90800981
NM_001142475	chr5	-	111064999	111312628	NREP	247629	111310128	111315128
NR_046678	chr5	+	111248204	111353003	NREP-AS1	104799	111245704	111250704
NM_001293163	chr7	+	129251542	129396922	NRF1	145380	129249042	129254042
NM_013962	chr8	+	31497267	32600770	NRG1	1103503	31494767	31499767
NR_104158	chr8	+	31883251	31996993	NRG1-IT1	113742	31880751	31885751
NM_001184935	chr5	-	139226363	139422884	NRG2	196521	139420384	139425384
NM_001165972	chr10	+	83635069	84746935	NRG3	1111866	83632569	83637569
NR_120666	chr10	-	83988769	83992676	NRG3-AS1	3907	83990176	83995176
NM_138573	chr15	-	76234327	76304785	NRG4	70458	76302285	76307285
NM_006176	chr11	+	124609828	124617102	NRGN	7274	124607328	124612328
NM_003489	chr21	-	16333555	16437126	NRIP1	103571	16434626	16439626
NM_031474	chr12	-	2934513	2944221	NRIP2	9708	2941721	2946721
NM_020645	chr11	-	9002122	9025596	NRIP3	23474	9023096	9028096
NR_126359	chr2	-	6968684	6980595	NRIR	11911	6978095	6983095
NM_198465	chrX	+	105066535	105202602	NRK	136067	105064035	105069035
NM_006177	chr14	-	24549315	24553832	NRL	4517	24551332	24556332
NM_007243	chr6	-	30655823	30659197	NRM	3374	30656697	30661697
NM_001278710	chr6	-	5998232	6007838	NRN1	9606	6005338	6010338
NM_001348682	chr16	+	67918780	67922756	NRN1L	3976	67916280	67921280
NR_045006	chr9	-	129170053	129172783	NRON	2730	129170283	129175283
NM_001244973	chr10	-	33466418	33623833	NRP1	157415	33621333	33626333
NM_201279	chr2	+	206547223	206662857	NRP2	115634	206544723	206549723
NM_198565	chr3	+	196366566	196388874	NRROS	22308	196364066	196369066
NM_080723	chr6	+	24126413	24147757	NRSN1	21344	24123913	24128913
NR_136649	chr20	+	327369	335512	NRSN2	8143	324869	329869
NR_109990	chr20	-	300330	305896	NRSN2-AS1	5566	303396	308396
NM_004558	chr19	+	5823812	5828335	NRTN	4523	5821312	5826312
NM_001330078	chr2	-	50145642	51259674	NRXN1	1114032	51257174	51262174
NM_138732	chr11	-	64373645	64490660	NRXN2	117015	64488160	64493160
NR_073547	chr14	+	78636715	80334633	NRXN3	1697918	78634215	78639215
NR_073403	chr5	+	74062815	74072737	NSA2	9922	74060315	74065315
NM_172349	chr5	+	176560079	176727214	NSD1	167135	176557579	176562579
NM_001042424	chr4	+	1873122	1983934	NSD2	110812	1870622	1875622
NM_023034	chr8	-	38132560	38239790	NSD3	107230	38237290	38242290
NM_015922	chrX	+	151999510	152037907	NSDHL	38397	151997010	152002010
NR_040116	chr17	+	44668034	44834828	NSF	166794	44665534	44670534
NM_001206736	chr20	-	1422806	1448337	NSFL1C	25531	1445837	1450837
NR_033799	chr17_ctg5_hap1	-	330260	380553	NSFP1	50293	378053	383053
NM_001040101	chr4	+	4387982	4420785	NSG1	32803	4385482	4390482
NM_015980	chr5	+	173472606	173536182	NSG2	63576	173470106	173475106
NM_001042549	chr1	-	212899494	212965139	NSL1	65645	212962639	212967639
NM_003580	chr8	-	59496063	59572404	NSMAF	76341	59569904	59574904
NM_145080	chr16	-	27236314	27280113	NSMCE1	43799	27277613	27282613
NM_001349486	chr8	+	126104064	126379367	NSMCE2	275303	126101564	126106564
NM_001167865	chr10	-	123716602	123734743	NSMCE4A	18141	123732243	123737243
NM_001178064	chr9	-	140342022	140353786	NSMF	11764	140351286	140356286
NM_001261467	chr17	+	28443824	28513493	NSRP1	69669	28441324	28446324
NM_017755	chr5	-	6599351	6633473	NSUN2	34122	6630973	6635973
NM_022072	chr3	+	93781748	93850675	NSUN3	68927	93779248	93784248
NR_045791	chr1	+	46805848	46830824	NSUN4	24976	46803348	46808348
NM_018044	chr7	-	72716512	72722864	NSUN5	6352	72720364	72725364
NR_033322	chr7	+	75039604	75046071	NSUN5P1	6467	75037104	75042104
NR_033323	chr7	-	72418831	72425302	NSUN5P2	6471	72422802	72427802
NM_001351116	chr10	-	18834489	18948185	NSUN6	113696	18945685	18950685
NM_024677	chr4	+	40751913	40813199	NSUN7	61286	40749413	40754413
NM_032526	chr1	-	40124792	40137710	NT5C1A	12918	40135210	40140210
NM_033253	chr2	-	18744136	18770846	NT5C1B	26710	18768346	18773346
NM_001199104	chr2	-	18735988	18770846	NT5C1B-RDH14	34858	18768346	18773346
NM_012229	chr10	-	104847773	104953063	NT5C2	105290	104950563	104955563
NM_001002009	chr7	-	33053724	33102409	NT5C3A	48685	33099909	33104909
NM_052935	chr17	-	39981333	39992523	NT5C3B	11190	39990023	39995023
NM_152729	chr6	+	116421998	116566853	NT5DC1	144855	116419498	116424498
NM_022908	chr3	-	52558384	52569093	NT5DC2	10709	52566593	52571593
NM_001031701	chr12	-	104166080	104234975	NT5DC3	68895	104232475	104237475
NM_001350494	chr2	+	113479062	113500454	NT5DC4	21392	113476562	113481562
NM_002526	chr6	+	86159301	86205509	NT5E	46208	86156801	86161801
NM_020201	chr17	+	17206679	17250977	NT5M	44298	17204179	17209179
NM_001270766	chr16	-	15131709	15149936	NTAN1	18227	15147436	15152436
NM_001102654	chr12	+	5541279	5604465	NTF3	63186	5538779	5543779
NM_006179	chr19	-	49564396	49567124	NTF4	2728	49564624	49569624
NM_001318194	chr16	-	2089815	2097870	NTHL1	8055	2095370	2100370
NM_001048209	chr11	+	131240370	132206716	NTM	966346	131237870	131242870
NR_046820	chr11	+	132154195	132158353	NTM-IT	4158	132151695	132156695
NM_001286796	chr9	+	132371162	132398410	NTMT1	27248	132368662	132373662
NM_004822	chr17	+	8924858	9147317	NTN1	222459	8922358	8927358
NM_006181	chr16	+	2521499	2524146	NTN3	2647	2518999	2523999
NM_001329701	chr12	-	96051582	96184984	NTN4	133402	96182484	96187484
NM_145807	chr19	-	49164663	49176338	NTN5	11675	49173838	49178838
NM_014917	chr1	+	107682539	108027521	NTNG1	344982	107680039	107685039
NM_032536	chr9	+	135037333	135118220	NTNG2	80887	135034833	135039833
NM_001329453	chr1	+	233086276	233114548	NTPCR	28272	233083776	233088776
NM_001007792	chr1	+	156785541	156851642	NTRK1	66101	156783041	156788041
NM_006180	chr9	+	87283372	87641985	NTRK2	358613	87280872	87285872
NM_001243101	chr15	-	88419987	88799962	NTRK3	379975	88797462	88802462
NR_038229	chr15	+	88795960	88814297	NTRK3-AS1	18337	88793460	88798460
NM_006183	chr12	+	86268072	86276770	NTS	8698	86265572	86270572
NM_002531	chr20	+	61340188	61394123	NTSR1	53935	61337688	61342688
NM_012344	chr2	-	11798303	11810329	NTSR2	12026	11807829	11812829
NM_014840	chr12	-	106457124	106533811	NUAK1	76687	106531311	106536311
NM_030952	chr1	-	205271190	205290919	NUAK2	19729	205288419	205293419
NM_016118	chr7	+	151038846	151075548	NUB1	36702	151036346	151041346
NM_002484	chr16	+	10837642	10863208	NUBP1	25566	10835142	10840142
NR_104318	chr16	+	1832923	1839192	NUBP2	6269	1830423	1835423
NM_025152	chr14	+	32030590	32330429	NUBPL	299839	32028090	32033090
NM_006184	chr19	+	49403306	49426540	NUCB1	23234	49400806	49405806
NR_046633	chr19	-	49414186	49422148	NUCB1-AS1	7962	49419648	49424648
NM_001352666	chr11	+	17298260	17353412	NUCB2	55152	17295760	17300760
NM_022731	chr1	-	205681946	205719372	NUCKS1	37426	205716872	205721872
NM_006600	chr1	+	27248212	27273362	NUDC	25150	27245712	27250712
NM_032869	chr8	-	110253147	110346350	NUDCD1	93203	110343850	110348850
NM_001329991	chr5	-	162873533	162887160	NUDCD2	13627	162884660	162889660
NM_015332	chr7	-	44421964	44530385	NUDCD3	108421	44527885	44532885
NM_002452	chr7	+	2281856	2290780	NUDT1	8924	2279356	2284356
NM_153183	chrX	+	51075082	51080377	NUDT10	5295	51072582	51077582
NM_018159	chrX	-	51232862	51239459	NUDT11	6597	51236959	51241959
NM_031438	chr5	-	102884555	102898502	NUDT12	13947	102896002	102901002
NM_001283014	chr10	+	74870132	74891586	NUDT13	21454	74867632	74872632
NM_177533	chr14	-	105639273	105647660	NUDT14	8387	105645160	105650160
NR_136688	chr13	+	48611702	48626878	NUDT15	15176	48609202	48614202
NM_001171905	chr3	+	131100514	131107674	NUDT16	7160	131098014	131103014
NR_002949	chr3	+	131080688	131083966	NUDT16P1	3278	131078188	131083188
NM_001012758	chr1	-	145586492	145589435	NUDT17	2943	145586935	145591935
NM_024815	chr8	-	21964382	21966932	NUDT18	2550	21964432	21969432
NM_001105570	chr19	+	33182866	33204702	NUDT19	21836	33180366	33185366
NM_147172	chr9	+	34329503	34343711	NUDT2	14208	34327003	34332003
NM_007006	chr16	-	56463047	56485261	NUDT21	22214	56482761	56487761
NM_001271831	chr11	+	63993729	63997488	NUDT22	3759	63991229	63996229
NM_006703	chr6	-	34254972	34360457	NUDT3	105485	34357957	34362957
NM_199040	chr12	+	93771698	93797024	NUDT4	25326	93769198	93774198
NR_002212	chr12	+	93771745	93796052	NUDT4P1	24307	93769245	93774245
NR_104005	chr12	+	93771701	93796045	NUDT4P2	24344	93769201	93774201
NM_001321648	chr10	-	12207326	12238143	NUDT5	30817	12235643	12240643
NM_198041	chr4	-	123813798	123844159	NUDT6	30361	123841659	123846659
NM_001243661	chr16	+	77756388	77776157	NUDT7	19769	77753888	77758888
NM_001248011	chr4	+	88343727	88380606	NUDT9	36879	88341227	88346227
NM_145697	chr1	+	163291722	163325553	NUF2	33831	163289222	163294222
NM_012345	chr13	-	45513383	45563613	NUFIP1	50230	45561113	45566113
NM_020772	chr17	-	27582853	27621166	NUFIP2	38313	27618666	27623666
NM_001010906	chr8	-	27879480	27941388	NUGGC	61908	27938888	27943888
NM_006185	chr11	-	71713909	71791739	NUMA1	77830	71789239	71794239
NM_001005745	chr14	-	73741917	73925286	NUMB	183369	73922786	73927786
NM_001289979	chr19	-	41171811	41196563	NUMBL	24752	41194063	41199063
NM_020401	chr12	+	69080730	69139594	NUP107	58864	69078230	69083230
NM_018230	chr1	-	229577043	229644088	NUP133	67045	229641588	229646588
NM_005124	chr6	-	17615265	17707065	NUP153	91800	17704565	17709565
NM_004298	chr5	-	37291734	37371228	NUP155	79494	37368728	37373728
NM_015231	chr11	-	47799634	47870096	NUP160	70462	47867596	47872596
NM_015354	chr9	+	131709971	131769375	NUP188	59404	131707471	131712471
NM_015135	chr7	+	135242661	135333499	NUP205	90838	135240161	135245161
NM_024923	chr3	-	13357729	13461819	NUP210	104090	13459319	13464319
NM_001159484	chr1	-	153965167	154127592	NUP210L	162425	154125092	154130092
NR_034158	chr3	+	126380923	126390782	NUP210P1	9859	126378423	126383423
NM_005085	chr9	+	134000947	134110057	NUP214	109110	133998447	134003447
NM_001287584	chr2	+	183982217	184026412	NUP35	44195	183979717	183984717
NM_024057	chr12	-	102467966	102513909	NUP37	45943	102511409	102516409
NR_104456	chr6	-	150045451	150067708	NUP43	22257	150065208	150070208
NM_007172	chr22	+	45559725	45583890	NUP50	24165	45557225	45562225
NR_038956	chr22	-	45529638	45559662	NUP50-AS1	30024	45557162	45562162
NR_103780	chr4	-	77035811	77069668	NUP54	33857	77067168	77072168
NM_014089	chr13	+	25875665	25916561	NUP58	40896	25873165	25878165
NM_016553	chr19	-	50410083	50432988	NUP62	22905	50430488	50435488
NR_033676	chrX	-	106366656	106449670	NUP62CL	83014	106447170	106452170
NM_001330472	chr17	+	73201530	73231854	NUP85	30324	73199030	73204030
NM_001320653	chr17	-	5288152	5323059	NUP88	34907	5320559	5325559
NM_014669	chr16	+	56764016	56878861	NUP93	114845	56761516	56766516
NM_139132	chr11	-	3696239	3819022	NUP98	122783	3816522	3821522
NM_007342	chr7	+	23221445	23240630	NUPL2	19185	23218945	23223945
NM_138459	chr6	+	117996622	118031886	NUS1	35264	117994122	117999122
NM_001243142	chr15	+	41624891	41673248	NUSAP1	48357	41622391	41627391
NM_005796	chr16	+	67880634	67906469	NUTF2	25835	67878134	67883134
NM_001284293	chr15	+	34635515	34649938	NUTM1	14423	34633015	34638015
NM_001099338	chr10	+	88985204	88994733	NUTM2A	9529	88982704	88987704
NR_024397	chr10	-	88998423	89102315	NUTM2A-AS1	103892	89099815	89104815
NM_001278495	chr10	+	81462982	81472513	NUTM2B	9531	81460482	81465482
NR_120613	chr10	-	81451255	81586350	NUTM2B-AS1	135095	81583850	81588850
NM_001009610	chr10	+	89117476	89130452	NUTM2D	12976	89114976	89119976
NM_017561	chr9	-	97080477	97090926	NUTM2F	10449	97088426	97093426
NM_001045477	chr9	+	99691285	99704572	NUTM2G	13287	99688785	99693785
NM_002533	chr1	-	224415035	224517891	NVL	102856	224515391	224520391
NM_001290355	chr19	+	16830786	16928774	NWD1	97988	16828286	16833286
NM_001144990	chr4	+	37246689	37451087	NWD2	204398	37244189	37249189
NM_001081491	chr11	-	62559597	62572964	NXF1	13367	62570464	62575464
NM_022053	chrX	-	101615315	101694929	NXF2	79614	101692429	101697429
NM_001099686	chrX	-	101615315	101694929	NXF2B	79614	101692429	101697429
NM_022052	chrX	-	102330749	102348022	NXF3	17273	102345522	102350522
NR_002216	chrX	+	101804892	101826621	NXF4	21729	101802392	101807392
NR_028089	chrX	-	101087084	101112549	NXF5	25465	101110049	101115049
NM_022463	chr17	-	702552	882998	NXN	180446	880498	885498
NM_138454	chr19	-	17566233	17571725	NXNL1	5492	17569225	17574225
NM_145283	chr9	+	91150015	91190704	NXNL2	40689	91147515	91152515
NM_152315	chr11	-	114392436	114430617	NXPE1	38181	114428117	114433117
NM_182495	chr11	+	114549199	114577652	NXPE2	28453	114546699	114551699
NM_145037	chr3	+	101498020	101547075	NXPE3	49055	101495520	101500520
NM_017678	chr11	-	114441312	114466484	NXPE4	25172	114463984	114468984
NM_152745	chr7	+	8473584	8792593	NXPH1	319009	8471084	8476084
NM_007226	chr2	-	139426726	139537811	NXPH2	111085	139535311	139540311
NM_007225	chr17	+	47653297	47661171	NXPH3	7874	47650797	47655797
NM_007224	chr12	+	57610577	57620232	NXPH4	9655	57608077	57613077
NM_013248	chr20	+	23331372	23335408	NXT1	4036	23328872	23333872
NM_018698	chrX	+	108779009	108787927	NXT2	8918	108776509	108781509
NM_173564	chr7	+	100081549	100092424	NYAP1	10875	100079049	100084049
NM_020864	chr2	+	226265601	226518734	NYAP2	253133	226263101	226268101
NM_025081	chr14	+	24867991	24888494	NYNRIN	20503	24865491	24870491
NM_022567	chrX	+	41306712	41334905	NYX	28193	41304212	41309212
NR_024021	chr18	+	56702910	56720446	OACYLP	17536	56700410	56705410
NM_178507	chr11	+	120081682	120101041	OAF	19359	120079182	120084182
NM_001329690	chr6	-	41034526	41065526	OARD1	31000	41063026	41068026
NM_001320151	chr12	+	113344581	113369995	OAS1	25414	113342081	113347081
NM_016817	chr12	+	113416273	113449528	OAS2	33255	113413773	113418773
NM_006187	chr12	+	113376237	113411055	OAS3	34818	113373737	113378737
NM_001261825	chr12	-	121458094	121477045	OASL	18951	121474545	121479545
NM_001322967	chr10	-	126085871	126107545	OAT	21674	126105045	126110045
NM_004152	chr19	+	2269484	2273487	OAZ1	4003	2266984	2271984
NM_002537	chr15	-	64979772	64995480	OAZ2	15708	64992980	64997980
NM_001134939	chr1	+	151735444	151743806	OAZ3	8362	151732944	151737944
NM_001293193	chr9	+	138437984	138441815	OBP2A	3831	138435484	138440484
NM_001288987	chr9	-	136080665	136084637	OBP2B	3972	136082137	136087137
NM_001271223	chr1	+	228395830	228566575	OBSCN	170745	228393330	228398330
NR_073155	chr1	-	228391206	228401356	OBSCN-AS1	10150	228398856	228403856
NM_015311	chr2	-	220415449	220436268	OBSL1	20819	220433768	220438768
NM_001080399	chr8	-	133036466	133071627	OC90	35161	133069127	133074127
NM_001300984	chr15	-	28000020	28344458	OCA2	344438	28341958	28346958
NM_024578	chr19	+	17337012	17340028	OCEL1	3016	17334512	17339512
NM_017830	chr4	+	48833059	48863834	OCIAD1	30775	48830559	48835559
NR_146806	chr4	-	48854025	48862220	OCIAD1-AS1	8195	48859720	48864720
NM_001286774	chr4	-	48887396	48908845	OCIAD2	21449	48906345	48911345
NM_002538	chr5	+	68788118	68853931	OCLN	65813	68785618	68790618
NM_001097622	chr7	+	5920428	5925994	OCM	5566	5917928	5922928
NM_006188	chr7	-	97614012	97619416	OCM2	5404	97616916	97621916
NM_001318784	chrX	+	128674231	128726537	OCRL	52306	128671731	128676731
NM_080721	chr20	-	45169669	45179213	OCSTAMP	9544	45176713	45181713
NM_017855	chr4	+	71062243	71070293	ODAM	8050	71059743	71064743
NM_002539	chr2	-	10580496	10588680	ODC1	8184	10586180	10591180
NM_024410	chr8	+	103563847	103573245	ODF1	9398	103561347	103566347
NM_001351584	chr9	+	131217433	131263571	ODF2	46138	131214933	131219933
NM_001184765	chr1	-	86812506	86862025	ODF2L	49519	86859525	86864525
NM_001286136	chr11	+	196760	200258	ODF3	3498	194260	199260
NM_175881	chr15	+	76016318	76020029	ODF3L1	3711	76013818	76018818
NM_182577	chr19	-	463345	474983	ODF3L2	11638	472483	477483
NM_001319953	chr17	+	8243157	8249363	ODF4	6206	8240657	8245657
NM_003611	chrX	+	13752831	13787480	OFD1	34649	13750331	13755331
NM_002541	chr7	+	44646120	44748669	OGDH	102549	44643620	44648620
NM_001347822	chr10	-	50942686	50970425	OGDHL	27739	50967925	50972925
NM_001324360	chr16	+	56485391	56511407	OGFOD1	26016	56482891	56487891
NM_001304837	chr12	+	123459249	123464588	OGFOD2	5339	123456749	123461749
NM_024648	chr17	-	80347085	80376513	OGFOD3	29428	80374013	80379013
NM_007346	chr20	+	61436151	61445352	OGFR	9201	61433651	61438651
NR_102430	chr20	-	61431978	61436939	OGFR-AS1	4961	61434439	61439439
NM_001324266	chr6	+	71998144	72018762	OGFRL1	20618	71995644	72000644
NR_036498	chr22	+	42665758	42670868	OGFRP1	5110	42663258	42668258
NM_016821	chr3	+	9791627	9808353	OGG1	16726	9789127	9794127
NM_033014	chr9	-	95145552	95166981	OGN	21429	95164481	95169481
NM_181672	chrX	+	70752911	70795747	OGT	42836	70750411	70755411
NM_007280	chr15	-	41601465	41624819	OIP5	23354	41622319	41627319
NR_026757	chr15	+	41576200	41591795	OIP5-AS1	15595	41573700	41578700
NM_152635	chr10	+	74653313	74692794	OIT3	39481	74650813	74655813
NM_001328688	chr2	-	174937174	175113398	OLA1	176224	175110898	175115898
NM_001039702	chr10	+	15085894	15115851	OLAH	29957	15083394	15088394
NM_014279	chr9	+	137967088	138013030	OLFM1	45942	137964588	137969588
NM_058164	chr19	-	9964393	10047228	OLFM2	82835	10044728	10049728
NR_110211	chr1	-	102268122	102462790	OLFM3	194668	102460290	102465290
NM_006418	chr13	+	53602875	53626196	OLFM4	23321	53600375	53605375
NR_133006	chr11	-	5539539	5543015	OLFM5P	3476	5540515	5545515
NM_198474	chr11	+	7506599	7532606	OLFML1	26007	7504099	7509099
NM_182487	chr9	+	127539436	127577170	OLFML2A	37734	127536936	127541936
NM_001297713	chr1	-	161952981	161994255	OLFML2B	41274	161991755	161996755
NM_001286353	chr1	+	114522012	114524876	OLFML3	2864	114519512	114524512
NM_005806	chr21	+	34398215	34401503	OLIG2	3288	34395715	34400715
NR_026762	chr10	+	102133332	102148111	OLMALINC	14779	102130832	102135832
NM_001172633	chr12	-	10310898	10324790	OLR1	13892	10322290	10327290
NM_145243	chr1	-	58946390	59012471	OMA1	66081	59009971	59014971
NM_005014	chr9	-	95176526	95186836	OMD	10310	95184336	95189336
NM_002544	chr17	-	29621667	29624380	OMG	2713	29621880	29626880
NM_004498	chr15	-	53049159	53082209	ONECUT1	33050	53079709	53084709
NM_004852	chr18	+	55102916	55158530	ONECUT2	55614	55100416	55105416
NM_001080488	chr19	+	1753661	1775444	ONECUT3	21783	1751161	1756161
NR_130719	chr11	+	59710351	59763318	OOSP1	52967	59707851	59712851
NM_173801	chr11	+	59807747	59815516	OOSP2	7769	59805247	59810247
NM_130832	chr3	+	193310932	193415600	OPA1	104668	193308432	193313432
NR_046634	chr3	-	193336387	193345121	OPA1-AS1	8734	193342621	193347621
NM_001017989	chr19	-	46031024	46088122	OPA3	57098	46085622	46090622
NR_104297	chr10	-	98102974	98119122	OPALIN	16148	98116622	98121622
NM_001319104	chr11	-	132284558	133402507	OPCML	1117949	133400007	133405007
NM_002547	chrX	-	67262185	67653299	OPHN1	391114	67650799	67655799
NM_017570	chr8	-	145106166	145115606	OPLAH	9440	145113106	145118106
NM_020061	chrX	+	153409697	153424507	OPN1LW	14810	153407197	153412197
NM_000513	chrX	+	153485202	153499470	OPN1MW	14268	153482702	153487702
NM_001048181	chrX	+	153485202	153498755	OPN1MW2	13553	153482702	153487702
NM_001330067	chrX	+	153485224	153498755	OPN1MW3	13531	153482724	153487724
NM_001708	chr7	-	128412542	128415844	OPN1SW	3302	128413344	128418344
NM_014322	chr1	-	241756451	241803701	OPN3	47250	241801201	241806201
NM_033282	chr10	+	88414313	88426216	OPN4	11903	88411813	88416813
NM_181744	chr6	+	47749774	47794116	OPN5	44342	47747274	47752274
NM_000911	chr1	+	29138653	29190208	OPRD1	51555	29136153	29141153
NM_001282904	chr8	-	54138275	54164257	OPRK1	25982	54161757	54166757
NM_182647	chr20	+	62711434	62731996	OPRL1	20562	62708934	62713934
NM_001008503	chr6	+	154360545	154568001	OPRM1	207456	154358045	154363045
NM_001302807	chr4	+	71263598	71275914	OPRPN	12316	71261098	71266098
NM_014359	chr1	+	203463270	203478077	OPTC	14807	203460770	203465770
NM_021980	chr10	+	13142081	13180276	OPTN	38195	13139581	13144581
NM_001004297	chr10	-	45798101	45811056	OR13A1	12955	45808556	45813556
NR_126023	chr7	-	143935665	144052811	OR2A1-AS1	117146	144050311	144055311
NM_198074	chr1	-	247693433	247697141	OR2C3	3708	247694641	247699641
NM_001318022	chr6_apd_hap1	+	728408	735577	OR2H1	7169	725908	730908
NM_001005216	chr6_mcf_hap5	+	383133	453829	OR2J3	70696	380633	385633
NM_001304535	chr1	+	248100330	248264224	OR2L13	163894	248097830	248102830
NM_001005513	chr11	-	48366899	48373999	OR4C45	7100	48371499	48376499
NR_046417	chr15	+	102382321	102390527	OR4F13P	8206	102379821	102384821
NM_001004723	chr14	+	20271928	20296531	OR4N2	24603	20269428	20274428
NR_038321	chr11	-	5362112	5526882	OR51B5	164770	5524382	5529382
NM_152430	chr11	+	4665155	4676716	OR51E1	11561	4662655	4667655
NM_030774	chr11	-	4701400	4719076	OR51E2	17676	4716576	4721576
NM_175883	chr19	+	9296269	9299493	OR7D2	3224	9293769	9298769
NR_002171	chr13	+	64311567	64316701	OR7E156P	5134	64309067	64314067
NR_120437	chr12	+	52473479	52502103	OR7E47P	28624	52470979	52475979
NR_027688	chr11	-	55746178	55753881	OR7E5P	7703	55751381	55756381
NR_002185	chr2	+	71251204	71257060	OR7E91P	5856	71248704	71253704
NM_001002905	chr11	+	124120422	124135756	OR8G1	15334	124117922	124122922
NM_001005212	chr11	+	57791352	57949038	OR9Q1	157686	57788852	57793852
NM_032790	chr12	+	122064454	122079946	ORAI1	15492	122061954	122066954
NM_032831	chr7	+	102073976	102097268	ORAI2	23292	102071476	102076476
NM_152288	chr16	+	30960404	30966259	ORAI3	5855	30957904	30962904
NM_153451	chr11	-	69480331	69490165	ORAOV1	9834	69487665	69492665
NM_001190818	chr1	-	52838500	52870143	ORC1	31643	52867643	52872643
NR_033915	chr2	-	201774893	201828424	ORC2	53531	201825924	201830924
NM_001197259	chr6	+	88299784	88377172	ORC3	77388	88297284	88302284
NM_181742	chr2	-	148687965	148779173	ORC4	91208	148776673	148781673
NM_002553	chr7	-	103766787	103848495	ORC5	81708	103845995	103850995
NR_037620	chr16	+	46723557	46732306	ORC6	8749	46721057	46726057
NM_000607	chr9	+	117085302	117088759	ORM1	3457	117082802	117087802
NM_000608	chr9	+	117092068	117095536	ORM2	3468	117089568	117094568
NM_016467	chr2	-	190634992	190649097	ORMDL1	14105	190646597	190651597
NM_014182	chr12	+	56211805	56214959	ORMDL2	3154	56209305	56214305
NM_001320802	chr17	-	38077293	38084057	ORMDL3	6764	38081557	38086557
NM_006812	chr12	+	58087737	58115340	OS9	27603	58085237	58090237
NM_002556	chr11	-	59341870	59383617	OSBP	41747	59381117	59386117
NM_001282738	chr22	+	31089768	31303811	OSBP2	214043	31087268	31092268
NM_017784	chr3	-	31702316	32023342	OSBPL10	321026	32020842	32025842
NR_049771	chr3	+	31745704	31763078	OSBPL10-AS1	17374	31743204	31748204
NM_022776	chr3	-	125247701	125314381	OSBPL11	66680	125311881	125316881
NM_080597	chr18	-	21742010	21977833	OSBPL1A	235823	21975333	21980333
NM_001278649	chr20	+	60813540	60871269	OSBPL2	57729	60811040	60816040
NM_015550	chr7	-	24836155	25019831	OSBPL3	183676	25017331	25022331
NM_145638	chr11	-	3108345	3186582	OSBPL5	78237	3184082	3189082
NM_032523	chr2	+	179059207	179264160	OSBPL6	204953	179056707	179061707
NM_145798	chr17	-	45884732	45899147	OSBPL7	14415	45896647	45901647
NM_020841	chr12	-	76745577	76953589	OSBPL8	208012	76951089	76956089
NM_001350209	chr1	+	52082545	52254891	OSBPL9	172346	52080045	52085045
NM_133169	chr19	-	54597932	54605994	OSCAR	8062	54603494	54608494
NM_145047	chr1	-	36883506	36916086	OSCP1	32580	36913586	36918586
NM_016470	chr20	-	42824580	42839546	OSER1	14966	42837046	42842046
NR_038339	chr20	+	42839599	42854667	OSER1-AS1	15068	42837099	42842099
NM_017807	chr14	-	20915206	20923267	OSGEP	8061	20920767	20925767
NM_022353	chr2	-	190611385	190627924	OSGEPL1	16539	190625424	190630424
NR_102429	chr2	+	190627505	190630282	OSGEPL1-AS1	2777	190625005	190630005
NM_182981	chr16	+	83986826	83999937	OSGIN1	13111	83984326	83989326
NM_004337	chr8	+	90914095	90940095	OSGIN2	26000	90911595	90916595
NM_020530	chr22	-	30658816	30662832	OSM	4016	30660332	30665332
NM_001323505	chr5	+	38845959	38935743	OSMR	89784	38843459	38848459
NR_109951	chr5	-	38693314	38845931	OSMR-AS1	152617	38843431	38848431
NM_145260	chr2	-	19551245	19558372	OSR1	7127	19555872	19560872
NM_053001	chr8	+	99956630	99964332	OSR2	7702	99954130	99959130
NM_001267818	chr4	+	109571740	109588978	OSTC	17238	109569240	109574240
NR_028496	chr6	-	159262157	159278664	OSTCP1	16507	159276164	159281164
NM_012383	chr9	+	77703397	77762114	OSTF1	58717	77700897	77705897
NM_014028	chr6	-	108362612	108395941	OSTM1	33329	108393441	108398441
NR_145458	chr6	+	108444836	108480599	OSTM1-AS1	35763	108442336	108447336
NM_198184	chr3	+	190917029	190983403	OSTN	66374	190914529	190919529
NR_133663	chr3	-	190931083	190952394	OSTN-AS1	21311	190949894	190954894
NM_000531	chrX	+	38211735	38280703	OTC	68968	38209235	38214235
NM_144672	chr16	+	21689834	21772050	OTOA	82216	21687334	21692334
NM_194248	chr2	-	26680070	26781566	OTOF	101496	26779066	26784066
NM_001277269	chr11	+	17568919	17667491	OTOG	98572	17566419	17571419
NM_173591	chr12	+	80603232	80772870	OTOGL	169638	80600732	80605732
NM_001080440	chr3	+	161214595	161221730	OTOL1	7135	161212095	161217095
NM_177998	chr4	-	4190529	4228621	OTOP1	38092	4226121	4231121
NM_178160	chr17	+	72920369	72930006	OTOP2	9637	72917869	72922869
NM_178233	chr17	+	72931896	72946087	OTOP3	14191	72929396	72934396
NM_020157	chr20	+	16728997	16732809	OTOR	3812	16726497	16731497
NM_032109	chr5	-	76924536	76934522	OTP	9986	76932022	76937022
NM_017670	chr11	+	63753324	63765892	OTUB1	12568	63750824	63755824
NM_023112	chr14	+	94492723	94515276	OTUB2	22553	94490223	94495223
NM_001145373	chr10	+	23728197	23731310	OTUD1	3113	23725697	23730697
NM_015207	chr1	+	20208887	20239437	OTUD3	30550	20206387	20211387
NM_001102653	chr4	-	146054801	146100832	OTUD4	46031	146098332	146103332
NM_001136159	chrX	-	48779302	48815648	OTUD5	36346	48813148	48818148
NM_016023	chr8	+	92082423	92099323	OTUD6B	16900	92079923	92084923
NR_110438	chr8	-	92072133	92082417	OTUD6B-AS1	10284	92079917	92084917
NM_130901	chr15	-	31767600	32162875	OTUD7A	395275	32160375	32165375
NM_020205	chr1	-	149912228	149982686	OTUD7B	70458	149980186	149985186
NM_138348	chr5	+	14664753	14699959	OTULIN	35206	14662253	14667253
NM_001199770	chr2	+	63277191	63284966	OTX1	7775	63274691	63279691
NM_021728	chr14	-	57267424	57277194	OTX2	9770	57274694	57279694
NR_029385	chr14	+	57279875	57398026	OTX2-AS1	118151	57277375	57282375
NR_125716	chr1	+	180528109	180535654	OVAAL	7545	180525609	180530609
NM_183378	chr12	-	29580488	29650619	OVCH1	70131	29648119	29653119
NR_073172	chr12	+	29542226	29640257	OVCH1-AS1	98031	29539726	29544726
NM_198185	chr11	-	7711154	7727941	OVCH2	16787	7725441	7730441
NM_002557	chr1	-	111956936	111970399	OVGP1	13463	111967899	111972899
NM_004561	chr11	+	65554504	65564690	OVOL1	10186	65552004	65557004
NM_001303462	chr20	-	18004795	18039832	OVOL2	35037	18037332	18042332
NM_001302757	chr19	+	36602104	36604613	OVOL3	2509	36599604	36604604
NM_005015	chr14	+	23235730	23240998	OXA1L	5268	23233230	23238230
NM_000436	chr5	-	41730166	41870791	OXCT1	140625	41868291	41873291
NM_001346195	chr13	-	97637972	97646984	OXGR1	9012	97644484	97649484
NM_001352982	chr3	+	16306584	16393602	OXNAD1	87018	16304084	16309084
NM_018002	chr8	+	107282405	107764921	OXR1	482516	107279905	107284905
NM_001145391	chr3	+	25831562	25836025	OXSM	4463	25829062	25834062
NM_005109	chr3	+	38207025	38296979	OXSR1	89954	38204525	38209525
NM_000916	chr3	-	8792094	8811300	OXTR	19206	8808800	8813800
NM_002558	chr17	-	3799884	3819960	P2RX1	20076	3817460	3822460
NM_016318	chr12	+	133195365	133198972	P2RX2	3607	133192865	133197865
NM_002559	chr11	+	57105840	57137549	P2RX3	31709	57103340	57108340
NM_001261398	chr12	+	121647663	121671909	P2RX4	24246	121645163	121650163
NM_001204520	chr17	-	3576521	3599698	P2RX5	23177	3597198	3602198
NR_037928	chr17	-	3566186	3599698	P2RX5-TAX1BP3	33512	3597198	3602198
NM_001159554	chr22	+	21369441	21382302	P2RX6	12861	21366941	21371941
NR_033953	chr12	+	121570621	121624354	P2RX7	53733	121568121	121573121
NM_002563	chr3	+	152552481	152559228	P2RY1	6747	152549981	152554981
NM_014499	chrX	+	78200828	78219224	P2RY10	18396	78198328	78203328
NM_002566	chr19	+	10222196	10226064	P2RY11	3868	10219696	10224696
NM_022788	chr3	-	151054630	151102600	P2RY12	47970	151100100	151105100
NM_176894	chr3	-	151044095	151047337	P2RY13	3242	151044837	151049837
NM_014879	chr3	-	150929904	150996230	P2RY14	66326	150993730	150998730
NM_002564	chr11	+	72929342	72953472	P2RY2	24130	72926842	72931842
NM_001277205	chr11	+	72975549	73009670	P2RY6	34121	72973049	72978049
NM_178129	chrX	-	1581465	1656037	P2RY8	74572	1653537	1658537
NM_001146289	chr1	-	43212005	43232755	P3H1	20750	43230255	43235255
NM_001134418	chr3	-	189674516	189840226	P3H2	165710	189837726	189842726
NR_126419	chr3	+	189838752	189862635	P3H2-AS1	23883	189836252	189841252
NM_014262	chr12	+	6937537	6949018	P3H3	11481	6935037	6940037
NM_006455	chr17	-	39958204	39968451	P3H4	10247	39965951	39970951
NM_000917	chr10	-	74766979	74856732	P4HA1	89753	74854232	74859232
NM_001142598	chr5	-	131528303	131563556	P4HA2	35253	131561056	131566056
NR_047470	chr5	+	131520568	131528498	P4HA2-AS1	7930	131518068	131523068
NM_182904	chr11	-	73977693	74022721	P4HA3	45028	74020221	74025221
NR_120556	chr11	+	74022406	74035750	P4HA3-AS1	13344	74019906	74024906
NM_000918	chr17	-	79801033	79818544	P4HB	17511	79816044	79821044
NM_177938	chr3	+	49027340	49044581	P4HTM	17241	49024840	49029840
NM_006191	chr12	+	56498102	56507694	PA2G4	9592	56495602	56500602
NR_003284	chr3	-	156527059	156529810	PA2G4P4	2751	156527310	156532310
NM_001267806	chr11	+	73587743	73638781	PAAF1	51038	73585243	73590243
NM_002568	chr8	-	101715143	101734315	PABPC1	19172	101731815	101736815
NR_134983	chr20	+	43538700	43567958	PABPC1L	29258	43536200	43541200
NR_110398	chrX	-	72218226	72222695	PABPC1L2B-AS1	4469	72220195	72225195
NR_026904	chr2	+	147344624	147348558	PABPC1P2	3934	147342124	147347124
NM_001135653	chr1	-	40026484	40042521	PABPC4	16037	40040021	40045021
NM_001114734	chr4	-	135117488	135122903	PABPC4L	5415	135120403	135125403
NM_080832	chrX	+	90689596	90693583	PABPC5	3987	90687096	90692096
NR_110659	chrX	-	90669901	90689998	PABPC5-AS1	20097	90687498	90692498
NM_004643	chr14	+	23789396	23795394	PABPN1	5998	23786896	23791896
NM_001294328	chr16	-	88929747	88933068	PABPN1L	3321	88930568	88935568
NM_001080378	chr6	+	163148163	163736524	PACRG	588361	163145663	163150663
NR_028390	chr6	-	163731016	163745505	PACRG-AS1	14489	163743005	163748005
NR_110871	chr6	-	163464011	163475193	PACRG-AS2	11182	163472693	163477693
NR_122120	chr6	-	163602676	163613034	PACRG-AS3	10358	163610534	163615534
NR_133933	chr4	+	20697904	20754523	PACRGL	56619	20695404	20700404
NM_018026	chr11	+	65837823	66012218	PACS1	174395	65835323	65840323
NM_001243127	chr14	+	105767147	105864484	PACS2	97337	105764647	105769647
NM_020804	chr6	+	34433837	34503000	PACSIN1	69163	34431337	34436337
NM_001184970	chr22	-	43265771	43411182	PACSIN2	145411	43408682	43413682
NM_001184974	chr11	-	47199072	47208010	PACSIN3	8938	47205510	47210510
NM_013358	chr1	+	17531620	17572501	PADI1	40881	17529120	17534120
NM_007365	chr1	-	17393255	17445948	PADI2	52693	17443448	17448448
NM_016233	chr1	+	17575592	17610727	PADI3	35135	17573092	17578092
NM_012387	chr1	+	17634689	17690495	PADI4	55806	17632189	17637189
NM_207421	chr1	+	17698690	17728195	PADI6	29505	17696190	17701190
NM_002571	chr9	+	138453601	138458622	PAEP	5021	138451101	138456101
NR_046384	chr19	-	39876269	39881835	PAF1	5566	39879335	39884335
NM_000430	chr17	+	2496922	2588909	PAFAH1B1	91987	2494422	2499422
NR_110268	chr11	+	117014999	117048889	PAFAH1B2	33890	117012499	117017499
NM_001145940	chr19	-	42801184	42806952	PAFAH1B3	5768	42804452	42809452
NM_000437	chr1	-	26286257	26324648	PAFAH2	38391	26322148	26327148
NM_018440	chr8	-	81880045	82024303	PAG1	144258	82021803	82026803
NM_003785	chrX	-	49452053	49460596	PAGE1	8543	49458096	49463096
NM_207339	chrX	+	55115484	55119269	PAGE2	3785	55112984	55117984
NM_001015038	chrX	+	55101488	55105336	PAGE2B	3848	55098988	55103988
NM_001303613	chrX	-	55284848	55291349	PAGE3	6501	55288849	55293849
NM_001318877	chrX	+	49593862	49598867	PAGE4	5005	49591362	49596362
NM_001013435	chrX	+	55246779	55250541	PAGE5	3762	55244279	55249279
NM_024516	chr16	+	29827527	29833816	PAGR1	6289	29825027	29830027
NM_000277	chr12	-	103232103	103311381	PAH	79278	103308881	103313881
NM_006452	chr4	+	57301914	57327534	PAICS	25620	57299414	57304414
NM_183323	chr5	-	43526369	43557521	PAIP1	31152	43555021	43560021
NR_109830	chr5	+	138677520	138705409	PAIP2	27889	138675020	138680020
NM_020459	chr2	-	71409867	71454233	PAIP2B	44366	71451733	71456733
NM_002576	chr11	-	77033059	77185108	PAK1	152049	77182608	77187608
NM_017906	chr6	+	10695187	10709970	PAK1IP1	14783	10692687	10697687
NM_002577	chr3	+	196466727	196559518	PAK2	92791	196464227	196469227
NM_001324330	chrX	+	110187468	110470589	PAK3	283121	110184968	110189968
NM_005884	chr19	+	39616419	39670046	PAK4	53627	39613919	39618919
NM_177990	chr20	-	9518036	9819687	PAK5	301651	9817187	9822187
NM_001276718	chr15	+	40531291	40569688	PAK6	38397	40528791	40533791
NM_024675	chr16	-	23614482	23652678	PALB2	38196	23650178	23655178
NM_014431	chr10	+	72238563	72328206	PALD1	89643	72236063	72241063
NM_001166108	chr4	+	169418216	169849608	PALLD	431392	169415716	169420716
NM_001040134	chr19	+	708952	748330	PALM	39378	706452	711452
NM_001037293	chr9	+	112403067	112713756	PALM2	310689	112400567	112405567
NM_147150	chr9	+	112542576	112934791	PALM2-AKAP2	392215	112540076	112545076
NM_001145028	chr19	-	14164178	14169971	PALM3	5793	14167471	14172471
NM_017734	chr1	+	100111430	100160097	PALMD	48667	100108930	100113930
NM_001319943	chr5	+	102090486	102366808	PAM	276322	102087986	102092986
NM_016069	chr16	-	4390249	4401400	PAM16	11151	4398900	4403900
NM_001282675	chr11	-	35453375	35551848	PAMR1	98473	35549348	35554348
NM_014871	chr12	-	56710006	56727837	PAN2	17831	56725337	56730337
NM_175854	chr13	+	28712642	28869475	PAN3	156833	28710142	28715142
NR_147203	chr4	-	111516668	111536614	PANCR	19946	111534114	111539114
NM_148977	chr10	-	91339253	91405329	PANK1	66076	91402829	91407829
NM_024960	chr20	+	3869485	3910529	PANK2	41044	3866985	3871985
NM_024594	chr5	-	167982627	168006614	PANK3	23987	168004114	168009114
NM_018216	chr1	-	2439969	2458067	PANK4	18098	2455567	2460567
NM_015368	chr11	+	93862093	93915137	PANX1	53044	93859593	93864593
NM_001160300	chr22	+	50609159	50618724	PANX2	9565	50606659	50611659
NM_052959	chr11	+	124481452	124490251	PANX3	8799	124478952	124483952
NR_109766	chr10	+	135192740	135205200	PAOX	12460	135190240	135195240
NM_001114393	chr5	+	78908239	78984066	PAPD4	75827	78905739	78910739
NM_001040285	chr16	+	50186828	50269219	PAPD5	82391	50184328	50189328
NM_001171805	chr5	+	6714717	6757161	PAPD7	42444	6712217	6717217
NM_173462	chr14	+	73704204	73741347	PAPLN	37143	73701704	73706704
NM_001293632	chr14	+	96968712	97033453	PAPOLA	64741	96966212	96971212
NM_020144	chr7	-	4897368	4901625	PAPOLB	4257	4899125	4904125
NM_022894	chr2	+	60983364	61029221	PAPOLG	45857	60980864	60985864
NM_002581	chr9	+	118916070	119164600	PAPPA	248530	118913570	118918570
NM_020318	chr1	+	176432306	176811970	PAPPA2	379664	176429806	176434806
NM_005443	chr4	-	108534821	108641419	PAPSS1	106598	108638919	108643919
NM_004670	chr10	+	89419475	89507462	PAPSS2	87987	89416975	89421975
NM_001040202	chr4	-	79839093	79860582	PAQR3	21489	79858082	79863082
NM_001284512	chr16	+	3019245	3023490	PAQR4	4245	3016745	3021745
NM_017705	chr15	+	69591293	69699976	PAQR5	108683	69588793	69593793
NM_001272107	chr1	-	156213111	156217908	PAQR6	4797	156215408	156220408
NM_178422	chr1	-	26187974	26197744	PAQR7	9770	26195244	26200244
NM_133367	chr6	+	52226925	52272575	PAQR8	45650	52224425	52229425
NR_125393	chr3	+	142682899	142719932	PAQR9-AS1	37033	142680399	142685399
NM_001184786	chr10	-	34398487	35104253	PARD3	705766	35101753	35106753
NM_001302769	chr2	+	205410515	206484886	PARD3B	1074371	205408015	205413015
NM_032521	chr20	+	49348080	49370278	PARD6B	22198	49345580	49350580
NM_032510	chr18	-	77915116	78005397	PARD6G	90281	78002897	78007897
NR_028340	chr18	+	77905806	77936315	PARD6G-AS1	30509	77903306	77908306
NM_001303486	chr10	-	51026319	51371371	PARG	345052	51368871	51373871
NR_029388	chr10	-	51253907	51371344	PARGP1	117437	51368844	51373844
NM_007262	chr1	+	8021713	8045342	PARK7	23629	8019213	8024213
NM_001324437	chr3	-	183547172	183602696	PARL	55524	183600196	183605196
NM_015393	chr4	+	75858284	75975325	PARM1	117041	75855784	75860784
NM_002582	chr16	-	14529556	14724128	PARN	194572	14721628	14726628
NM_001618	chr1	-	226548391	226595801	PARP1	47410	226593301	226598301
NM_032789	chr8	-	145051319	145060639	PARP10	9320	145058139	145063139
NR_104461	chr12	-	3918026	3982614	PARP11	64588	3980114	3985114
NR_130117	chr7	-	139723543	139763521	PARP12	39978	139761021	139766021
NM_017554	chr3	+	122399671	122449687	PARP14	50016	122397171	122402171
NM_001308320	chr3	+	122296448	122357894	PARP15	61446	122293948	122298948
NM_017851	chr15	-	65550431	65579181	PARP16	28750	65576681	65581681
NM_005484	chr14	+	20811772	20826063	PARP2	14291	20809272	20814272
NM_005485	chr3	+	51976320	51982883	PARP3	6563	51973820	51978820
NM_006437	chr13	-	24995068	25086948	PARP4	91880	25084448	25089448
NR_136603	chr15	-	72533521	72564916	PARP6	31395	72562416	72567416
NM_001178055	chr5	+	49961732	50142356	PARP8	180624	49959232	49964232
NM_031458	chr3	-	122246759	122283523	PARP9	36764	122281023	122286023
NM_001319988	chr12	+	102513948	102591298	PARPBP	77350	102511448	102516448
NM_152268	chr1	-	55222570	55230226	PARS2	7656	55227726	55232726
NR_024617	chr5	+	59783539	59843484	PART1	59945	59781039	59786039
NM_018222	chr11	+	12399025	12556903	PARVA	157878	12396525	12401525
NM_001003828	chr22	+	44395090	44565112	PARVB	170022	44392590	44397590
NM_001137605	chr22	+	44568835	44604349	PARVG	35514	44566335	44571335
NM_173493	chrX	+	150732006	150845211	PASD1	113205	150729506	150734506
NM_001252120	chr2	-	242045513	242089394	PASK	43881	242086894	242091894
NM_138294	chr11	+	125616187	125619743	PATE1	3556	125613687	125618687
NM_212555	chr11	-	125646027	125648714	PATE2	2687	125646214	125651214
NM_001129883	chr11	+	125658005	125661495	PATE3	3490	125655505	125660505
NM_001144874	chr11	+	125703210	125709967	PATE4	6757	125700710	125705710
NM_176877	chr1	+	62208137	62629591	PATJ	421454	62205637	62210637
NM_152716	chr11	-	59404191	59436511	PATL1	32320	59434011	59439011
NM_001330283	chr15	-	44957929	44969086	PATL2	11157	44966586	44971586
NM_032052	chr22	-	31721789	31742249	PATZ1	20460	31739749	31744749
NR_117094	chr11	+	31848113	31850850	PAUPAR	2737	31845613	31850613
NM_002583	chr12	-	79985744	80084790	PAWR	99046	80082290	80087290
NM_001257096	chr20	+	21686296	21699124	PAX1	12828	21683796	21688796
NM_001304569	chr10	+	102495465	102589698	PAX2	94233	102492965	102497965
NM_181461	chr2	-	223064605	223163715	PAX3	99110	223161215	223166215
NM_006193	chr7	-	127250345	127255780	PAX4	5435	127253280	127258280
NM_001280555	chr9	-	36833271	37034476	PAX5	201205	37031976	37036976
NM_001258462	chr11	-	31806339	31839509	PAX6	33170	31837009	31842009
NR_033971	chr11	+	31838113	31908587	PAX6-AS1	70474	31835613	31840613
NM_001135254	chr1	+	18957499	19075360	PAX7	117861	18954999	18959999
NM_013992	chr2	-	113973573	114036498	PAX8	62925	114033998	114038998
NR_015377	chr2	+	113993845	114024600	PAX8-AS1	30755	113991345	113996345
NM_006194	chr14	+	37126772	37147011	PAX9	20239	37124272	37129272
NM_016631	chr21	-	34106209	34144169	PAXBP1	37960	34141669	34146669
NR_038879	chr21	+	34100424	34115433	PAXBP1-AS1	15009	34097924	34102924
NM_007349	chr7	-	154735399	154794682	PAXIP1	59283	154792182	154797182
NR_024476	chr7	+	154720226	154741196	PAXIP1-AS2	20970	154717726	154722726
NM_001300888	chrX	+	75392763	75398145	PBDC1	5382	75390263	75395263
NM_001278945	chr8	-	27667137	27695612	PBK	28475	27693112	27698112
NM_022129	chr10	-	70042416	70092684	PBLD	50268	70090184	70095184
NM_021635	chr6	-	138537126	138539627	PBOV1	2501	138537127	138542127
NM_018313	chr3	-	52579367	52719866	PBRM1	140499	52717366	52722366
NM_001353131	chr1	+	164528596	164855284	PBX1	326688	164526096	164531096
NM_002586	chr6	-	32152509	32157963	PBX2	5454	32155463	32160463
NM_006195	chr9	+	128509616	128729655	PBX3	220039	128507116	128512116
NM_025245	chr19	-	19672515	19729725	PBX4	57210	19727225	19732225
NM_001317735	chr1	-	154916558	154928639	PBXIP1	12081	154926139	154931139
NM_001040716	chr11	-	66615996	66725847	PC	109851	66723347	66728347
NR_015342	chr9	+	79379351	79402485	PCA3	23134	79376851	79381851
NR_045262	chr8	+	128025398	128033259	PCAT1	7861	128022898	128027898
NR_024259	chr18	-	24267584	24283602	PCAT18	16018	24281102	24286102
NR_040109	chr19	-	41960074	42006559	PCAT19	46485	42004059	42009059
NR_119373	chr8	-	128084938	128094466	PCAT2	9528	128091966	128096966
NR_126438	chr15	+	69884538	69988091	PCAT29	103553	69882038	69887038
NR_026555	chr4	+	80748624	80784401	PCAT4	35777	80746124	80751124
NR_110138	chr10	+	36067229	36089848	PCAT5	22619	36064729	36069729
NR_121569	chr9	+	97317326	97331038	PCAT7	13712	97314826	97319826
NM_001323004	chr10	-	72642037	72648543	PCBD1	6506	72646043	72651043
NM_032151	chr5	+	134240809	134298336	PCBD2	57527	134238309	134243309
NR_033872	chr2	-	70189394	70314147	PCBP1-AS1	124753	70311647	70316647
NM_001128914	chr12	+	53845885	53874946	PCBP2	29061	53843385	53848385
NM_001348238	chr21	+	47063638	47362368	PCBP3	298730	47061138	47066138
NM_001174100	chr3	-	51991469	52001482	PCBP4	10013	51998982	52003982
NM_000282	chr13	+	100741268	101182691	PCCA	441423	100738768	100743768
NR_047686	chr13	-	101116690	101133269	PCCA-AS1	16579	101130769	101135769
NM_000532	chr3	+	135969166	136049013	PCCB	79847	135966666	135971666
NM_032420	chr5	-	141232675	141257975	PCDH1	25300	141255475	141260475
NM_032961	chr4	+	134070444	134115765	PCDH10	45321	134067944	134072944
NM_001168360	chrX	+	91090459	91878228	PCDH11X	787769	91087959	91092959
NM_032973	chrY	+	4924130	5610269	PCDH11Y	686139	4921630	4926630
NM_016580	chr5	-	141323149	141338627	PCDH12	15478	141336127	141341127
NM_001142772	chr10	-	55562532	56561051	PCDH15	998519	56558551	56563551
NM_001040429	chr13	+	58205788	58303065	PCDH17	97277	58203288	58208288
NM_001300828	chr4	-	138440072	138453652	PCDH18	13580	138451152	138456152
NM_001184880	chrX	-	99546641	99665271	PCDH19	118630	99662771	99667771
NM_022843	chr13	-	61983818	61989655	PCDH20	5837	61987155	61992155
NM_001173523	chr4	+	30722036	31148423	PCDH7	426387	30719536	30724536
NM_002590	chr13	-	53418108	53422775	PCDH8	4667	53420275	53425275
NM_001318373	chr13	-	66876965	67804468	PCDH9	927503	67801968	67806968
NR_046527	chr13	+	67399300	67489163	PCDH9-AS2	89863	67396800	67401800
NR_046636	chr13	+	67551520	67559908	PCDH9-AS3	8388	67549020	67554020
NR_046637	chr13	+	67565017	67576132	PCDH9-AS4	11115	67562517	67567517
NM_018900	chr5	+	140165720	140391929	PCDHA1	226209	140163220	140168220
NM_031860	chr5	+	140235467	140391929	PCDHA10	156462	140232967	140237967
NM_018902	chr5	+	140247097	140391929	PCDHA11	144832	140244597	140249597
NM_018903	chr5	+	140254886	140391929	PCDHA12	137043	140252386	140257386
NM_018904	chr5	+	140261853	140391929	PCDHA13	130076	140259353	140264353
NM_018905	chr5	+	140174443	140391929	PCDHA2	217486	140171943	140176943
NM_018906	chr5	+	140180782	140391929	PCDHA3	211147	140178282	140183282
NM_018907	chr5	+	140186658	140391929	PCDHA4	205271	140184158	140189158
NM_018908	chr5	+	140201360	140391929	PCDHA5	190569	140198860	140203860
NM_031849	chr5	+	140207506	140391929	PCDHA6	184423	140205006	140210006
NM_018910	chr5	+	140213968	140391929	PCDHA7	177961	140211468	140216468
NM_018911	chr5	+	140220906	140391929	PCDHA8	171023	140218406	140223406
NM_031857	chr5	+	140227356	140391929	PCDHA9	164573	140224856	140229856
NM_018898	chr5	+	140306301	140391929	PCDHAC1	85628	140303801	140308801
NM_018899	chr5	+	140345746	140391929	PCDHAC2	46183	140343246	140348246
NM_013340	chr5	+	140430960	140433547	PCDHB1	2587	140428460	140433460
NM_018930	chr5	+	140571951	140575213	PCDHB10	3262	140569451	140574451
NM_018931	chr5	+	140579347	140582618	PCDHB11	3271	140576847	140581847
NM_018932	chr5	+	140588290	140591698	PCDHB12	3408	140585790	140590790
NM_018933	chr5	+	140593490	140596993	PCDHB13	3503	140590990	140595990
NM_018934	chr5	+	140601897	140605860	PCDHB14	3963	140599397	140604397
NM_018935	chr5	+	140624916	140627801	PCDHB15	2885	140622416	140627416
NM_020957	chr5	+	140561264	140565796	PCDHB16	4532	140558764	140563764
NR_001281	chr5	+	140613904	140617101	PCDHB18P	3197	140611404	140616404
NR_001282	chr5	+	140619688	140624312	PCDHB19P	4624	140617188	140622188
NM_018936	chr5	+	140474190	140476964	PCDHB2	2774	140471690	140476690
NM_018937	chr5	+	140479825	140483407	PCDHB3	3582	140477325	140482325
NM_018938	chr5	+	140501331	140505203	PCDHB4	3872	140498831	140503831
NM_015669	chr5	+	140514787	140517709	PCDHB5	2922	140512287	140517287
NM_001303145	chr5	+	140529602	140532868	PCDHB6	3266	140527102	140532102
NM_018940	chr5	+	140552201	140555957	PCDHB7	3756	140549701	140554701
NM_019120	chr5	+	140557370	140560081	PCDHB8	2711	140554870	140559870
NM_019119	chr5	+	140566700	140571111	PCDHB9	4411	140564200	140569200
NM_018912	chr5	+	140710251	140892546	PCDHGA1	182295	140707751	140712751
NM_018913	chr5	+	140792742	140892546	PCDHGA10	99804	140790242	140795242
NM_018914	chr5	+	140800536	140892546	PCDHGA11	92010	140798036	140803036
NM_003735	chr5	+	140810157	140892546	PCDHGA12	82389	140807657	140812657
NM_018915	chr5	+	140718326	140892546	PCDHGA2	174220	140715826	140720826
NM_018916	chr5	+	140723600	140892546	PCDHGA3	168946	140721100	140726100
NM_018917	chr5	+	140734591	140892546	PCDHGA4	157955	140732091	140737091
NM_018918	chr5	+	140743897	140892546	PCDHGA5	148649	140741397	140746397
NM_018919	chr5	+	140753650	140892546	PCDHGA6	138896	140751150	140756150
NM_018920	chr5	+	140762305	140892546	PCDHGA7	130241	140759805	140764805
NM_032088	chr5	+	140771482	140892546	PCDHGA8	121064	140768982	140773982
NM_018921	chr5	+	140782519	140892546	PCDHGA9	110027	140780019	140785019
NM_018922	chr5	+	140729827	140892546	PCDHGB1	162719	140727327	140732327
NM_018923	chr5	+	140739702	140892546	PCDHGB2	152844	140737202	140742202
NM_018924	chr5	+	140749830	140892546	PCDHGB3	142716	140747330	140752330
NM_003736	chr5	+	140767451	140892546	PCDHGB4	125095	140764951	140769951
NM_018925	chr5	+	140777694	140892546	PCDHGB5	114852	140775194	140780194
NM_018926	chr5	+	140787769	140892546	PCDHGB6	104777	140785269	140790269
NM_018927	chr5	+	140797259	140892548	PCDHGB7	95289	140794759	140799759
NM_002588	chr5	+	140855568	140892544	PCDHGC3	36976	140853068	140858068
NM_018928	chr5	+	140864740	140892546	PCDHGC4	27806	140862240	140867240
NM_018929	chr5	+	140868807	140892546	PCDHGC5	23739	140866307	140871307
NM_001271168	chr20	-	2815960	2821889	PCED1A	5929	2819389	2824389
NM_001281429	chr12	+	47473385	47630446	PCED1B	157061	47470885	47475885
NR_026544	chr12	-	47602202	47610226	PCED1B-AS1	8024	47607726	47612726
NM_015885	chr11	+	82868136	82896835	PCF11	28699	82865636	82870636
NR_002769	chr2	+	193614570	193641625	PCGEM1	27055	193612070	193617070
NM_032673	chr2	-	74732169	74734821	PCGF1	2652	74732321	74737321
NM_007144	chr17	-	36890149	36904558	PCGF2	14409	36902058	36907058
NM_001317836	chr4	+	699529	764768	PCGF3	65239	697029	702029
NM_001257101	chr10	+	92922768	93044088	PCGF5	121320	92920268	92925268
NM_032154	chr10	-	105062552	105110891	PCGF6	48339	105108391	105113391
NM_001127202	chr13	-	113831852	113863234	PCID2	31382	113860734	113865734
NM_022104	chr20	+	44563316	44576662	PCIF1	13346	44560816	44565816
NM_002591	chr20	+	56136136	56141513	PCK1	5377	56133636	56138636
NM_001291556	chr14	+	24563339	24573341	PCK2	10002	24560839	24565839
NR_109934	chr15	-	64657210	64679886	PCLAF	22676	64677386	64682386
NM_033026	chr7	-	82383320	82792197	PCLO	408877	82789697	82794697
NM_001315507	chr8	+	17780365	17887457	PCM1	107092	17777865	17782865
NM_001252049	chr6	+	150070830	150132557	PCMT1	61727	150068330	150073330
NM_052937	chr8	-	52730134	52811746	PCMTD1	81612	52809246	52814246
NM_018257	chr20	+	62887047	62907579	PCMTD2	20532	62884547	62889547
NM_002592	chr20	-	5095598	5107268	PCNA	11670	5104768	5109768
NM_001320401	chr3	+	101292937	101313310	PCNP	20373	101290437	101295437
NM_006031	chr21	+	47744035	47865682	PCNT	121647	47741535	47746535
NM_001308160	chr14	+	71374121	71582099	PCNX1	207978	71371621	71376621
NM_014801	chr1	-	233119881	233431459	PCNX2	311578	233428959	233433959
NM_032223	chr11	+	65383782	65404910	PCNX3	21128	65381282	65386282
NM_022495	chr14	+	60558628	60601532	PCNX4	42904	60556128	60561128
NM_002593	chr7	+	100199881	100205798	PCOLCE	5917	100197381	100202381
NR_038910	chr7	-	100187023	100201661	PCOLCE-AS1	14638	100199161	100204161
NM_013363	chr3	-	142536701	142608045	PCOLCE2	71344	142605545	142610545
NM_001014442	chr13	+	24463025	24466243	PCOTH	3218	24460525	24465525
NM_006198	chr21	+	41239346	41301322	PCP4	61976	41236846	41241846
NM_001102566	chr1	+	161228516	161255240	PCP4L1	26724	161226016	161231016
NM_000439	chr5	-	95726039	95768985	PCSK1	42946	95766485	95771485
NM_013271	chrX	-	48689501	48694040	PCSK1N	4539	48691540	48696540
NM_001201528	chr20	+	17206751	17465222	PCSK2	258471	17204251	17209251
NM_017573	chr19	-	1481426	1490449	PCSK4	9023	1487949	1492949
NM_001190482	chr9	+	78505559	78977255	PCSK5	471696	78503059	78508059
NM_138319	chr15	-	101844132	102030187	PCSK6	186055	102027687	102032687
NR_132373	chr15	+	101874641	101877636	PCSK6-AS1	2995	101872141	101877141
NM_004716	chr11	-	117075786	117103241	PCSK7	27455	117100741	117105741
NM_174936	chr1	+	55505148	55530526	PCSK9	25378	55502648	55507648
NM_001330378	chr17	+	53828339	53900451	PCTP	72112	53825839	53830839
NM_016297	chr2	+	70485230	70508317	PCYOX1	23087	70482730	70487730
NM_001301054	chr5	+	148737569	148749221	PCYOX1L	11652	148735069	148740069
NM_001312673	chr3	-	195964615	196014623	PCYT1A	50008	196012123	196017123
NM_001163264	chrX	-	24576203	24690979	PCYT1B	114776	24688479	24693479
NR_046638	chrX	+	24668189	24676354	PCYT1B-AS1	8165	24665689	24670689
NM_001330518	chr17	-	79858840	79869353	PCYT2	10513	79866853	79871853
NM_014891	chr7	-	98992297	99006305	PDAP1	14008	99003805	99008805
NM_002597	chr1	-	186412697	186430240	PDC	17543	186427740	186432740
NM_005018	chr2	-	242792032	242801058	PDCD1	9026	242798558	242803558
NM_145859	chr3	-	167401694	167452651	PDCD10	50957	167450151	167455151
NM_014976	chr10	+	105156411	105206019	PDCD11	49608	105153911	105158911
NM_025239	chr9	+	5510544	5571282	PDCD1LG2	60738	5508044	5513044
NM_002598	chr6	-	170884659	170893780	PDCD2	9121	170891280	170896280
NM_032346	chr19	+	34895302	34917072	PDCD2L	21770	34892802	34897802
NM_014456	chr10	+	112631552	112659764	PDCD4	28212	112629052	112634052
NM_004708	chr19	+	33072093	33078358	PDCD5	6265	33069593	33074593
NM_001267559	chr5	+	271735	315089	PDCD6	43354	269235	274235
NM_013374	chr3	+	33840062	33911199	PDCD6IP	71137	33837562	33842562
NR_037599	chr15	+	29034979	29101720	PDCD6IPP2	66741	29032479	29037479
NM_005707	chr15	-	65409716	65426174	PDCD7	16458	65423674	65428674
NM_005388	chr9	-	125580375	125590935	PDCL	10560	125588435	125593435
NM_152401	chr4	-	56422691	56458379	PDCL2	35688	56455879	56460879
NM_024065	chr2	+	101179417	101193201	PDCL3	13784	101176917	101181917
NM_006661	chr6	-	165740775	166075588	PDE10A	334813	166073088	166078088
NM_001077197	chr2	-	178487976	178973066	PDE11A	485090	178970566	178975566
NM_001322176	chr3	+	57541973	57642207	PDE12	100234	57539473	57544473
NM_001258312	chr2	-	183004761	183387572	PDE1A	382811	183385072	183390072
NM_000924	chr12	+	54943176	54973023	PDE1B	29847	54940676	54945676
NM_001322059	chr7	-	31823125	32467836	PDE1C	644711	32465336	32470336
NM_002599	chr11	-	72287183	72385497	PDE2A	98314	72382997	72387997
NM_000921	chr12	+	20522178	20837041	PDE3A	314863	20519678	20524678
NM_000922	chr11	+	14665268	14893604	PDE3B	228336	14662768	14667768
NM_001243121	chr19	+	10527448	10580307	PDE4A	52859	10524948	10529948
NM_001297440	chr1	+	66258192	66840262	PDE4B	582070	66255692	66260692
NM_000923	chr19	-	18318770	18359010	PDE4C	40240	18356510	18361510
NM_001165899	chr5	-	58264865	59783925	PDE4D	1519060	59781425	59786425
NM_001350521	chr1	-	144851423	145076186	PDE4DIP	224763	145073686	145078686
NR_146087	chr1	+	147521552	147567054	PDE4DIPP1	45502	147519052	147524052
NM_001083	chr4	-	120415549	120549981	PDE5A	134432	120547481	120552481
NM_000440	chr5	-	149237518	149324356	PDE6A	86838	149321856	149326856
NM_000283	chr4	+	619362	664681	PDE6B	45319	616862	621862
NM_006204	chr10	+	95372344	95425429	PDE6C	53085	95369844	95374844
NM_001291018	chr2	-	232597134	232646037	PDE6D	48903	232643537	232648537
NM_002602	chr17	-	79617488	79623607	PDE6G	6119	79621107	79626107
NM_006205	chr12	+	15125955	15134799	PDE6H	8844	15123455	15128455
NM_001242318	chr8	-	66626568	66753969	PDE7A	127401	66751469	66756469
NM_018945	chr6	+	136172833	136516709	PDE7B	343876	136170333	136175333
NM_001243137	chr15	+	85523743	85682376	PDE8A	158633	85521243	85526243
NM_001349752	chr5	+	76476081	76724080	PDE8B	247999	76473581	76478581
NM_001315533	chr21	+	44073861	44195618	PDE9A	121757	44071361	44076361
NM_033023	chr7	-	536896	559481	PDGFA	22585	556981	561981
NM_002608	chr22	-	39619363	39641060	PDGFB	21697	39638560	39643560
NM_016205	chr4	-	157682762	157892546	PDGFC	209784	157890046	157895046
NM_033135	chr11	-	103777913	104035027	PDGFD	257114	104032527	104037527
NM_006206	chr4	+	55095255	55164414	PDGFRA	69159	55092755	55097755
NM_002609	chr5	-	149493401	149535422	PDGFRB	42021	149532922	149537922
NM_006207	chr8	+	17433941	17500642	PDGFRL	66701	17431441	17436441
NM_000284	chrX	+	19362010	19379826	PDHA1	17816	19359510	19364510
NM_001173468	chr3	-	58413356	58419579	PDHB	6223	58417079	58422079
NM_001135024	chr11	+	34937676	35017675	PDHX	79999	34935176	34940176
NM_006849	chr16	+	333117	337209	PDIA2	4092	330617	335617
NM_005313	chr15	+	44038589	44064804	PDIA3	26215	44036089	44041089
NM_004911	chr7	-	148700153	148725782	PDIA4	25629	148723282	148728282
NM_006810	chr3	+	122785855	122880953	PDIA5	95098	122783355	122788355
NM_001282705	chr2	-	10923516	10978103	PDIA6	54587	10975603	10980603
NM_001243532	chr1	+	26437655	26452039	PDIK1L	14384	26435155	26440155
NM_174924	chr16	-	20370491	20416033	PDILT	45542	20413533	20418533
NR_103731	chr2	+	173420100	173490351	PDK1	70251	173417600	173422600
NM_001199898	chr17	+	48172100	48188733	PDK2	16633	48169600	48174600
NM_001142386	chrX	+	24483343	24568583	PDK3	85240	24480843	24485843
NM_002612	chr7	-	95212808	95225925	PDK4	13117	95223425	95228425
NM_020992	chr10	-	96997324	97050905	PDLIM1	53581	97048405	97053405
NM_176871	chr8	+	22437986	22455538	PDLIM2	17552	22435486	22440486
NM_014476	chr4	-	186421814	186456712	PDLIM3	34898	186454212	186459212
NM_003687	chr5	+	131593350	131609147	PDLIM4	15797	131590850	131595850
NM_001256427	chr4	+	95373007	95589378	PDLIM5	216371	95370507	95375507
NM_005451	chr5	-	176910394	176924606	PDLIM7	14212	176922106	176927106
NM_018444	chr8	+	94929082	94938296	PDP1	9214	94926582	94931582
NM_020786	chr16	+	66914263	66925002	PDP2	10739	66911763	66916763
NM_002613	chr16	+	2587964	2653191	PDPK1	65227	2585464	2590464
NM_198389	chr1	+	13910251	13944452	PDPN	34201	13907751	13912751
NM_001322119	chr16	+	70147528	70196440	PDPR	48912	70145028	70150028
NM_030815	chr20	-	30532757	30539883	PDRG1	7126	30537383	30542383
NM_001100399	chr4	-	39824482	39979576	PDS5A	155094	39977076	39982076
NM_015032	chr13	+	33160563	33352158	PDS5B	191595	33158063	33163063
NM_014317	chr10	+	26986352	27035726	PDSS1	49374	26983852	26988852
NM_020381	chr6	-	107473760	107780779	PDSS2	307019	107778279	107783279
NM_000209	chr13	+	28494167	28500451	PDX1	6284	28491667	28496667
NM_001324021	chr16	+	15068819	15233267	PDXDC1	164448	15066319	15071319
NR_003610	chr16	-	70010201	70099851	PDXDC2P-NPIPB14P	89650	70097351	70102351
NM_003681	chr21	+	45138977	45182188	PDXK	43211	45136477	45141477
NM_020315	chr22	+	38054736	38062939	PDXP	8203	38052236	38057236
NM_001190898	chr20	-	1959401	1974931	PDYN	15530	1972431	1977431
NR_134520	chr20	+	1927855	1988163	PDYN-AS1	60308	1925355	1930355
NM_016484	chrX	-	69506210	69509798	PDZD11	3588	69507298	69512298
NM_178140	chr5	+	31639516	32111038	PDZD2	471522	31637016	31642016
NM_001168468	chr11	+	119056165	119060932	PDZD3	4767	119053665	119058665
NM_001303512	chrX	-	153067620	153096022	PDZD4	28402	153093522	153098522
NM_001195263	chr10	-	102767439	102790914	PDZD7	23475	102788414	102793414
NM_173791	chr10	-	119039999	119134978	PDZD8	94979	119132478	119137478
NM_173806	chr16	-	21995185	22012431	PDZD9	17246	22009931	22014931
NM_001201325	chr1	+	145727665	145764206	PDZK1	36541	145725165	145730165
NM_005764	chr1	-	47649260	47655771	PDZK1IP1	6511	47653271	47658271
NR_111936	chr1	-	147466093	147487188	PDZK1P1	21095	147484688	147489688
NM_015009	chr3	-	73431580	73674072	PDZRN3	242492	73671572	73676572
NR_046681	chr3	+	73672718	73677050	PDZRN3-AS1	4332	73670218	73675218
NM_001164595	chr12	+	41582249	41968392	PDZRN4	386143	41579749	41584749
NM_001297576	chr1	+	160175108	160185166	PEA15	10058	160172608	160177608
NM_024776	chr15	-	77400497	77712446	PEAK1	311949	77709946	77714946
NM_001080471	chr1	+	156863522	156886226	PEAR1	22704	156861022	156866022
NM_002567	chr12	+	118573688	118583393	PEBP1	9705	118571188	118576188
NM_144962	chr8	-	22570764	22785421	PEBP4	214657	22782921	22787921
NM_000442	chr17	-	62396776	62407083	PECAM1	10307	62404583	62409583
NM_018441	chr2	-	216903110	216946539	PECR	43429	216944039	216949039
NR_033686	chr1	-	32095462	32110838	PEF1	15376	32108338	32113338
NM_015068	chr7	+	94285636	94299006	PEG10	13370	94283136	94288136
NR_144431	chr8	-	141104992	141110634	PEG13	5642	141108134	141113134
NM_001146187	chr19	-	57321444	57352094	PEG3	30650	57349594	57354594
NM_020651	chr2	-	64319785	64371605	PELI1	51820	64369105	64374105
NM_021255	chr14	+	56585092	56768031	PELI2	182939	56582592	56587592
NM_001243135	chr11	+	66233797	66244808	PELI3	11011	66231297	66236297
NM_015946	chr5	+	52083773	52098452	PELO	14679	52081273	52086273
NM_001278241	chr17	-	4574678	4607632	PELP1	32954	4605132	4610132
NM_148172	chr17	-	17408876	17495017	PEMT	86141	17492517	17497517
NM_001135690	chr8	-	57353512	57359293	PENK	5781	57356793	57361793
NM_000285	chr19	-	33877854	34012799	PEPD	134945	34010299	34015299
NM_002616	chr17	-	8043787	8055753	PER1	11966	8053253	8058253
NM_022817	chr2	-	239152678	239197207	PER2	44529	239194707	239199707
NM_001289861	chr1	+	7844488	7905240	PER3	60752	7841988	7846988
NM_001291366	chr1	-	910578	917497	PERM1	6919	914997	919997
NM_022121	chr6	-	138409641	138428660	PERP	19019	138426160	138431160
NM_001282327	chr22	-	30972611	31003000	PES1	30389	31000500	31005500
NM_001164811	chr20	+	18118498	18123812	PET117	5314	18115998	18120998
NM_001282678	chr7	-	92116336	92157845	PEX1	41509	92155345	92160345
NM_002617	chr1	-	2336240	2344010	PEX10	7770	2341510	2346510
NM_001271573	chr15	-	90224761	90234015	PEX11A	9254	90231515	90236515
NR_073492	chr1	+	145516164	145523732	PEX11B	7568	145513664	145518664
NM_001300881	chr19	-	7541760	7554286	PEX11G	12526	7551786	7556786
NM_000286	chr17	-	33901813	33905656	PEX12	3843	33903156	33908156
NM_002618	chr2	+	61244811	61279125	PEX13	34314	61242311	61247311
NM_004565	chr1	+	10535002	10690815	PEX14	155813	10532502	10537502
NM_004813	chr11	-	45931219	45939674	PEX16	8455	45937174	45942174
NM_002857	chr1	-	160246598	160254941	PEX19	8343	160252441	160257441
NM_001172087	chr8	-	77892493	77913280	PEX2	20787	77910780	77915780
NM_017929	chr22	+	18560685	18573797	PEX26	13112	18558185	18563185
NM_003630	chr6	+	143771917	143811751	PEX3	39834	143769417	143774417
NM_001131026	chr12	+	7341758	7371169	PEX5	29411	7339258	7344258
NM_016559	chr3	-	179512746	179754841	PEX5L	242095	179752341	179757341
NR_110059	chr3	+	179615981	179639687	PEX5L-AS2	23706	179613481	179618481
NR_133009	chr6	-	42931610	42946981	PEX6	15371	42944481	42949481
NM_000288	chr6	+	137143701	137235072	PEX7	91371	137141201	137146201
NM_012393	chr17	+	8152595	8173809	PFAS	21214	8150095	8155095
NM_002622	chr5	-	139624634	139682689	PFDN1	58055	139680189	139685189
NM_012394	chr1	-	161070345	161087866	PFDN2	17521	161085366	161090366
NM_002623	chr20	+	52824501	52836492	PFDN4	11991	52822001	52827001
NM_002624	chr12	+	53689234	53693234	PFDN5	4000	53686734	53691734
NM_001271805	chrX	-	54959566	55024967	PFKFB1	65401	55022467	55027467
NM_001018053	chr1	+	207226619	207254368	PFKFB2	27749	207224119	207229119
NR_136554	chr10	+	6186840	6277507	PFKFB3	90667	6184340	6189340
NM_001317136	chr3	-	48555116	48598613	PFKFB4	43497	48596113	48601113
NM_002626	chr21	+	45719916	45747264	PFKL	27348	45717416	45722416
NM_001166686	chr12	+	48499655	48540187	PFKM	40532	48497155	48502155
NM_001323069	chr10	+	3109711	3178997	PFKP	69286	3107211	3112211
NM_005022	chr17	-	4848944	4852381	PFN1	3437	4849881	4854881
NM_053024	chr3	-	149682690	149688741	PFN2	6051	149686241	149691241
NM_199346	chr2	-	24337678	24346347	PFN4	8669	24343847	24348847
NM_001079807	chr11	+	60970984	60980341	PGA3	9357	60968484	60973484
NM_001079808	chr11	+	60989820	60999167	PGA4	9347	60987320	60992320
NM_014224	chr11	+	61008647	61018915	PGA5	10268	61006147	61011147
NM_002629	chr10	+	99185881	99193201	PGAM1	7320	99183381	99188381
NR_077225	chr12	+	96043030	96067770	PGAM1P5	24740	96040530	96045530
NM_000290	chr7	-	44102325	44105186	PGAM2	2861	44102686	44107686
NM_001170544	chr12	+	133287392	133299323	PGAM5	11931	133284892	133289892
NM_001321099	chr2	-	197697727	197791455	PGAP1	93728	197788955	197793955
NM_001256235	chr11	+	3818953	3847601	PGAP2	28648	3816453	3821453
NM_033419	chr17	-	37827374	37844323	PGAP3	16949	37841823	37846823
NM_001184743	chr6	+	28249313	28270326	PGBD1	21013	28246813	28251813
NM_170725	chr1	+	249200441	249213345	PGBD2	12904	249197941	249202941
NM_170753	chr10	-	50723150	50732327	PGBD3	9177	50729827	50734827
NM_001258311	chr1	-	230457391	230561674	PGBD5	104283	230559174	230564174
NM_002630	chr6	-	41704448	41715139	PGC	10691	41712639	41717639
NR_029429	chr1	-	111927140	111932473	PGCP1	5333	111929973	111934973
NM_001304451	chr1	+	10459048	10480568	PGD	21520	10456548	10461548
NM_001293643	chr14	-	75408532	75422467	PGF	13935	75419967	75424967
NM_025092	chr11	+	289137	295688	PGGHG	6551	286637	291637
NM_005023	chr5	-	114546526	114598569	PGGT1B	52043	114596069	114601069
NM_000291	chrX	+	77359665	77382324	PGK1	22659	77357165	77362165
NM_012088	chr19	+	17622431	17632097	PGLS	9666	17619931	17624931
NM_005091	chr19	-	46522411	46526556	PGLYRP1	4145	46524056	46529056
NM_052890	chr19	-	15579456	15590315	PGLYRP2	10859	15587815	15592815
NM_052891	chr1	-	153270337	153283194	PGLYRP3	12857	153280694	153285694
NM_020393	chr1	-	153302596	153321317	PGLYRP4	18721	153318817	153323817
NM_002633	chr1	+	64058946	64125916	PGM1	66970	64056446	64061446
NM_018290	chr4	+	37828281	37864559	PGM2	36278	37825781	37830781
NM_173582	chr11	-	74041356	74109510	PGM2L1	68154	74107010	74112010
NM_001199917	chr6	-	83874592	83903655	PGM3	29063	83901155	83906155
NM_021965	chr9	+	70971814	71145977	PGM5	174163	70969314	70974314
NR_121192	chr9	-	70970079	70972782	PGM5-AS1	2703	70970282	70975282
NR_002836	chr9	-	69080243	69147854	PGM5P2	67611	69145354	69150354
NR_121190	chr9	+	72689	88826	PGM5P3-AS1	16137	70189	75189
NR_146438	chr2	+	114297090	114326515	PGM5P4	29425	114294590	114299590
NR_121185	chr2	-	114286223	114300267	PGM5P4-AS1	14044	114297767	114302767
NM_001042371	chr16	-	2261602	2264822	PGP	3220	2262322	2267322
NM_001300927	chr19	+	18451396	18480763	PGPEP1	29367	18448896	18453896
NM_001167902	chr15	-	99511458	99551024	PGPEP1L	39566	99548524	99553524
NM_000926	chr11	-	100900354	101000544	PGR	100190	100998044	101003044
NR_073144	chr11	+	100999807	101030001	PGR-AS1	30194	100997307	101002307
NM_006667	chrX	+	118370207	118378429	PGRMC1	8222	118367707	118372707
NM_006320	chr4	-	129190391	129209984	PGRMC2	19593	129207484	129212484
NM_024419	chr17	+	76374698	76420740	PGS1	46042	76372198	76377198
NM_001322308	chr6	+	12716887	13288075	PHACTR1	571188	12714387	12719387
NM_014721	chr6	+	143929316	144152322	PHACTR2	223006	143926816	143931816
NR_027113	chr6	-	143875251	143890476	PHACTR2-AS1	15225	143887976	143892976
NM_001199505	chr20	+	58152563	58422766	PHACTR3	270203	58150063	58155063
NM_001350159	chr1	+	28696064	28826881	PHACTR4	130817	28693564	28698564
NM_032177	chr5	+	125936606	125962944	PHAX	26338	125934106	125939106
NM_001281715	chr17	-	47481409	47492267	PHB	10858	47489767	47494767
NM_001267700	chr12	-	7074514	7079916	PHB2	5402	7077416	7082416
NM_004426	chr12	+	9067315	9094060	PHC1	26745	9064815	9069815
NM_198040	chr1	-	33789223	33841194	PHC2	51971	33838694	33843694
NM_001308116	chr3	-	169805367	169899537	PHC3	94170	169897037	169902037
NM_000444	chrX	+	22050561	22269427	PHEX	218866	22048061	22053061
NR_046639	chrX	-	22180848	22191100	PHEX-AS1	10252	22188600	22193600
NM_024165	chr6	+	33378772	33384230	PHF1	5458	33376272	33381272
NM_018288	chr6	-	170104001	170124106	PHF10	20105	170121606	170126606
NM_001040443	chr13	+	50069745	50103127	PHF11	33382	50067245	50072245
NM_001033561	chr17	-	27232270	27278508	PHF12	46238	27276008	27281008
NM_153812	chr1	+	6673755	6684093	PHF13	10338	6671255	6676255
NR_033436	chr7	+	11013498	11209250	PHF14	195752	11010998	11015998
NM_001286840	chr9	-	123617928	123657174	PHF19	39246	123654674	123659674
NM_005392	chr9	+	96338908	96441869	PHF2	102961	96336408	96341408
NM_016436	chr20	+	34359922	34538288	PHF20	178366	34357422	34362422
NM_001277196	chr8	+	133787603	133861052	PHF20L1	73449	133785103	133790103
NM_016621	chr11	-	45950869	46142985	PHF21A	192116	46140485	46145485
NM_001135862	chr22	-	45277042	45405809	PHF21B	128767	45403309	45408309
NM_001284517	chr17	-	7138346	7142825	PHF23	4479	7140325	7145325
NM_001304333	chr9	+	34957483	34982541	PHF24	25058	34954983	34959983
NM_001290259	chr6	+	64345706	64425418	PHF3	79712	64343206	64348206
NM_032758	chr22	-	41855720	41864708	PHF5A	8988	41862208	41867208
NM_032458	chrX	+	133507341	133562822	PHF6	55481	133504841	133509841
NM_016483	chr3	+	52444523	52457657	PHF7	13134	52442023	52447023
NM_001184896	chrX	-	53963112	54071569	PHF8	108457	54069069	54074069
NM_006623	chr1	+	120254418	120286849	PHGDH	32431	120251918	120256918
NM_001145643	chr15	+	40643233	40648634	PHGR1	5401	40640733	40645733
NM_017934	chr6	-	79644135	79788015	PHIP	143880	79785515	79790515
NM_001122670	chrX	-	71798663	71934029	PHKA1	135366	71931529	71936529
NR_110391	chrX	+	71908798	71932190	PHKA1-AS1	23392	71906298	71911298
NM_000292	chrX	-	18910415	19002480	PHKA2	92065	18999980	19004980
NR_029379	chrX	+	18908413	18913093	PHKA2-AS1	4680	18905913	18910913
NM_000293	chr16	+	47495209	47735434	PHKB	240225	47492709	47497709
NM_001258459	chr7	-	56147975	56160689	PHKG1	12714	56158189	56163189
NM_000294	chr16	+	30759619	30772497	PHKG2	12878	30757119	30762119
NM_007350	chr12	-	76419226	76425556	PHLDA1	6330	76423056	76428056
NM_012396	chr1	-	201433411	201438299	PHLDA3	4888	201435799	201440799
NM_015157	chr11	+	118477212	118528748	PHLDB1	51536	118474712	118479712
NM_001134437	chr3	+	111451326	111695364	PHLDB2	244038	111448826	111453826
NM_198850	chr19	-	43979254	44008985	PHLDB3	29731	44006485	44011485
NM_194449	chr18	+	60382671	60647676	PHLPP1	265005	60380171	60385171
NM_015020	chr16	-	71678828	71758604	PHLPP2	79776	71756104	71761104
NM_001143804	chr17	-	47300731	47308128	PHOSPHO1	7397	47305628	47310628
NM_001199288	chr2	+	170550963	170558218	PHOSPHO2	7255	170548463	170553463
NR_144936	chr2	+	170550940	170608396	PHOSPHO2-KLHL23	57456	170548440	170553440
NM_005169	chr11	-	71950120	71955220	PHOX2A	5100	71952720	71957720
NM_003924	chr4	-	41746098	41750987	PHOX2B	4889	41748487	41753487
NM_001286581	chr11	+	576445	612222	PHRF1	35777	573945	578945
NM_001323042	chr1	-	114239826	114302510	PHTF1	62684	114300010	114305010
NM_001127358	chr7	+	77428108	77586821	PHTF2	158713	77425608	77430608
NM_006214	chr10	-	13319795	13342130	PHYH	22335	13339630	13344630
NM_174933	chr9	+	131683173	131704320	PHYHD1	21147	131680673	131685673
NM_014759	chr8	-	22077215	22089851	PHYHIP	12636	22087351	22092351
NM_032439	chr10	+	60936347	61007534	PHYHIPL	71187	60933847	60938847
NM_153373	chr5	-	177635474	177659823	PHYKPL	24349	177657323	177662323
NM_001324403	chr8	+	75736771	75767279	PI15	30508	75734271	75739271
NM_001199159	chr6	+	36916038	36932613	PI16	16575	36913538	36918538
NM_018425	chr10	+	99400442	99436189	PI4K2A	35747	99397942	99402942
NM_018323	chr4	+	25235652	25280831	PI4K2B	45179	25233152	25238152
NM_058004	chr22	-	21061978	21213100	PI4KA	151122	21210600	21215600
NR_003563	chr22	-	20383730	20398695	PI4KAP1	14965	20396195	20401195
NR_003700	chr22	-	21827286	21871780	PI4KAP2	44494	21869280	21874280
NM_001198775	chr1	-	151264272	151300191	PI4KB	35919	151297691	151302691
NM_153685	chr12	-	6802956	6810009	PIANP	7053	6807509	6812509
NM_016166	chr15	+	68346516	68483802	PIAS1	137286	68344016	68349016
NM_001324048	chr18	-	44383187	44497495	PIAS2	114308	44494995	44499995
NM_006099	chr1	+	145575987	145586546	PIAS3	10559	145573487	145578487
NM_015897	chr19	+	4007595	4039384	PIAS4	31789	4005095	4010095
NM_006346	chr13	+	73356160	73590591	PIBF1	234431	73353660	73358660
NM_001206947	chr11	-	85668213	85780923	PICALM	112710	85778423	85783423
NR_038230	chr17	-	48127712	48133103	PICART1	5391	48130603	48135603
NM_001039584	chr22	+	38453261	38471708	PICK1	18447	38450761	38455761
NR_024089	chr21	-	46419121	46424642	PICSAR	5521	46422142	46427142
NM_001330158	chr2	-	229888688	230136057	PID1	247369	230133557	230138557
NM_145887	chr11	-	799178	805250	PIDD1	6072	802750	807750
NM_001142864	chr16	-	88781745	88851628	PIEZO1	69883	88849128	88854128
NM_022068	chr18	-	10670243	11148761	PIEZO2	478518	11146261	11151261
NM_001286496	chr15	-	65107828	65117867	PIF1	10039	65115367	65120367
NR_125338	chr1	+	111889181	111895639	PIFO	6458	111886681	111891681
NM_020473	chrX	-	15337572	15353676	PIGA	16104	15351176	15356176
NM_004855	chr15	+	55611132	55647846	PIGB	36714	55608632	55613632
NM_153747	chr1	-	172410596	172413230	PIGC	2634	172410730	172415730
NM_002643	chr2	-	46808412	46844251	PIGF	35839	46841751	46846751
NR_144334	chr4	+	492988	533983	PIGG	40995	490488	495488
NM_004569	chr14	-	68056022	68067017	PIGH	10995	68064517	68069517
NM_005482	chr1	-	77554666	77685132	PIGK	130466	77682632	77687632
NM_004278	chr17	+	16120508	16229573	PIGL	109065	16118008	16123008
NM_145167	chr1	-	159997461	160001783	PIGM	4322	159999283	160004283
NM_176787	chr18	-	59711457	59854289	PIGN	142832	59851789	59856789
NM_152850	chr9	-	35088684	35096598	PIGO	7914	35094098	35099098
NM_016430	chr21	-	38437663	38445458	PIGP	7795	38442958	38447958
NM_004204	chr16	+	619967	634136	PIGQ	14169	617467	622467
NM_002644	chr1	-	207101866	207119811	PIGR	17945	207117311	207122311
NM_033198	chr17	-	26880405	26898887	PIGS	18482	26896387	26901387
NM_015937	chr20	+	44044706	44054885	PIGT	10179	44042206	44047206
NM_080476	chr20	-	33148345	33265089	PIGU	116744	33262589	33267589
NM_017837	chr1	+	27114453	27124894	PIGV	10441	27111953	27116953
NM_178517	chr17	+	34890588	34895152	PIGW	4564	34888088	34893088
NM_001166304	chr3	+	196439244	196462876	PIGX	23632	196436744	196441744
NM_001042616	chr4	-	89442128	89444952	PIGY	2824	89442452	89447452
NM_025163	chr3	-	196673213	196695742	PIGZ	22529	196693242	196698242
NM_017916	chr19	-	49949549	49955115	PIH1D1	5566	49952615	49957615
NM_001082619	chr11	-	111934733	111944895	PIH1D2	10162	111942395	111947395
NM_173494	chrX	+	106449861	106487473	PIH1D3	37612	106447361	106452361
NM_152309	chr10	-	98353068	98480279	PIK3AP1	127211	98477779	98482779
NM_002645	chr11	-	17108123	17229543	PIK3C2A	121420	17227043	17232043
NM_002646	chr1	-	204391757	204459474	PIK3C2B	67717	204456974	204461974
NM_001288772	chr12	+	18414473	18801352	PIK3C2G	386879	18411973	18416973
NM_001308020	chr18	+	39535162	39661446	PIK3C3	126284	39532662	39537662
NM_006218	chr3	+	178866310	178957881	PIK3CA	91571	178863810	178868810
NM_006219	chr3	-	138371539	138478201	PIK3CB	106662	138475701	138480701
NM_005026	chr1	+	9711788	9788980	PIK3CD	77192	9709288	9714288
NR_126367	chr1	-	9732483	9747632	PIK3CD-AS2	15149	9745132	9750132
NM_001282426	chr7	+	106505722	106549423	PIK3CG	43701	106503222	106508222
NM_052880	chr22	-	31677578	31688520	PIK3IP1	10942	31686020	31691020
NR_110542	chr22	+	31731334	31734007	PIK3IP1-AS1	2673	31728834	31733834
NM_181523	chr5	+	67511583	67597649	PIK3R1	86066	67509083	67514083
NM_005027	chr19	+	18263987	18281343	PIK3R2	17356	18261487	18266487
NM_001328648	chr1	-	46505811	46640573	PIK3R3	134762	46638073	46643073
NM_014602	chr3	-	130397777	130465696	PIK3R4	67919	130463196	130468196
NM_001251853	chr17	-	8782232	8869029	PIK3R5	86797	8866529	8871529
NR_110865	chr17	-	8706040	8770994	PIK3R6	64954	8768494	8773494
NM_015040	chr2	+	209130990	209223475	PIKFYVE	92485	209128490	209133490
NM_178272	chr7	+	99971067	99997722	PILRA	26655	99968567	99973567
NM_178238	chr7	+	99955625	99965454	PILRB	9829	99953125	99958125
NM_001243186	chr6	+	37137921	37143204	PIM1	5283	37135421	37140421
NM_006875	chrX	-	48770458	48776413	PIM2	5955	48773913	48778913
NM_001001852	chr22	+	50354142	50357720	PIM3	3578	50351642	50356642
NM_019013	chr17	+	6347734	6354385	PIMREG	6651	6345234	6350234
NR_038830	chr19	+	9945882	9960365	PIN1	14483	9943382	9948382
NM_001170747	chrX	+	71401525	71483814	PIN4	82289	71399025	71404025
NR_110387	chrX	+	43036242	43085847	PINCR	49605	43033742	43038742
NM_032409	chr1	+	20959947	20978004	PINK1	18057	20957447	20962447
NR_046507	chr1	-	20969149	20978686	PINK1-AS	9537	20976186	20981186
NM_001193621	chr19	+	44080951	44086256	PINLYP	5305	44078451	44083451
NM_017884	chr8	-	10622470	10697409	PINX1	74939	10694909	10699909
NM_002652	chr7	+	142829173	142836834	PIP	7661	142826673	142831673
NM_005028	chr10	-	22823765	23003503	PIP4K2A	179738	23001003	23006003
NM_003559	chr17	-	36921943	36956158	PIP4K2B	34215	36953658	36958658
NM_001146260	chr12	+	57984941	57997211	PIP4K2C	12270	57982441	57987441
NM_001330689	chr1	+	151171019	151222007	PIP5K1A	50988	151168519	151173519
NM_003558	chr9	+	71320329	71624092	PIP5K1B	303763	71317829	71322829
NM_012398	chr19	-	3630178	3700477	PIP5K1C	70299	3697977	3702977
NR_027712	chr6	+	7986334	7990577	PIP5K1P1	4243	7983834	7988834
NM_001135219	chr9	-	130683807	130693076	PIP5KL1	9269	130690576	130695576
NM_016518	chr17	+	27369917	27384236	PIPOX	14319	27367417	27372417
NR_002319	chr10	-	95717896	95721672	PIPSL	3776	95719172	95724172
NM_003662	chrX	-	15402923	15511711	PIR	108788	15509211	15514211
NR_037859	chrX	-	15363712	15509432	PIR-FIGF	145720	15506932	15511932
NM_001101387	chr17	-	10725791	10741418	PIRT	15627	10738918	10743918
NM_001326411	chr22	-	32014478	32058550	PISD	44072	32056050	32061050
NM_020362	chr1	+	24104875	24114722	PITHD1	9847	24102375	24107375
NM_006224	chr17	-	1421282	1466110	PITPNA	44828	1463610	1468610
NM_001284277	chr22	-	28247656	28315294	PITPNB	67638	28312794	28317794
NM_181671	chr17	+	65373396	65693379	PITPNC1	319983	65370896	65375896
NM_004910	chr11	-	67259238	67272843	PITPNM1	13605	67270343	67275343
NM_001300801	chr12	-	123468026	123595036	PITPNM2	127010	123592536	123597536
NR_038290	chr12	+	123565930	123569291	PITPNM2-AS1	3361	123563430	123568430
NM_031220	chr17	-	6354582	6459877	PITPNM3	105295	6457377	6462377
NR_144640	chr10	-	3179918	3215033	PITRM1	35115	3212533	3217533
NR_038284	chr10	+	3183792	3190821	PITRM1-AS1	7029	3181292	3186292
NM_002653	chr5	-	134363423	134369964	PITX1	6541	134367464	134372464
NM_001204397	chr4	-	111538579	111563279	PITX2	24700	111560779	111565779
NM_005029	chr10	-	103989945	104001231	PITX3	11286	103998731	104003731
NM_004764	chr12	+	130822432	130856877	PIWIL1	34445	130819932	130824932
NM_001330480	chr8	+	22132792	22214379	PIWIL2	81587	22130292	22135292
NM_001255975	chr22	-	25115000	25170687	PIWIL3	55687	25168187	25173187
NM_152431	chr11	+	94300473	94354587	PIWIL4	54114	94297973	94302973
NM_145119	chrX	-	68380580	68385365	PJA1	4785	68382865	68387865
NM_014819	chr5	-	108670409	108745675	PJA2	75266	108743175	108748175
NM_001042702	chr2	+	179316162	179326110	PJVK	9948	179313662	179318662
NM_000296	chr16	-	2138710	2185899	PKD1	47189	2183399	2188399
NM_138295	chr7	-	47814249	47988088	PKD1L1	173839	47985588	47990588
NM_052892	chr16	-	81134483	81253975	PKD1L2	119492	81251475	81256475
NM_181536	chr16	-	71963440	72033877	PKD1L3	70437	72031377	72036377
NR_036447	chr16	+	16411465	16444465	PKD1P1	33000	16408965	16413965
NR_146231	chr16	+	15005618	15045917	PKD1P3-NPIPA1	40299	15003118	15008118
NR_146336	chr16	+	16410078	16487829	PKD1P4-NPIPA8	77751	16407578	16412578
NR_146331	chr16	-	18451961	18495782	PKD1P5-LOC105376752	43821	18493282	18498282
NR_123721	chr16	-	15198158	15230816	PKD1P6-NPIPP1	32658	15228316	15233316
NM_000297	chr4	+	88928798	88998931	PKD2	70133	88926298	88931298
NM_001253837	chr10	-	102047902	102090243	PKD2L1	42341	102087743	102092743
NM_001300921	chr5	+	137225124	137278434	PKD2L2	53310	137222624	137227624
NM_138370	chr2	+	42275160	42285668	PKDCC	10508	42272660	42277660
NM_006071	chr22	-	46651559	46659219	PKDREJ	7660	46656719	46661719
NM_138694	chr6	-	51480144	51952423	PKHD1	472279	51949923	51954923
NM_177531	chr8	+	110374705	110543500	PKHD1L1	168795	110372205	110377205
NM_006823	chr8	+	79428335	79517502	PKIA	89167	79425835	79430835
NR_125389	chr8	-	79446126	79470738	PKIA-AS1	24612	79468238	79473238
NM_001270394	chr6	+	122793061	123047518	PKIB	254457	122790561	122795561
NM_181804	chr20	+	43160421	43247678	PKIG	87257	43157921	43162921
NM_000298	chr1	-	155259083	155271225	PKLR	12142	155268725	155273725
NM_001206797	chr15	-	72491369	72523965	PKM	32596	72521465	72526465
NM_182687	chr16	-	3022791	3030540	PKMYT1	7749	3028040	3033040
NM_002741	chr19	+	14544165	14582679	PKN1	38514	14541665	14546665
NM_006256	chr1	+	89149826	89301938	PKN2	152112	89147326	89152326
NR_110682	chr1	-	89003195	89150887	PKN2-AS1	147692	89148387	89153387
NM_013355	chr9	+	131464782	131483199	PKN3	18417	131462282	131467282
NM_001286258	chr21	+	44394619	44454041	PKNOX1	59422	44392119	44397119
NM_022062	chr11	+	125034558	125303285	PKNOX2	268727	125032058	125037058
NR_125759	chr11	-	125028356	125034505	PKNOX2-AS1	6149	125032005	125037005
NM_000299	chr1	+	201252579	201302121	PKP1	49542	201250079	201255079
NM_004572	chr12	-	32943679	33049780	PKP2	106101	33047280	33052280
NM_001303029	chr11	+	392598	404908	PKP3	12310	390098	395098
NM_001304969	chr2	+	159313391	159537940	PKP4	224549	159310891	159315891
NR_135242	chr2	-	159514848	159591514	PKP4-AS1	76666	159589014	159594014
NM_015900	chr3	+	119316694	119348658	PLA1A	31964	119314194	119319194
NR_133651	chr16	-	14766404	14788430	PLA2G10	22026	14785930	14790930
NM_030821	chr4	-	110631144	110651242	PLA2G12A	20098	110648742	110653742
NM_001318124	chr10	-	74694519	74714577	PLA2G12B	20058	74712077	74717077
NM_012320	chr16	+	68279246	68294961	PLA2G15	15715	68276746	68281746
NM_001128203	chr11	-	63341943	63381941	PLA2G16	39998	63379441	63384441
NM_000928	chr12	-	120759913	120765592	PLA2G1B	5679	120763092	120768092
NM_001161728	chr1	-	20301923	20306932	PLA2G2A	5009	20304432	20309432
NM_001316722	chr1	-	20489584	20503857	PLA2G2C	14273	20501357	20506357
NM_001271814	chr1	-	20439142	20446059	PLA2G2D	6917	20443559	20448559
NM_014589	chr1	-	20246799	20250110	PLA2G2E	3311	20247610	20252610
NM_022819	chr1	+	20465822	20476879	PLA2G2F	11057	20463322	20468322
NM_015715	chr22	-	31530792	31536593	PLA2G3	5801	31534093	31539093
NM_001311193	chr1	+	186798031	186958113	PLA2G4A	160082	186795531	186800531
NM_001114633	chr15	+	42131010	42140346	PLA2G4B	9336	42128510	42133510
NM_003706	chr19	-	48551099	48614109	PLA2G4C	63010	48611609	48616609
NR_132363	chr19	+	48564627	48568202	PLA2G4C-AS1	3575	48562127	48567127
NM_178034	chr15	-	42359880	42386752	PLA2G4D	26872	42384252	42389252
NM_001206670	chr15	-	42273779	42342901	PLA2G4E	69122	42340401	42345401
NR_120334	chr15	+	42264960	42291292	PLA2G4E-AS1	26332	42262460	42267460
NM_213600	chr15	-	42433331	42448839	PLA2G4F	15508	42446339	42451339
NM_000929	chr1	+	20396700	20418394	PLA2G5	21694	20394200	20399200
NM_001349866	chr22	-	38507501	38577916	PLA2G6	70415	38575416	38580416
NM_001168357	chr6	-	46672052	46703430	PLA2G7	31378	46700930	46705930
NM_001195641	chr2	-	160797259	160919126	PLA2R1	121867	160916626	160921626
NM_001031689	chr9	-	26903367	26947468	PLAA	44101	26944968	26949968
NM_001316887	chrX	-	133699872	133898352	PLAC1	198480	133895852	133900852
NM_182832	chr21	-	42547157	42557166	PLAC4	10009	42554666	42559666
NM_016619	chr4	-	84011210	84035911	PLAC8	24701	84033411	84038411
NM_001029869	chr5	-	145463875	145485128	PLAC8L1	21253	145482628	145487628
NR_138551	chr10	+	81891438	81904820	PLAC9	13382	81888938	81893938
NR_026740	chr2	-	130680434	130691890	PLAC9P1	11456	130689390	130694390
NM_002655	chr8	-	57073467	57123859	PLAG1	50392	57121359	57126359
NM_001289038	chr6	-	144261436	144385736	PLAGL1	124300	144383236	144388236
NM_002657	chr20	-	30780306	30795546	PLAGL2	15240	30793046	30798046
NM_001319189	chr8	-	42032235	42065242	PLAT	33007	42062742	42067742
NM_001319191	chr10	+	75670858	75677258	PLAU	6400	75668358	75673358
NM_001005376	chr19	-	44150246	44174498	PLAUR	24252	44171998	44176998
NM_153021	chr2	+	28718937	28866653	PLB1	147716	28716437	28721437
NM_024829	chr12	-	14656596	14720791	PLBD1	64195	14718291	14723291
NR_120465	chr12	+	14720665	14772689	PLBD1-AS1	52024	14718165	14723165
NM_173542	chr12	+	113796370	113827458	PLBD2	31088	113793870	113798870
NM_015192	chr20	+	8112911	8865547	PLCB1	752636	8110411	8115411
NM_004573	chr15	-	40580097	40600174	PLCB2	20077	40597674	40602674
NM_001184883	chr11	+	64018994	64036924	PLCB3	17930	64016494	64021494
NM_001172646	chr20	+	9049700	9461462	PLCB4	411762	9047200	9052200
NM_006225	chr3	-	38048986	38071154	PLCD1	22168	38068654	38073654
NM_133373	chr17	-	43189007	43209900	PLCD3	20893	43207400	43212400
NM_032726	chr2	+	219472487	219501909	PLCD4	29422	219469987	219474987
NM_001288989	chr10	+	95753745	96088148	PLCE1	334403	95751245	95756245
NR_033969	chr10	-	96039046	96046827	PLCE1-AS1	7781	96044327	96049327
NR_120616	chr10	-	95841706	95868551	PLCE1-AS2	26845	95866051	95871051
NM_002660	chr20	+	39766160	39804357	PLCG1	38197	39763660	39768660
NR_109889	chr20	-	39726633	39766640	PLCG1-AS1	40007	39764140	39769140
NM_002661	chr16	+	81812862	81996298	PLCG2	183436	81810362	81815362
NM_001349251	chr3	-	155197670	155462878	PLCH1	265208	155460378	155465378
NM_001303012	chr1	+	2398897	2436969	PLCH2	38072	2396397	2401397
NM_006226	chr2	+	198669425	199014608	PLCL1	345183	198666925	198671925
NM_001144382	chr3	+	16926451	17132098	PLCL2	205647	16923951	16928951
NR_028057	chrX	+	192990	220022	PLCXD1	27032	190490	195490
NM_153268	chr3	+	111393522	111565294	PLCXD2	171772	111391022	111396022
NM_001005473	chr5	-	41307047	41510730	PLCXD3	203683	41508230	41513230
NM_033123	chr12	-	18836109	18890993	PLCZ1	54884	18888493	18893493
NM_002662	chr3	-	171318194	171528284	PLD1	210090	171525784	171530784
NM_002663	chr17	+	4710395	4726727	PLD2	16332	4707895	4712895
NM_012268	chr19	+	40854331	40884397	PLD3	30066	40851831	40856831
NM_138790	chr14	+	105391152	105399573	PLD4	8421	105388652	105393652
NM_001320272	chr1	-	242251688	242687998	PLD5	436310	242685498	242690498
NM_178836	chr17	-	17104308	17109646	PLD6	5338	17107146	17112146
NM_000445	chr8	-	144989314	145050913	PLEC	61599	145048413	145053413
NM_002664	chr2	+	68592321	68624585	PLEK	32264	68589821	68594821
NM_016445	chr14	-	67853695	67878917	PLEK2	25222	67876417	67881417
NM_001330178	chr10	+	124134093	124191871	PLEKHA1	57778	124131593	124136593
NM_021623	chr8	+	38758752	38831430	PLEKHA2	72678	38756252	38761252
NM_019091	chr2	+	179345198	179369782	PLEKHA3	24584	179342698	179347698
NM_020904	chr19	-	49340353	49371884	PLEKHA4	31531	49369384	49374384
NM_019012	chr12	+	19282625	19529333	PLEKHA5	246708	19280125	19285125
NM_014935	chr1	-	204187978	204329057	PLEKHA6	141079	204326557	204331557
NM_001329630	chr11	-	16798843	17035963	PLEKHA7	237120	17033463	17038463
NM_001350973	chr7	+	30067976	30170098	PLEKHA8	102122	30065476	30070476
NR_037144	chr12	-	45566816	45609789	PLEKHA8P1	42973	45607289	45612289
NM_001130033	chr11	+	73357222	73373864	PLEKHB1	16642	73354722	73359722
NM_001267065	chr2	+	131862419	131907425	PLEKHB2	45006	131859919	131864919
NM_001161498	chr14	+	69951470	69995215	PLEKHD1	43745	69948970	69953970
NM_024310	chr19	+	30156326	30166383	PLEKHF1	10057	30153826	30158826
NM_024613	chr8	+	96145948	96168913	PLEKHF2	22965	96143448	96148448
NM_001029884	chr6	+	150921000	151164801	PLEKHG1	243801	150918500	150923500
NM_022835	chr19	+	39903749	39919055	PLEKHG2	15306	39901249	39906249
NM_001308147	chr14	+	65171125	65211064	PLEKHG3	39939	65168625	65173625
NM_001129727	chr16	+	67312059	67323403	PLEKHG4	11344	67309559	67314559
NM_052909	chr5	+	92265	190087	PLEKHG4B	97822	89765	94765
NM_198681	chr1	-	6526151	6580121	PLEKHG5	53970	6577621	6582621
NM_018173	chr12	+	6419601	6437672	PLEKHG6	18071	6417101	6422101
NM_001004330	chr12	+	93130264	93165868	PLEKHG7	35604	93127764	93132764
NM_020715	chr14	+	68000007	68056255	PLEKHH1	56248	67997507	68002507
NM_172069	chr2	+	43864438	43995126	PLEKHH2	130688	43861938	43866938
NR_073573	chr17	-	40819931	40829048	PLEKHH3	9117	40826548	40831548
NM_001300836	chr19	-	2229950	2236352	PLEKHJ1	6402	2233852	2238852
NM_014798	chr17_ctg5_hap1	-	128327	183214	PLEKHM1	54887	180714	185714
NR_024386	chr17	-	62780958	62833302	PLEKHM1P1	52344	62830802	62835802
NM_015164	chr1	+	16010797	16061264	PLEKHM2	50467	16008297	16013297
NM_001080475	chr2	-	208686011	208890284	PLEKHM3	204273	208887784	208892784
NM_001160184	chr1	+	901876	910484	PLEKHN1	8608	899376	904376
NM_001304722	chr1	+	150121623	150132260	PLEKHO1	10637	150119123	150124123
NM_001195059	chr15	+	65134081	65160201	PLEKHO2	26120	65131581	65136581
NM_001193435	chr10	+	115511212	115542192	PLEKHS1	30980	115508712	115513712
NM_001145024	chr11	-	112118875	112131583	PLET1	12708	112129083	112134083
NM_000301	chr6	+	161123224	161175085	PLG	51861	161120724	161125724
NR_003506	chr2	+	106998569	107007851	PLGLA	9282	106996069	107001069
NM_001032392	chr2	+	88047609	88058994	PLGLB1	11385	88045109	88050109
NM_002665	chr2	+	88047605	88058994	PLGLB2	11389	88045105	88050105
NM_018465	chr9	-	5357966	5437937	PLGRKT	79971	5435437	5440437
NM_002666	chr15	-	90207599	90222648	PLIN1	15049	90220148	90225148
NR_038064	chr9	-	19115758	19127604	PLIN2	11846	19125104	19130104
NM_001164189	chr19	-	4838345	4867780	PLIN3	29435	4865280	4870280
NM_001080400	chr19	-	4502191	4517716	PLIN4	15525	4515216	4520216
NM_001013706	chr19	-	4522543	4535208	PLIN5	12665	4532708	4537708
NM_005030	chr16	+	23690092	23701688	PLK1	11596	23687592	23692592
NM_006622	chr5	-	57749809	57755966	PLK2	6157	57753466	57758466
NM_004073	chr1	+	45265896	45271667	PLK3	5771	45263396	45268396
NM_001190799	chr4	+	128802015	128820377	PLK4	18362	128799515	128804515
NM_001243079	chr19	+	1524072	1535455	PLK5	11383	1521572	1526572
NM_015993	chr16	-	57290008	57318584	PLLP	28576	57316084	57321084
NM_002667	chr6	+	118869425	118882878	PLN	13453	118866925	118871925
NM_001316320	chr1	+	11994723	12035599	PLOD1	40876	11992223	11997223
NM_000935	chr3	-	145787227	145879282	PLOD2	92055	145876782	145881782
NM_001084	chr7	-	100849257	100861011	PLOD3	11754	100858511	100863511
NM_001128834	chrX	+	103031433	103047547	PLP1	16114	103028933	103033933
NM_002668	chrX	+	49028183	49031468	PLP2	3285	49025683	49030683
NM_007198	chr8	+	37620100	37637286	PLPBP	17186	37617600	37622600
NM_176895	chr5	-	54720669	54830906	PLPP1	110237	54828406	54833406
NM_003712	chr19	-	281039	291435	PLPP2	10396	288935	293935
NM_003713	chr1	-	56960418	57045257	PLPP3	84839	57042757	57047757
NM_001030059	chr10	+	122216465	122349376	PLPP4	132911	122213965	122218965
NM_001102559	chr8	-	38120649	38126738	PLPP5	6089	38124238	38129238
NM_203453	chr9	+	4662293	4665272	PLPP6	2979	4659793	4664793
NM_032728	chr9	+	134165080	134184649	PLPP7	19569	134162580	134167580
NM_207299	chr9	+	103791030	104087417	PLPPR1	296387	103788530	103793530
NM_001170635	chr19	+	11466061	11476374	PLPPR2	10313	11463561	11468561
NM_001270366	chr19	-	812487	821952	PLPPR3	9465	819452	824452
NM_014839	chr1	+	99729847	99775138	PLPPR4	45291	99727347	99732347
NM_001037317	chr1	-	99355800	99470449	PLPPR5	114649	99467949	99472949
NM_002669	chr4	-	155456148	155471585	PLRG1	15437	155469085	155474085
NM_001145319	chr3	+	142315228	142432505	PLS1	117277	142312728	142317728
NM_005032	chrX	+	114795176	114885179	PLS3	90003	114792676	114797676
NR_110383	chrX	-	114752496	114797058	PLS3-AS1	44562	114794558	114799558
NM_021105	chr3	-	146232966	146262628	PLSCR1	29662	146260128	146265128
NM_020359	chr3	-	146151074	146213778	PLSCR2	62704	146211278	146216278
NM_001201576	chr17	-	7293046	7298162	PLSCR3	5116	7295662	7300662
NM_020353	chr3	-	145910123	145968966	PLSCR4	58843	145966466	145971466
NM_001321245	chr3	-	146294341	146324003	PLSCR5	29662	146321503	146326503
NM_001242920	chr20	-	44527258	44541003	PLTP	13745	44538503	44543503
NR_047484	chr13	-	28393228	28491428	PLUT	98200	28488928	28493928
NM_031310	chr19	-	17462256	17488158	PLVAP	25902	17485658	17490658
NM_020405	chr17	-	37219555	37307902	PLXDC1	88347	37305402	37310402
NM_001282736	chr10	+	20105371	20578784	PLXDC2	473413	20102871	20107871
NM_032242	chr3	+	126707436	126756235	PLXNA1	48799	126704936	126709936
NM_025179	chr1	-	208195587	208417665	PLXNA2	222078	208415165	208420165
NM_017514	chrX	+	153686620	153701989	PLXNA3	15369	153684120	153689120
NM_020911	chr7	-	131808090	132261323	PLXNA4	453233	132258823	132263823
NM_001130082	chr3	-	48445260	48471460	PLXNB1	26200	48468960	48473960
NM_012401	chr22	-	50713407	50746001	PLXNB2	32594	50743501	50748501
NM_001163257	chrX	+	153029650	153044801	PLXNB3	15151	153027150	153032150
NM_005761	chr12	+	94542498	94701451	PLXNC1	158953	94539998	94544998
NM_015103	chr3	-	129274055	129325582	PLXND1	51527	129323082	129328082
NR_135186	chr1	-	205797149	205819276	PM20D1	22127	205816776	205821776
NM_001010853	chr6	+	89855768	89875288	PM20D2	19520	89853268	89858268
NM_021127	chr18	+	57567191	57571538	PMAIP1	4347	57564691	57569691
NR_003921	chr5	+	22142460	22152379	PMCHL1	9919	22139960	22144960
NR_003922	chr5	+	70671611	70681820	PMCHL2	10209	70669111	70674111
NM_006928	chr12	-	56347888	56360496	PMEL	12608	56357996	56362996
NM_199171	chr20	-	56223447	56286592	PMEPA1	63145	56284092	56289092
NM_007221	chr1	+	156182778	156209868	PMF1	27090	156180278	156185278
NM_001199664	chr1	+	156182778	156213123	PMF1-BGLAP	30345	156180278	156185278
NM_001160213	chr16	-	72152995	72206349	PMFBP1	53354	72203849	72208849
NM_033238	chr15	+	74287013	74340155	PML	53142	74284513	74289513
NM_002676	chr22	-	41972889	41985871	PMM1	12982	41983371	41988371
NM_000303	chr16	+	8891669	8943194	PMM2	51525	8889169	8894169
NM_002677	chr8	-	82352562	82359758	PMP2	7196	82357258	82362258
NM_001281456	chr17	-	15133093	15168674	PMP22	35581	15166174	15171174
NM_015160	chr9	+	139305024	139318213	PMPCA	13189	139302524	139307524
NM_004279	chr7	+	102937872	102955133	PMPCB	17261	102935372	102940372
NM_001321048	chr2	+	190648810	190742355	PMS1	93545	190646310	190651310
NM_001322008	chr7	-	6010555	6048737	PMS2	38182	6046237	6051237
NR_002217	chr7	+	6774935	6791232	PMS2CL	16297	6772435	6777435
NR_003613	chr7	-	99918262	99933930	PMS2P1	15668	99931430	99936430
NR_003614	chr7	+	72476643	72491707	PMS2P2	15064	72474143	72479143
NR_028059	chr7	-	75137068	75157453	PMS2P3	20385	75154953	75159953
NR_046299	chr7	-	66741117	66767429	PMS2P4	26312	66764929	66769929
NR_027776	chr7	-	74702376	74988276	PMS2P5	285900	74985776	74990776
NR_130940	chr7	-	74977963	74988292	PMS2P7	10329	74985792	74990792
NR_028058	chr7	+	76668796	76682355	PMS2P9	13559	76666296	76671296
NM_001323012	chr1	-	154897207	154915165	PMVK	17958	154912665	154917665
NM_001039582	chrX	-	152935187	152939816	PNCK	4629	152937316	152942316
NR_136326	chr6	-	99845926	99873221	PNISR	27295	99870721	99875721
NM_015488	chr2	+	219135114	219211516	PNKD	76402	219132614	219137614
NM_007254	chr19	-	50364459	50370822	PNKP	6363	50368322	50373322
NM_001271862	chr6	+	160221280	160241736	PNLDC1	20456	160218780	160223780
NM_000936	chr10	+	118305435	118327370	PNLIP	21935	118302935	118307935
NM_006229	chr10	+	118350470	118368687	PNLIPRP1	18217	118347970	118352970
NM_005396	chr10	+	118380464	118404654	PNLIPRP2	24190	118377964	118382964
NM_001011709	chr10	+	118187423	118237468	PNLIPRP3	50045	118184923	118189923
NM_006029	chr14	-	74178485	74181128	PNMA1	2643	74178628	74183628
NM_007257	chr8	-	26362195	26371483	PNMA2	9288	26368983	26373983
NM_001282535	chrX	+	152224765	152228827	PNMA3	4062	152222265	152227265
NM_001184924	chrX	-	152157367	152162671	PNMA5	5304	152160171	152165171
NM_032882	chrX	+	152240796	152243402	PNMA6A	2606	152238296	152243296
NM_001351293	chrX	-	152661096	152666878	PNMA6E	5782	152664378	152669378
NM_018215	chr19	-	46969747	46974820	PNMA8A	5073	46972320	46977320
NM_020709	chr19	-	46994447	46999169	PNMA8B	4722	46996669	47001669
NM_002687	chr14	+	39644386	39652422	PNN	8036	39641886	39646886
NM_001329916	chr2	+	68384961	68403370	PNO1	18409	68382461	68387461
NM_006228	chr8	+	28174648	28200871	PNOC	26223	28172148	28177148
NM_000270	chr14	+	20937537	20946165	PNP	8628	20935037	20940037
NM_001145716	chr6	+	36210944	36276372	PNPLA1	65428	36208444	36213444
NM_020376	chr11	+	818900	825571	PNPLA2	6671	816400	821400
NM_025225	chr22	+	44319618	44343448	PNPLA3	23830	44317118	44322118
NM_001172672	chrX	-	7866803	7895780	PNPLA4	28977	7893280	7898280
NM_001177675	chr22	-	44275557	44287893	PNPLA5	12336	44285393	44290393
NM_006702	chr19	+	7599037	7626653	PNPLA6	27616	7596537	7601537
NM_001098537	chr9	-	140354403	140445021	PNPLA7	90618	140442521	140447521
NM_001256011	chr7	-	108110865	108168605	PNPLA8	57740	108166105	108171105
NM_018129	chr17	+	46018888	46026674	PNPO	7786	46016388	46021388
NM_033109	chr2	-	55861197	55921045	PNPT1	59848	55918545	55923545
NM_006813	chr6	+	89790428	89794879	PNRC1	4451	89787928	89792928
NM_017761	chr1	+	24286300	24289949	PNRC2	3649	24283800	24288800
NM_001161581	chr3	-	52109248	52188706	POC1A	79458	52186206	52191206
NR_037659	chr12	-	89813497	89920039	POC1B	106542	89917539	89922539
NR_146294	chr12	+	89919346	89935319	POC1B-AS1	15973	89916846	89921846
NM_001199782	chr12	-	89913189	89920039	POC1B-GALNT4	6850	89917539	89922539
NM_001099271	chr5	-	74970023	75013313	POC5	43290	75010813	75015813
NM_001199080	chr1	+	53527723	53551174	PODN	23451	53525223	53530223
NM_001146254	chr19	-	14041999	14064204	PODNL1	22205	14061704	14066704
NM_001018111	chr7	-	131185020	131241376	PODXL	56356	131238876	131243876
NM_015720	chr3	+	127348001	127391653	PODXL2	43652	127345501	127350501
NM_024921	chrX	-	84532394	84634748	POF1B	102354	84632248	84637248
NM_015352	chr20	+	30795695	30826467	POFUT1	30772	30793195	30798195
NM_015227	chr21	-	46683842	46707828	POFUT2	23986	46705328	46710328
NM_001314014	chr1	+	166808640	166825581	POGK	16941	166806140	166811140
NM_152305	chr3	+	119187784	119213554	POGLUT1	25770	119185284	119190284
NM_001194937	chr1	-	151375199	151431941	POGZ	56742	151429441	151434441
NM_001330360	chrX	+	24711949	25015102	POLA1	303153	24709449	24714449
NM_002689	chr11	+	65029322	65066156	POLA2	36834	65026822	65031822
NM_002690	chr8	+	42195972	42229331	POLB	33359	42193472	42198472
NM_001256849	chr19	+	50887579	50921275	POLD1	33696	50885079	50890079
NM_006230	chr7	-	44154278	44163169	POLD2	8891	44160669	44165669
NR_046409	chr11	+	74303574	74354105	POLD3	50531	74301074	74306074
NR_046412	chr11	-	67118235	67121067	POLD4	2832	67118567	67123567
NM_001290145	chr17	-	26673653	26684612	POLDIP2	10959	26682112	26687112
NM_001278657	chr22	-	42979726	43010968	POLDIP3	31242	43008468	43013468
NM_006231	chr12	-	133200347	133264110	POLE	63763	133261610	133266610
NM_001348385	chr14	-	50110269	50155098	POLE2	44829	50152598	50157598
NM_017443	chr9	-	116169517	116173029	POLE3	3512	116170529	116175529
NM_019896	chr2	+	75185769	75196859	POLE4	11090	75183269	75188269
NM_001126131	chr15	-	89859535	89878026	POLG	18491	89875526	89880526
NM_007215	chr17	-	62473901	62493184	POLG2	19283	62490684	62495684
NM_001291969	chr6	+	43543877	43588260	POLH	44383	43541377	43546377
NM_001351621	chr18	+	51795848	51847636	POLI	51788	51793348	51798348
NM_016218	chr5	+	74807574	74901644	POLK	94070	74805074	74810074
NM_001174084	chr10	-	103338638	103348027	POLL	9389	103345527	103350527
NM_013284	chr7	-	44111660	44122139	POLM	10479	44119639	44124639
NM_181808	chr4	-	2073684	2243891	POLN	170207	2241391	2246391
NM_199420	chr3	-	121150272	121264853	POLQ	114581	121262353	121267353
NM_015425	chr2	-	86247338	86333278	POLR1A	85940	86330778	86335778
NM_001282774	chr2	+	113299491	113334729	POLR1B	35238	113296991	113301991
NM_001318876	chr6	+	43484761	43497114	POLR1C	12353	43482261	43487261
NM_001206559	chr13	+	28194879	28241559	POLR1D	46680	28192379	28197379
NM_022490	chr9	+	37485931	37503694	POLR1E	17763	37483431	37488431
NM_000937	chr17	+	7387697	7417935	POLR2A	30238	7385197	7390197
NM_000938	chr4	+	57844805	57897328	POLR2B	52523	57842305	57847305
NM_032940	chr16	+	57496550	57505921	POLR2C	9371	57494050	57499050
NM_004805	chr2	-	128603839	128615729	POLR2D	11890	128613229	128618229
NM_001316323	chr19	-	1086577	1095391	POLR2E	8814	1092891	1097891
NM_001301130	chr22	+	38349669	38437922	POLR2F	88253	38347169	38352169
NM_002696	chr11	+	62529010	62534187	POLR2G	5177	62526510	62531510
NM_001278700	chr3	+	184079501	184086383	POLR2H	6882	184077001	184082001
NM_006234	chr7	-	102113547	102119381	POLR2J	5834	102116881	102121881
NM_032959	chr7	-	102277194	102312176	POLR2J2	34982	102309676	102314676
NM_001097615	chr7	-	102178365	102213068	POLR2J3	34703	102210568	102215568
NR_003655	chr7	-	43980493	44058793	POLR2J4	78300	44056293	44061293
NM_005034	chr8	+	101162838	101166230	POLR2K	3392	101160338	101165338
NM_021128	chr11	-	839720	842529	POLR2L	2809	840029	845029
NM_015532	chr15	+	57998718	58009755	POLR2M	11037	57996218	58001218
NM_007055	chr10	-	79734906	79789298	POLR3A	54392	79786798	79791798
NM_018082	chr12	+	106751435	106903976	POLR3B	152541	106748935	106753935
NM_006468	chr1	-	145590666	145611044	POLR3C	20378	145608544	145613544
NM_001722	chr8	+	22102618	22108680	POLR3D	6062	22100118	22105118
NM_001258033	chr16	+	22308695	22346424	POLR3E	37729	22306195	22311195
NR_104209	chr20	+	18448032	18465292	POLR3F	17260	18445532	18450532
NM_006467	chr5	+	89770680	89810369	POLR3G	39689	89768180	89773180
NM_032305	chr1	-	145456235	145470408	POLR3GL	14173	145467908	145472908
NM_001282884	chr22	-	41921805	41940610	POLR3H	18805	41938110	41943110
NM_016310	chr16	-	96978	103632	POLR3K	6654	101132	106132
NM_005035	chr19	-	617222	633568	POLRMT	16346	631068	636068
NM_001257190	chr7	+	72349905	72421979	POM121	72074	72347405	72352405
NM_001099415	chr7	-	75046059	75115565	POM121C	69506	75113065	75118065
NR_024593	chr22	-	25041132	25055114	POM121L10P	13982	25052614	25057614
NR_024591	chr22	-	22974027	22987012	POM121L1P	12985	22984512	22989512
NM_033482	chr6	-	27276841	27280011	POM121L2	3170	27277511	27282511
NR_024583	chr22	+	21636713	21652015	POM121L8P	15302	21634213	21639213
NR_003714	chr22	+	24647588	24661492	POM121L9P	13904	24645088	24650088
NM_000939	chr2	-	25383721	25391720	POMC	7999	25389220	25394220
NM_001243766	chr1	-	46654352	46685977	POMGNT1	31625	46683477	46688477
NM_032806	chr3	-	43120720	43147575	POMGNT2	26855	43145075	43150075
NM_032237	chr8	+	42948648	42978323	POMK	29675	42946148	42951148
NM_015932	chr13	+	29233140	29253093	POMP	19953	29230640	29235640
NM_007171	chr9	+	134378288	134399193	POMT1	20905	134375788	134380788
NM_013382	chr14	-	77741298	77787225	POMT2	45927	77784725	77789725
NM_152992	chr7	-	76239302	76256620	POMZP3	17318	76254120	76259120
NM_000446	chr7	-	94927668	94953884	PON1	26216	94951384	94956384
NM_001018161	chr7	-	95034173	95064384	PON2	30211	95061884	95066884
NM_000940	chr7	-	94989183	95025687	PON3	36504	95023187	95028187
NM_001145861	chr8	+	99129520	99172069	POP1	42549	99127020	99132020
NM_006627	chr19	+	30097169	30108162	POP4	10993	30094669	30099669
NM_022135	chr3	-	119360898	119379437	POPDC2	18539	119376937	119381937
NM_022361	chr6	-	105605774	105627858	POPDC3	22084	105625358	105630358
NM_000941	chr7	+	75544419	75616173	POR	71754	75541919	75546919
NM_001282167	chrX	+	48367346	48379202	PORCN	11856	48364846	48369846
NM_001135935	chr13	-	38136718	38172981	POSTN	36263	38170481	38175481
NR_003104	chr7	-	124462439	124570037	POT1	107598	124567537	124572537
NR_125718	chr7	+	124569926	124785287	POT1-AS1	215361	124567426	124572426
NM_001005365	chr8	+	43147584	43218328	POTEA	70744	43145084	43150084
NM_001277304	chr15	-	22051852	22082803	POTEB	30951	22080303	22085303
NR_102390	chr15	-	22051852	22082803	POTEB2	30951	22080303	22085303
NM_207355	chr15	-	22051852	22083141	POTEB3	31289	22080641	22085641
NR_134878	chr18	-	14507348	14543599	POTEC	36251	14541099	14546099
NM_174981	chr21	+	14982497	15013906	POTED	31409	14979997	14984997
NM_001083538	chr2	+	131975923	132022416	POTEE	46493	131973423	131978423
NM_001099771	chr2	-	130831107	130886795	POTEF	55688	130884295	130889295
NR_027480	chr14	+	19553364	19584942	POTEG	31578	19550864	19555864
NM_001136213	chr22	-	16256331	16287937	POTEH	31606	16285437	16290437
NR_046571	chr14	-	19563711	19566680	POTEH-AS1	2969	19564180	19569180
NM_001277406	chr2	-	131220388	131266808	POTEI	46420	131264308	131269308
NM_001277083	chr2	+	131369105	131415610	POTEJ	46505	131366605	131371605
NR_033885	chr2	+	132349614	132384002	POTEKP	34388	132347114	132352114
NM_001145442	chr14	-	19983953	20020272	POTEM	36319	20017772	20022772
NM_000306	chr3	-	87308782	87325737	POU1F1	16955	87323237	87328237
NM_006235	chr11	-	111222980	111250157	POU2AF1	27177	111247657	111252657
NM_001198786	chr1	+	167190065	167396582	POU2F1	206517	167187565	167192565
NM_002698	chr19	-	42590261	42636625	POU2F2	46364	42634125	42639125
NM_001244682	chr11	+	120107348	120190653	POU2F3	83305	120104848	120109848
NM_002699	chr1	-	38509522	38512450	POU3F1	2928	38509950	38514950
NM_005604	chr6	+	99282579	99286666	POU3F2	4087	99280079	99285079
NM_006236	chr2	+	105470525	105475031	POU3F3	4506	105468025	105473025
NM_006237	chr13	-	79173229	79177695	POU4F1	4466	79175195	79180195
NM_004575	chr4	+	147560044	147563623	POU4F2	3579	147557544	147562544
NM_002701	chr6_mcf_hap5	-	2514036	2520412	POU5F1	6376	2517912	2522912
NR_026893	chr12	-	51580718	51611539	POU6F1	30821	51609039	51614039
NM_007252	chr7	+	39017608	39504390	POU6F2	486782	39015108	39020108
NR_138047	chr7	-	39019494	39053167	POU6F2-AS2	33673	39050667	39055667
NR_024014	chr2	-	241388835	241396117	PP14571	7282	241393617	241398617
NR_027694	chr3	-	20021452	20053765	PP2D1	32313	20051265	20056265
NM_021129	chr10	-	71962585	71993190	PPA1	30605	71990690	71995690
NM_176866	chr4	-	106290233	106395227	PPA2	104994	106392727	106397727
NM_020230	chr19	+	10216898	10222679	PPAN	5781	10214398	10219398
NM_001198690	chr19	+	10216898	10226064	PPAN-P2RY11	9166	10214398	10219398
NM_005036	chr22	+	46546498	46639653	PPARA	93155	46543998	46548998
NM_006238	chr6	+	35310334	35395968	PPARD	85634	35307834	35312834
NM_138712	chr3	+	12329348	12475855	PPARG	146507	12326848	12331848
NM_001330752	chr4	-	23793643	24474452	PPARGC1A	680809	24471952	24476952
NM_133263	chr5	+	149109814	149234585	PPARGC1B	124771	149107314	149112314
NM_002703	chr4	-	57259528	57301802	PPAT	42274	57299302	57304302
NM_001301103	chr15	+	75315895	75343067	PPCDC	27172	75313395	75318395
NM_001287511	chr1	+	42922164	42939049	PPCS	16885	42919664	42924664
NM_006240	chrX	+	18709044	18846034	PPEF1	136990	18706544	18711544
NR_046642	chrX	-	18706762	18710806	PPEF1-AS1	4044	18708306	18713306
NM_006239	chr4	-	76781025	76823681	PPEF2	42656	76821181	76826181
NR_045286	chr11	+	70116805	70230607	PPFIA1	113802	70114305	70119305
NM_003625	chr12	-	81651753	82153109	PPFIA2	501356	82150609	82155609
NR_120491	chr12	+	81672967	81706201	PPFIA2-AS1	33234	81670467	81675467
NR_103842	chr19	+	49622645	49654287	PPFIA3	31642	49620145	49625145
NM_001304332	chr1	+	202995648	203047864	PPFIA4	52216	202993148	202998148
NM_001198915	chr12	+	27677044	27848497	PPFIBP1	171453	27674544	27679544
NM_001351855	chr11	+	7534995	7674996	PPFIBP2	140001	7532495	7537495
NM_016488	chr12	+	42719946	42842422	PPHLN1	122476	42717446	42722446
NM_021130	chr7	+	44836234	44842722	PPIA	6488	44833734	44838734
NM_000942	chr15	-	64448013	64455354	PPIB	7341	64452854	64457854
NM_000943	chr5	-	122359077	122372425	PPIC	13348	122369925	122374925
NM_005038	chr4	-	159630278	159644552	PPID	14274	159642052	159647052
NM_001319293	chr1	+	40204516	40229586	PPIE	25070	40202016	40207016
NR_144355	chr1	-	39987951	40025370	PPIEL	37419	40022870	40027870
NM_005729	chr10	+	81107219	81115089	PPIF	7870	81104719	81109719
NM_004792	chr2	+	170440849	170494254	PPIG	53405	170438349	170443349
NM_006347	chr1	+	43124047	43142429	PPIH	18382	43121547	43126547
NM_016059	chr6	-	36822605	36842800	PPIL1	20195	36840300	36845300
NM_148175	chr22	+	22020272	22052202	PPIL2	31930	22017772	22022772
NM_032472	chr2	-	201735678	201753849	PPIL3	18171	201751349	201756349
NM_139126	chr6	-	149825630	149867238	PPIL4	41608	149864738	149869738
NM_001111298	chr6	-	109711417	109762374	PPIL6	50957	109759874	109764874
NM_001190214	chr15	-	43825659	43882451	PPIP5K1	56792	43879951	43884951
NR_146339	chr15	-	43922759	43982229	PPIP5K1P1-CATSPER2	59470	43979729	43984729
NM_015216	chr5	+	102455951	102540612	PPIP5K2	84661	102453451	102458451
NM_002705	chr16	-	4932507	4987136	PPL	54629	4984636	4989636
NM_177952	chr14	+	60712469	60765805	PPM1A	53336	60709969	60714969
NM_177968	chr2	+	44395941	44461742	PPM1B	65801	44393441	44398441
NM_003620	chr17	+	58677543	58743640	PPM1D	66097	58675043	58680043
NR_048561	chr17	+	56833229	57062540	PPM1E	229311	56830729	56835729
NM_014634	chr22	-	22273791	22307250	PPM1F	33459	22304750	22309750
NM_177983	chr2	-	27604065	27632550	PPM1G	28485	27630050	27635050
NM_020700	chr12	-	63037762	63328665	PPM1H	290903	63326165	63331165
NM_005167	chr1	-	113252615	113257950	PPM1J	5335	113255450	113260450
NM_152542	chr4	-	89178760	89205983	PPM1K	27223	89203483	89208483
NM_139245	chr3	+	160473991	160796695	PPM1L	322704	160471491	160476491
NM_144641	chr3	+	52279808	52284615	PPM1M	4807	52277308	52282308
NM_001080401	chr19	+	46001730	46005764	PPM1N	4034	45999230	46004230
NM_016147	chr11	+	73882107	73965748	PPME1	83641	73879607	73884607
NM_000309	chr1	+	161136170	161141010	PPOX	4840	161133670	161138670
NM_206873	chr11	-	67165651	67169376	PPP1CA	3725	67166876	67171876
NM_206876	chr2	+	28974613	29025806	PPP1CB	51193	28972113	28977113
NM_002710	chr12	-	111157612	111180783	PPP1CC	23171	111178283	111183283
NM_002714	chr6_mcf_hap5	-	1950031	1966940	PPP1R10	16909	1964440	1969440
NM_021959	chr6_mann_hap4	+	1333523	1336701	PPP1R11	3178	1331023	1336023
NM_001143885	chr12	-	80167342	80329235	PPP1R12A	161893	80326735	80331735
NR_146533	chr12	+	80329060	80335175	PPP1R12A-AS1	6115	80326560	80331560
NM_002481	chr1	+	202317829	202557697	PPP1R12B	239868	202315329	202320329
NM_001271618	chr19	-	55602280	55628968	PPP1R12C	26688	55626468	55631468
NM_015316	chr14	-	104200087	104313927	PPP1R13B	113840	104311427	104316427
NM_001142502	chr19	-	45882891	45909607	PPP1R13L	26716	45907107	45912107
NM_033256	chr19	-	38741876	38747231	PPP1R14A	5355	38744731	38749731
NM_030949	chr6	+	150464187	150571528	PPP1R14C	107341	150461687	150466687
NM_001130143	chr15	-	41107642	41120907	PPP1R14D	13265	41118407	41123407
NM_014330	chr19	+	49375648	49379319	PPP1R15A	3671	49373148	49378148
NM_032833	chr1	-	204372491	204380945	PPP1R15B	8454	204378445	204383445
NM_001329442	chr8	+	145703364	145727504	PPP1R16A	24140	145700864	145705864
NM_015568	chr20	+	37434335	37551667	PPP1R16B	117332	37431835	37436835
NM_006658	chr7	+	31726630	31748069	PPP1R17	21439	31724130	31729130
NM_133471	chr6	-	30644165	30655672	PPP1R18	11507	30653172	30658172
NM_006741	chr12	-	54973023	54982443	PPP1R1A	9420	54979943	54984943
NM_032192	chr17	+	37783176	37792878	PPP1R1B	9702	37780676	37785676
NR_048567	chr2	+	182818967	182982483	PPP1R1C	163516	182816467	182821467
NM_001316325	chr3	-	195241217	195270224	PPP1R2	29007	195267724	195272724
NM_001135629	chr2	+	48667907	48742531	PPP1R21	74624	48665407	48670407
NM_014811	chr9	+	138371647	138380739	PPP1R26	9092	138369147	138374147
NR_038969	chr9	-	138354564	138364095	PPP1R26-AS1	9531	138361595	138366595
NM_001170753	chr11	+	61248584	61258400	PPP1R32	9816	61246084	61251084
NM_172365	chr14	+	65016619	65056097	PPP1R36	39478	65014119	65019119
NM_019121	chr19	+	45596430	45650543	PPP1R37	54113	45593930	45598930
NM_002711	chr7	-	113516881	113559082	PPP1R3A	42201	113556582	113561582
NM_001201329	chr8	-	8993763	9009152	PPP1R3B	15389	9006652	9011652
NM_005398	chr10	-	93388197	93392858	PPP1R3C	4661	93390358	93395358
NM_006242	chr20	-	58511886	58515352	PPP1R3D	3466	58512852	58517852
NM_001276318	chr14	-	23765129	23772057	PPP1R3E	6928	23769557	23774557
NM_033215	chrX	+	49126305	49144555	PPP1R3F	18250	49123805	49128805
NM_001013626	chr8	-	67899910	67940786	PPP1R42	40876	67938286	67943286
NM_001282413	chr2	+	242088987	242123065	PPP1R7	34078	242086487	242091487
NM_014110	chr1	+	28157251	28178183	PPP1R8	20932	28154751	28159751
NM_017650	chr7	+	94536948	94925727	PPP1R9A	388779	94534448	94539448
NM_032595	chr17	-	48211098	48227878	PPP1R9B	16780	48225378	48230378
NM_002715	chr5	-	133532147	133561950	PPP2CA	29803	133559450	133564450
NM_001009552	chr8	-	30643125	30670352	PPP2CB	27227	30667852	30672852
NM_014225	chr19	+	52693054	52729678	PPP2R1A	36624	52690554	52695554
NM_181699	chr11	-	111597631	111637169	PPP2R1B	39538	111634669	111639669
NM_002717	chr8	+	26149006	26230195	PPP2R2A	81189	26146506	26151506
NM_001271899	chr5	-	145969066	146461083	PPP2R2B	492017	146458583	146463583
NR_047115	chr5	-	146293769	146299069	PPP2R2B-IT1	5300	146296569	146301569
NM_001206994	chr4	-	6322304	6565327	PPP2R2C	243023	6562827	6567827
NM_001291310	chr10	+	133747954	133773338	PPP2R2D	25384	133745454	133750454
NM_002718	chr3	+	135684514	135866752	PPP2R3A	182238	135682014	135687014
NM_013239	chrX	-	294667	347690	PPP2R3B	53023	345190	350190
NR_130972	chr14	-	35554673	35591749	PPP2R3C	37076	35589249	35594249
NM_006243	chr1	+	212458878	212535205	PPP2R5A	76327	212456378	212461378
NM_006244	chr11	+	64692142	64701950	PPP2R5B	9808	64689642	64694642
NM_001352914	chr14	+	102226951	102394328	PPP2R5C	167377	102224451	102229451
NM_006245	chr6	+	42952236	42980083	PPP2R5D	27847	42949736	42954736
NM_001282179	chr14	-	63840609	64010079	PPP2R5E	169470	64007579	64012579
NM_001130692	chr4	-	101944586	102268628	PPP3CA	324042	102266128	102271128
NM_001142354	chr10	-	75196185	75255782	PPP3CB	59597	75253282	75258282
NR_132103	chr10	+	75255509	75267067	PPP3CB-AS1	11558	75253009	75258009
NM_005605	chr8	+	22298482	22398657	PPP3CC	100175	22295982	22300982
NM_000945	chr2	-	68405988	68479651	PPP3R1	73663	68477151	68482151
NM_147180	chr9	-	104353896	104357283	PPP3R2	3387	104354783	104359783
NM_001303503	chr16	+	30087296	30096698	PPP4C	9402	30084796	30089796
NM_005134	chr18	-	9546788	9614605	PPP4R1	67817	9612105	9617105
NR_110773	chr18	+	9614804	9619361	PPP4R1-AS1	4557	9612304	9617304
NR_003505	chr20	-	56807832	56884495	PPP4R1L	76663	56881995	56886995
NM_001318026	chr3	+	73045893	73118352	PPP4R2	72459	73043393	73048393
NM_001284280	chr14	-	91923824	91976824	PPP4R3A	53000	91974324	91979324
NM_001282850	chr2	-	55774427	55844860	PPP4R3B	70433	55842360	55847360
NM_207319	chrX	-	27478327	27481458	PPP4R3CP	3131	27478958	27483958
NM_058237	chr14	+	94640648	94746072	PPP4R4	105424	94638148	94643148
NM_001204284	chr19	+	46850250	46894232	PPP5C	43982	46847750	46852750
NM_001205281	chr19	-	46984044	47104457	PPP5D1	120413	47101957	47106957
NM_001123355	chr9	-	127908851	127952218	PPP6C	43367	127949718	127954718
NM_014931	chr19	-	55741146	55770038	PPP6R1	28892	55767538	55772538
NM_014678	chr22	+	50781745	50883518	PPP6R2	101773	50779245	50784245
NM_001164162	chr11	+	68228185	68382801	PPP6R3	154616	68225685	68230685
NM_001288727	chr10	+	103892750	103910090	PPRC1	17340	103890250	103895250
NM_000310	chr1	-	40538381	40563142	PPT1	24761	40560642	40565642
NM_138717	chr6_cox_hap2	+	3591896	3602139	PPT2	10243	3589396	3594396
NR_037861	chr6_cox_hap2	+	3592443	3606743	PPT2-EGFL8	14300	3589943	3594943
NM_139283	chr12	-	110972236	111021064	PPTC7	48828	111018564	111023564
NM_015342	chr5	+	64859062	64883376	PPWD1	24314	64856562	64861562
NM_001167989	chrX	+	48755194	48760422	PQBP1	5228	48752694	48757694
NM_001146343	chr18	-	77662419	77711653	PQLC1	49234	77709153	77714153
NR_109848	chr1	+	19638739	19658922	PQLC2	20183	19636239	19641239
NM_001130001	chr3	+	157261132	157319021	PQLC2L	57889	157258632	157263632
NM_001282712	chr2	+	11295497	11318998	PQLC3	23501	11292997	11297997
NM_032319	chr2	-	73455133	73460412	PRADC1	5279	73457912	73462912
NM_007213	chrX	-	48928812	48931704	PRAF2	2892	48929204	48934204
NM_001080826	chr8	-	8175257	8239344	PRAG1	64087	8236844	8241844
NM_032152	chr19	-	8554939	8567538	PRAM1	12599	8565038	8570038
NM_001291717	chr22	-	22890117	22901768	PRAME	11651	22899268	22904268
NM_023013	chr1	+	12851545	12856777	PRAMEF1	5232	12849045	12854045
NM_001039361	chr1	+	13629924	13635299	PRAMEF10	5375	13627424	13632424
NM_001146344	chr1	-	12884617	12891264	PRAMEF11	6647	12888764	12893764
NM_001080830	chr1	+	12834990	12838048	PRAMEF12	3058	12832490	12837490
NM_001291380	chr1	-	13447413	13452656	PRAMEF13	5243	13450156	13455156
NM_001024661	chr1	-	13447413	13452656	PRAMEF14	5243	13450156	13455156
NM_001098376	chr1	+	13421175	13428190	PRAMEF15	7015	13418675	13423675
NM_001099851	chr1	+	13495257	13498257	PRAMEF17	3000	13492757	13497757
NM_001099850	chr1	-	13328195	13698405	PRAMEF18	370210	13695905	13700905
NM_001099790	chr1	-	13474052	13477569	PRAMEF19	3517	13475069	13480069
NM_023014	chr1	+	12916940	12921764	PRAMEF2	4824	12914440	12919440
NM_001099852	chr1	+	13736906	13747803	PRAMEF20	10897	13734406	13739406
NM_001100631	chr1	+	13035542	13038381	PRAMEF22	2839	13033042	13038042
NM_001310134	chr1	-	13052239	13112702	PRAMEF25	60463	13110202	13115202
NM_001306072	chr1	-	13052393	13112702	PRAMEF26	60309	13110202	13115202
NM_001300891	chr1	+	13424002	13427859	PRAMEF27	3857	13421502	13426502
NM_001291381	chr1	+	13629931	13635299	PRAMEF33	5368	13627431	13632431
NR_111947	chr1	+	13194517	13199727	PRAMEF34P	5210	13192017	13197017
NR_111945	chr1	+	13194517	13199727	PRAMEF36P	5210	13192017	13197017
NM_001009611	chr1	-	12939032	12946025	PRAMEF4	6993	12943525	12948525
NM_001013407	chr1	+	13359818	13369057	PRAMEF5	9239	13357318	13362318
NM_001010889	chr1	-	12998301	13007406	PRAMEF6	9105	13004906	13009906
NM_001012277	chr1	+	12976466	12980300	PRAMEF7	3834	12973966	12978966
NM_001012276	chr1	+	12976466	12980300	PRAMEF8	3834	12973966	12978966
NM_001010890	chr1	-	12998504	13002353	PRAMEF9	3849	12999853	13004853
NR_135291	chr22	-	22345495	22398332	PRAMENP	52837	22395832	22400832
NM_001145201	chr10	+	135160843	135166187	PRAP1	5344	135158343	135163343
NM_005039	chr12	-	11504756	11508524	PRB1	3768	11506024	11511024
NM_006248	chr12	-	11544473	11548498	PRB2	4025	11545998	11550998
NM_006249	chr12	-	11418846	11422641	PRB3	3795	11420141	11425141
NM_001261399	chr12	-	11460014	11463369	PRB4	3355	11460869	11465869
NM_001267580	chr15	-	91509267	91537881	PRC1	28614	91535381	91540381
NR_051984	chr15	+	91509598	91531854	PRC1-AS1	22256	91507098	91512098
NM_005973	chr1	+	156737273	156770609	PRCC	33336	156734773	156739773
NR_033357	chr17	+	74523667	74541458	PRCD	17791	74521167	74526167
NM_001319214	chr11	-	82533982	82612782	PRCP	78800	82610282	82615282
NM_001198	chr6	+	106534194	106557814	PRDM1	23620	106531694	106536694
NM_020228	chr11	-	129769600	129872730	PRDM10	103130	129870230	129875230
NR_046338	chr11	+	45115563	45246639	PRDM11	131076	45113063	45118063
NM_021619	chr9	+	133539980	133558384	PRDM12	18404	133537480	133542480
NM_021620	chr6	+	100054649	100063454	PRDM13	8805	100052149	100057149
NM_024504	chr8	-	70963885	70983562	PRDM14	19677	70981062	70986062
NM_001282934	chr21	-	43218384	43299591	PRDM15	81207	43297091	43302091
NM_022114	chr1	+	2985741	3355185	PRDM16	369444	2983241	2988241
NM_001135610	chr1	+	14026734	14151574	PRDM2	124840	14024234	14029234
NM_012406	chr12	-	108126642	108154914	PRDM4	28272	108152414	108157414
NM_001300823	chr4	-	121613067	121844021	PRDM5	230954	121841521	121846521
NM_001136239	chr5	+	122424797	122529960	PRDM6	105163	122422297	122427297
NM_001098173	chr16	-	90122973	90142338	PRDM7	19365	90139838	90144838
NM_020226	chr4	+	81106423	81125482	PRDM8	19059	81103923	81108923
NM_020227	chr5	+	23507717	23528706	PRDM9	20989	23505217	23510217
NM_001202431	chr1	-	45976706	45988562	PRDX1	11856	45986062	45991062
NM_005809	chr19	-	12907633	12912724	PRDX2	5091	12910224	12915224
NR_126102	chr10	-	120927210	120938377	PRDX3	11167	120935877	120940877
NM_006406	chrX	+	23685644	23704514	PRDX4	18870	23683144	23688144
NM_012094	chr11	+	64085559	64089295	PRDX5	3736	64083059	64088059
NM_004905	chr1	+	173446485	173457946	PRDX6	11461	173443985	173448985
NM_001330484	chr2	-	27353624	27357543	PREB	3919	27355043	27360043
NM_013237	chr5	+	176730762	176733960	PRELID1	3198	176728262	176733262
NM_138492	chr5	-	145135906	145214932	PRELID2	79026	145212432	145217432
NM_001142405	chr18	+	12407894	12432236	PRELID3A	24342	12405394	12410394
NM_016045	chr20	-	57608199	57617901	PRELID3B	9702	57615401	57620401
NM_002725	chr1	+	203444882	203460479	PRELP	15597	203442382	203447382
NM_002726	chr6	-	105725441	105850999	PREP	125558	105848499	105853499
NM_001171617	chr2	-	44544747	44589001	PREPL	44254	44586501	44591501
NM_020820	chr20	-	47240792	47444420	PREX1	203628	47441920	47446920
NM_024870	chr8	+	68864349	69149268	PREX2	284919	68861849	68866849
NM_005041	chr10	-	72357103	72362531	PRF1	5428	72360031	72365031
NM_001302927	chr11	-	57154259	57158130	PRG2	3871	57155630	57160630
NM_006093	chr11	-	57144241	57148623	PRG3	4382	57146123	57151123
NM_001127708	chr1	+	186265404	186283694	PRG4	18290	186262904	186267904
NM_001291314	chr12	-	11033559	11324222	PRH1	290663	11321722	11326722
NR_037918	chr12	-	10998447	11324224	PRH1-PRR4	325777	11321724	11326724
NM_001316893	chr12	-	11090004	11324222	PRH1-TAS2R14	234218	11321722	11326722
NM_001110213	chr12	+	11081834	11087444	PRH2	5610	11079334	11084334
NM_153026	chr12	-	42852139	42983572	PRICKLE1	131433	42981072	42986072
NM_198859	chr3	-	64079525	64211131	PRICKLE2	131606	64208631	64213631
NR_045697	chr3	+	64053639	64088807	PRICKLE2-AS1	35168	64051139	64056139
NR_046701	chr3	+	64089145	64092034	PRICKLE2-AS2	2889	64086645	64091645
NR_046702	chr3	+	64173219	64187236	PRICKLE2-AS3	14017	64170719	64175719
NM_006150	chrX	-	49031150	49042853	PRICKLE3	11703	49040353	49045353
NM_013397	chr6	+	41748499	41755110	PRICKLE4	6611	41745999	41750999
NM_000946	chr12	-	57125363	57146146	PRIM1	20783	57143646	57148646
NM_000947	chr6	+	57182414	57513376	PRIM2	330962	57179914	57184914
NM_178013	chr14	-	94184643	94254766	PRIMA1	70123	94252266	94257266
NM_001345893	chr4	+	185570766	185616113	PRIMPOL	45347	185568266	185573266
NM_206907	chr5	-	40759480	40798297	PRKAA1	38817	40795797	40800797
NM_006252	chr1	+	57110989	57181008	PRKAA2	70019	57108489	57113489
NM_006253	chr12	+	120105760	120119429	PRKAB1	13669	120103260	120108260
NR_103870	chr1	-	146626684	146644168	PRKAB2	17484	146641668	146646668
NM_002730	chr19	-	14202506	14228559	PRKACA	26053	14226059	14231059
NM_002731	chr1	+	84543657	84704181	PRKACB	160524	84541157	84546157
NM_001206709	chr12	-	49396054	49412629	PRKAG1	16575	49410129	49415129
NM_016203	chr7	-	151253200	151574316	PRKAG2	321116	151571816	151576816
NM_017431	chr2	-	219687105	219696512	PRKAG3	9407	219694012	219699012
NM_001278433	chr17	+	66409763	66529570	PRKAR1A	119807	66407263	66412263
NM_001164758	chr7	-	588833	767313	PRKAR1B	178480	764813	769813
NM_004157	chr3	-	48784011	48885283	PRKAR2A	101272	48882783	48887783
NR_109996	chr3	+	48885369	48889415	PRKAR2A-AS1	4046	48882869	48887869
NM_002736	chr7	+	106685177	106802256	PRKAR2B	117079	106682677	106687677
NM_002737	chr17	+	64298925	64806862	PRKCA	507937	64296425	64301425
NR_110822	chr17	-	64394186	64412972	PRKCA-AS1	18786	64410472	64415472
NM_212535	chr16	+	23847299	24231932	PRKCB	384633	23844799	23849799
NM_212539	chr3	+	53195222	53226733	PRKCD	31511	53192722	53197722
NM_005400	chr2	+	45879042	46415129	PRKCE	536087	45876542	45881542
NM_001316329	chr19	+	54385437	54410901	PRKCG	25464	54382937	54387937
NM_006255	chr14	+	61788160	62017698	PRKCH	229538	61785660	61790660
NM_002740	chr3	+	169940219	170023770	PRKCI	83551	169937719	169942719
NM_001323267	chr10	-	6436058	6622263	PRKCQ	186205	6619763	6624763
NR_036502	chr10	+	6622386	6627323	PRKCQ-AS1	4937	6619886	6624886
NM_001289104	chr19	+	11546077	11561782	PRKCSH	15705	11543577	11548577
NM_002744	chr1	+	1981908	2116838	PRKCZ	134930	1979408	1984408
NM_001330069	chr14	-	30045685	30396948	PRKD1	351263	30394448	30399448
NM_016457	chr19	-	47177572	47220384	PRKD2	42812	47217884	47222884
NM_005813	chr2	-	37477645	37544222	PRKD3	66577	37541722	37546722
NM_006904	chr8	-	48685668	48872743	PRKDC	187075	48870243	48875243
NM_001098512	chr10	+	52750910	54058110	PRKG1	1307200	52748410	52753410
NR_038277	chr10	-	54056607	54073888	PRKG1-AS1	17281	54071388	54076388
NM_001282485	chr4	-	82008523	82136271	PRKG2	127748	82133771	82138771
NM_013988	chr6	-	161768589	163148834	PRKN	1380245	163146334	163151334
NM_001316362	chr2	-	179296140	179315967	PRKRA	19827	179313467	179318467
NM_024653	chr7	+	102036803	102067129	PRKRIP1	30326	102034303	102039303
NM_005044	chrX	-	3522383	3631675	PRKX	109292	3629175	3634175
NR_046643	chrX	+	3577527	3586231	PRKX-AS1	8704	3575027	3580027
NR_073405	chr15	-	101087956	101099488	PRKXP1	11532	101096988	101101988
NR_028062	chrY	+	7142012	7249588	PRKY	107576	7139512	7144512
NM_001163558	chr6	-	22287472	22303082	PRL	15610	22300582	22305582
NM_000949	chr5	-	35055801	35230691	PRLR	174890	35228191	35233191
NM_001207042	chr19	+	50180408	50191707	PRMT1	11299	50177908	50182908
NM_001242864	chr21	+	48055506	48085036	PRMT2	29530	48053006	48058006
NM_001145166	chr11	+	20409075	20530879	PRMT3	121804	20406575	20411575
NM_006109	chr14	-	23389719	23398794	PRMT5	9075	23396294	23401294
NR_120599	chr14	+	23388664	23392616	PRMT5-AS1	3952	23386164	23391164
NM_018137	chr1	+	107599266	107601916	PRMT6	2650	107596766	107601766
NM_001351143	chr16	+	68344853	68392466	PRMT7	47613	68342353	68347353
NM_001256536	chr12	+	3490514	3703138	PRMT8	212624	3488014	3493014
NM_001350144	chr4	-	148558935	148605381	PRMT9	46446	148602881	148607881
NR_109833	chr8	+	128092118	128104840	PRNCR1	12722	128089618	128094618
NM_012409	chr20	+	4702499	4709108	PRND	6609	4699999	4704999
NM_001271561	chr20	+	4666739	4682236	PRNP	15497	4664239	4669239
NR_024267	chr20	-	4711927	4721314	PRNT	9387	4718814	4723814
NM_001161546	chr5	-	138727634	138730885	PROB1	3251	138728385	138733385
NM_000312	chr2	+	128175995	128186822	PROC	10827	128173495	128178495
NM_001304951	chr17	-	27030214	27038925	PROCA1	8711	27036425	27041425
NM_006404	chr20	+	33759739	33765165	PROCR	5426	33757239	33762239
NM_016335	chr22	-	18900286	18924066	PRODH	23780	18921566	18926566
NM_021232	chr19	-	36290891	36304201	PRODH2	13310	36301701	36306701
NM_032414	chr1	+	110993787	110999976	PROK1	6189	110991287	110996287
NM_021935	chr3	-	71820805	71834357	PROK2	13552	71831857	71836857
NM_138964	chr2	+	68870719	68882708	PROKR1	11989	68868219	68873219
NM_144773	chr20	-	5281845	5297378	PROKR2	15533	5294878	5299878
NM_001145848	chr4	-	15969848	16085623	PROM1	115775	16083123	16088123
NM_001321070	chr2	+	95940195	95957055	PROM2	16860	95937695	95942695
NM_006261	chr5	-	177419235	177423243	PROP1	4008	177420743	177425743
NM_001282471	chrY	-	23544859	23548246	PRORY	3387	23545746	23550746
NM_000313	chr3	-	93591880	93692934	PROS1	101054	93690434	93695434
NM_025138	chr13	-	39584001	39612213	PROSER1	28212	39609713	39614713
NM_153256	chr10	+	11865396	11914276	PROSER2	48880	11862896	11867896
NR_038222	chr10	-	11891606	11936709	PROSER2-AS1	45103	11934209	11939209
NM_001039887	chr19	+	36249043	36260077	PROSER3	11034	36246543	36251543
NM_001270616	chr1	+	214161277	214214847	PROX1	53570	214158777	214163777
NR_037850	chr1	-	213992983	214159496	PROX1-AS1	166513	214156996	214161996
NM_001243007	chr14	-	75319735	75330537	PROX2	10802	75328037	75333037
NM_001256134	chr13	+	113812967	113826698	PROZ	13731	113810467	113815467
NM_003675	chr10	+	13628938	13672868	PRPF18	43930	13626438	13631438
NM_014502	chr11	-	60658019	60674061	PRPF19	16042	60671561	60676561
NM_004698	chr1	+	150293916	150325704	PRPF3	31788	150291416	150296416
NM_015629	chr19	+	54618789	54635150	PRPF31	16361	54616289	54621289
NM_032864	chr1	+	52870218	52883992	PRPF38A	13774	52867718	52872718
NM_018061	chr1	+	109234931	109245552	PRPF38B	10621	109232431	109237431
NM_017922	chr14	+	45553301	45584804	PRPF39	31503	45550801	45555801
NM_001322267	chr9	+	116037913	116055185	PRPF4	17272	116035413	116040413
NM_017892	chr2	-	153508106	153573975	PRPF40A	65869	153571475	153576475
NM_001031698	chr12	+	50017196	50038452	PRPF40B	21256	50014696	50019696
NM_003913	chr6	+	4021568	4065217	PRPF4B	43649	4019068	4024068
NM_012469	chr20	+	62612430	62664453	PRPF6	52023	62609930	62614930
NM_006445	chr17	-	1553922	1588176	PRPF8	34254	1585676	1590676
NM_006262	chr12	+	49688908	49692481	PRPH	3573	49686408	49691408
NM_000322	chr6	-	42664332	42690358	PRPH2	26026	42687858	42692858
NM_001204402	chrX	+	106871653	106894256	PRPS1	22603	106869153	106874153
NM_002765	chrX	+	12809473	12842346	PRPS2	32873	12806973	12811973
NM_001330503	chr17	-	74306816	74350230	PRPSAP1	43414	74347730	74352730
NM_001243936	chr17	+	18759611	18834599	PRPSAP2	74988	18757111	18762111
NM_018304	chr17	+	57232859	57284070	PRR11	51211	57230359	57235359
NM_020719	chr19	+	50094899	50129696	PRR12	34797	50092399	50097399
NM_018457	chr12	+	53835432	53840427	PRR13	4995	53832932	53837932
NM_001320464	chr16	+	30662022	30667761	PRR14	5739	30659522	30664522
NM_173566	chr22	-	32077333	32146120	PRR14L	68787	32143620	32148620
NM_175887	chr7	+	29603426	29606911	PRR15	3485	29600926	29605926
NM_024320	chr17	-	46029333	46035243	PRR15L	5910	46032743	46037743
NM_016644	chr5	+	119799972	120023025	PRR16	223053	119797472	119802472
NM_175922	chr6	-	166719167	166721871	PRR18	2704	166719371	166724371
NM_199285	chr19	+	42806283	42814973	PRR19	8690	42803783	42808783
NM_198441	chr13	+	57715051	57718073	PRR20A	3022	57712551	57717551
NM_001130404	chr13	+	57728194	57731216	PRR20B	3022	57725694	57730694
NM_001130405	chr13	+	57715051	57718073	PRR20C	3022	57712551	57717551
NM_001130406	chr13	+	57721621	57724643	PRR20D	3022	57719121	57724121
NM_001130407	chr13	+	57728194	57731216	PRR20E	3022	57725694	57730694
NM_001134657	chr3	-	138760943	138763734	PRR23C	2791	138761234	138766234
NM_001282479	chr8	+	7397148	7399972	PRR23D1	2824	7394648	7399648
NM_001282478	chr8	+	7397149	7399972	PRR23D2	2823	7394649	7399649
NM_001013638	chr16	+	855442	863861	PRR25	8419	852942	857942
NR_027152	chr10	+	696016	711109	PRR26	15093	693516	698516
NM_214711	chr4	+	71019903	71032326	PRR27	12423	71017403	71022403
NM_001191030	chr17	+	62075710	62081644	PRR29	5934	62073210	62078210
NR_126169	chr17	-	62073430	62077259	PRR29-AS1	3829	62074759	62079759
NM_025263	chr6	+	30524485	30532473	PRR3	7988	30521985	30526985
NM_178553	chr2	-	27359714	27362332	PRR30	2618	27359832	27364832
NM_001351145	chr9	+	139863819	139867336	PRR31	3517	139861319	139866319
NM_018280	chr22	-	46446338	46450024	PRR34	3686	46447524	46452524
NR_027034	chr22	+	46449725	46454402	PRR34-AS1	4677	46447225	46452225
NM_145270	chr16	+	610421	615529	PRR35	5108	607921	612921
NM_001190467	chr19	-	7933604	7939326	PRR36	5722	7936826	7941826
NM_007244	chr12	-	10998447	11002075	PRR4	3628	10999575	11004575
NM_001017529	chr22	+	45064426	45133561	PRR5	69135	45061926	45066926
NM_181334	chr22	+	45098077	45258664	PRR5-ARHGAP8	160587	45095577	45100577
NM_001160167	chr11	+	36317724	36486754	PRR5L	169030	36315224	36320224
NM_001174101	chr5	+	176873795	176883287	PRR7	9492	176871295	176876295
NR_038915	chr5	-	176864889	176874945	PRR7-AS1	10056	176872445	176877445
NM_001286808	chr5	+	126853300	126890780	PRRC1	37480	126850800	126855800
NM_004638	chr6	+	31588449	31605554	PRRC2A	17105	31585949	31590949
NM_013318	chr9	+	134305476	134375575	PRRC2B	70099	134302976	134307976
NM_015172	chr1	+	171454665	171562650	PRRC2C	107985	171452165	171457165
NM_000950	chrX	+	37208527	37316548	PRRG1	108021	37206027	37211027
NM_001316335	chr19	+	50084586	50094265	PRRG2	9679	50082086	50087086
NM_024082	chrX	+	150863729	150870063	PRRG3	6334	150861229	150866229
NM_024081	chr11	+	32851480	32879669	PRRG4	28189	32848980	32853980
NM_030651	chr6	-	32116139	32119720	PRRT1	3581	32117220	32122220
NM_145239	chr16	+	29823408	29827202	PRRT2	3794	29820908	29825908
NM_207351	chr3	-	9987225	9994099	PRRT3	6874	9991599	9996599
NR_046734	chr3	+	9989087	9996471	PRRT3-AS1	7384	9986587	9991587
NM_001174164	chr7	-	127990378	128001739	PRRT4	11361	127999239	128004239
NM_022716	chr1	+	170633312	170708541	PRRX1	75229	170630812	170635812
NM_016307	chr9	+	132427919	132484951	PRRX2	57032	132425419	132430419
NR_132102	chr9	-	132475172	132480985	PRRX2-AS1	5813	132478485	132483485
NM_002769	chr7	+	142457318	142460927	PRSS1	3609	142454818	142459818
NM_003619	chr4	-	119201192	119273922	PRSS12	72730	119271422	119276422
NM_005865	chr6	+	27215501	27224399	PRSS16	8898	27213001	27218001
NM_001270452	chr16	+	2867163	2871723	PRSS21	4560	2864663	2869663
NM_022119	chr16	-	2902727	2908171	PRSS22	5444	2905671	2910671
NR_120592	chr11	+	86511281	86663945	PRSS23	152664	86508781	86513781
NM_001318395	chr16	-	2762418	2770552	PRSS27	8134	2768052	2773052
NM_007343	chr9	+	33750463	33799229	PRSS3	48766	33747963	33752963
NR_026864	chr16	-	2889573	2892752	PRSS30P	3179	2890252	2895252
NM_152891	chr16	-	2833953	2836708	PRSS33	2755	2834208	2839208
NM_153362	chr6	+	84222193	84235421	PRSS35	13228	84219693	84224693
NM_001258291	chr16	-	31150246	31161415	PRSS36	11169	31158915	31163915
NM_001171951	chr7	-	141536077	141541221	PRSS37	5144	141538721	141543721
NM_183062	chr1	+	228003417	228034171	PRSS38	30754	228000917	228005917
NR_001296	chr7	+	142478756	142482399	PRSS3P2	3643	142476256	142481256
NM_001135086	chr16	+	2848485	2855133	PRSS41	6648	2845985	2850985
NM_182702	chr3	-	46871032	46875585	PRSS42	4553	46873085	46878085
NM_199183	chr3	-	46783580	46786245	PRSS45	2665	46783745	46788745
NR_147121	chr3	-	46761072	46777917	PRSS46	16845	46775417	46780417
NM_001350291	chr9	-	94946613	94953438	PRSS47	6825	94950938	94955938
NM_183375	chr4	+	152198324	152212605	PRSS48	14281	152195824	152200824
NM_013270	chr3	-	46753605	46759373	PRSS50	5768	46756873	46761873
NM_001039503	chr16	-	31094744	31100130	PRSS53	5386	31097630	31102630
NM_001080492	chr16	-	58313900	58328951	PRSS54	15051	58326451	58331451
NM_001197020	chr8	+	10383055	10411676	PRSS55	28621	10380555	10385555
NM_001195129	chr2	+	233385172	233390425	PRSS56	5253	233382672	233387672
NM_001308209	chr19	-	685520	695461	PRSS57	9941	692961	697961
NM_001001317	chr7	-	141951957	141957878	PRSS58	5921	141955378	141960378
NM_002773	chr16	-	31142753	31147083	PRSS8	4330	31144583	31149583
NM_001282786	chr10	-	25137535	25241573	PRTFDC1	104038	25239073	25244073
NM_173814	chr15	-	55903738	56035317	PRTG	131579	56032817	56037817
NM_002777	chr19	+	840984	848175	PRTN3	7191	838484	843484
NR_130132	chr1	+	150980866	151008189	PRUNE1	27323	150978366	150983366
NR_131751	chr9	-	79226291	79521003	PRUNE2	294712	79518503	79523503
NM_020956	chr19	-	40899670	40919271	PRX	19601	40916771	40921771
NM_004676	chrY	-	24217902	24242154	PRY	24252	24239654	24244654
NM_001002758	chrY	-	24217902	24242154	PRY2	24252	24239654	24244654
NM_002778	chr10	-	73576039	73611132	PSAP	35093	73608632	73613632
NM_001085382	chr4	-	7432020	7436700	PSAPL1	4680	7434200	7439200
NM_058179	chr9	+	80911990	80945009	PSAT1	33019	80909490	80914490
NR_033343	chr8	+	143751725	143764145	PSCA	12420	143749225	143754225
NM_001270965	chr10	-	104162373	104179691	PSD	17318	104177191	104182191
NM_032289	chr5	+	139175405	139224052	PSD2	48647	139172905	139177905
NR_105053	chr5	-	139120931	139125808	PSD2-AS1	4877	139123308	139128308
NM_015310	chr8	-	18384812	18871196	PSD3	486384	18868696	18873696
NM_012455	chr2	+	113931559	113960677	PSD4	29118	113929059	113934059
NM_007318	chr14	+	73603142	73690399	PSEN1	87257	73600642	73605642
NM_000447	chr1	+	227058272	227083804	PSEN2	25532	227055772	227060772
NM_001330524	chr19	-	43370612	43383974	PSG1	13362	43381474	43386474
NR_026824	chr19	-	43341148	43359870	PSG10P	18722	43357370	43362370
NM_203287	chr19	-	43511808	43530631	PSG11	18823	43528131	43533131
NM_031246	chr19	-	43568361	43586893	PSG2	18532	43584393	43589393
NM_021016	chr19	-	43225793	43244668	PSG3	18875	43242168	43247168
NM_213633	chr19	-	43696853	43709926	PSG4	13073	43707426	43712426
NM_002781	chr19	-	43671894	43690688	PSG5	18794	43688188	43693188
NM_001031850	chr19	-	43406233	43422076	PSG6	15843	43419576	43424576
NM_001290042	chr19	-	43428283	43441330	PSG7	13047	43438830	43443830
NM_001130168	chr19	-	43256838	43269831	PSG8	12993	43267331	43272331
NR_036584	chr19	+	43326014	43331030	PSG8-AS1	5016	43323514	43328514
NM_002784	chr19	-	43757433	43773715	PSG9	16282	43771215	43776215
NM_001128217	chr9	-	15464064	15511017	PSIP1	46953	15508517	15513517
NM_006742	chr16	+	67927174	67963581	PSKH1	36407	67924674	67929674
NM_033126	chr8	-	87059339	87081926	PSKH2	22587	87079426	87084426
NM_148976	chr11	-	14526421	14665180	PSMA1	138759	14662680	14667680
NM_002787	chr7	-	42956461	42971805	PSMA2	15344	42969305	42974305
NM_152132	chr14	+	58711522	58738727	PSMA3	27205	58709022	58714022
NR_029434	chr14	-	58732082	58764855	PSMA3-AS1	32773	58762355	58767355
NM_001102667	chr15	+	78832746	78841604	PSMA4	8858	78830246	78835246
NM_001199774	chr1	-	109941652	109969108	PSMA5	27456	109966608	109971608
NM_001282234	chr14	+	35747763	35786685	PSMA6	38922	35745263	35750263
NM_002792	chr20	-	60711782	60718514	PSMA7	6732	60716014	60721014
NM_001308188	chr18	+	23713810	23773319	PSMA8	59509	23711310	23716310
NM_002793	chr6	-	170844203	170862417	PSMB1	18214	170859917	170864917
NM_002794	chr1	-	36065142	36107445	PSMB2	42303	36104945	36109945
NR_104195	chr17	+	36908965	36920484	PSMB3	11519	36906465	36911465
NM_001130725	chr14	-	23495059	23504429	PSMB5	9370	23501929	23506929
NM_002799	chr9	-	127115743	127177752	PSMB7	62009	127175252	127180252
NM_004159	chr6	-	32808493	32812712	PSMB8	4219	32810212	32815212
NM_002800	chr6_cox_hap2	+	4266465	4272158	PSMB9	5693	4263965	4268965
NM_002802	chr14	+	90722893	90738966	PSMC1	16073	90720393	90725393
NM_002803	chr7	+	102987970	103009842	PSMC2	21872	102985470	102990470
NM_002804	chr11	-	47440319	47448024	PSMC3	7705	47445524	47450524
NR_045669	chr17	-	40724327	40729849	PSMC3IP	5522	40727349	40732349
NM_153001	chr19	+	40476911	40487671	PSMC4	10760	40474411	40479411
NM_002805	chr17	+	61904769	61909387	PSMC5	4618	61902269	61907269
NM_002806	chr14	+	53173895	53194716	PSMC6	20821	53171395	53176395
NR_034059	chr2	+	231921577	232037540	PSMD1	115963	231919077	231924077
NM_170750	chrX	-	107327434	107334874	PSMD10	7440	107332374	107337374
NM_001270482	chr17	+	30771480	30810337	PSMD11	38857	30768980	30773980
NM_174871	chr17	-	65334031	65362743	PSMD12	28712	65360243	65365243
NM_002817	chr11	+	236807	252984	PSMD13	16177	234307	239307
NM_005805	chr2	+	162164785	162268228	PSMD14	103443	162162285	162167285
NM_002808	chr3	+	184016885	184026842	PSMD2	9957	184014385	184019385
NM_002809	chr17	+	38137020	38154213	PSMD3	17193	38134520	38139520
NM_001330692	chr1	+	151227175	151239954	PSMD4	12779	151224675	151229675
NM_001270427	chr9	-	123578331	123605299	PSMD5	26968	123602799	123607799
NR_024408	chr9	+	123605319	123616651	PSMD5-AS1	11332	123602819	123607819
NM_001271780	chr3	-	63996224	64009686	PSMD6	13462	64007186	64012186
NR_038286	chr3	+	63989697	63997917	PSMD6-AS2	8220	63987197	63992197
NM_002811	chr16	+	74330672	74340186	PSMD7	9514	74328172	74333172
NM_002812	chr19	+	38865189	38874464	PSMD8	9275	38862689	38867689
NM_001261400	chr12	+	122326636	122355771	PSMD9	29135	122324136	122329136
NM_176783	chr14	+	24605366	24608176	PSME1	2810	24602866	24607866
NM_002818	chr14	-	24612573	24615855	PSME2	3282	24613355	24618355
NR_049772	chr17	+	40985158	40995777	PSME3	10619	40982658	40987658
NM_014614	chr2	-	54091203	54197977	PSME4	106774	54195477	54200477
NM_001323407	chr20	+	1093871	1152890	PSMF1	59019	1091371	1096371
NM_001261824	chr21	-	40547371	40555440	PSMG1	8069	40552940	40557940
NM_147163	chr18	+	12658737	12725739	PSMG2	67002	12656237	12661237
NM_001134340	chr7	-	1606969	1609668	PSMG3	2699	1607168	1612168
NR_027329	chr7	+	1609708	1629261	PSMG3-AS1	19553	1607208	1612208
NM_001128591	chr6	+	3259161	3268300	PSMG4	9139	3256661	3261661
NM_014068	chr6_qbl_hap6	+	2378425	2403713	PSORS1C1	25288	2375925	2380925
NR_026816	chr6_mcf_hap5	-	2523452	2527623	PSORS1C3	4171	2525123	2530123
NR_044998	chr13	-	20248891	20357159	PSPC1	108268	20354659	20359659
NM_004577	chr7	-	56078743	56119268	PSPH	40525	56116768	56121768
NM_032636	chr1	-	109822175	109825790	PSRC1	3615	109823290	109828290
NM_153336	chr10	+	124739555	124749907	PSTK	10352	124737055	124742055
NM_001321137	chr15	+	77287020	77329816	PSTPIP1	42796	77284520	77289520
NM_024430	chr18	-	43563501	43652250	PSTPIP2	88749	43649750	43654750
NM_001164722	chr1	-	28473676	28520447	PTAFR	46771	28517947	28522947
NM_001099666	chr9	-	72324437	72374876	PTAR1	50439	72372376	72377376
NM_031990	chr19	+	797391	812327	PTBP1	14936	794891	799891
NM_001300989	chr1	+	97187160	97280605	PTBP2	93445	97184660	97189660
NM_001244897	chr9	-	114979994	115095944	PTBP3	115950	115093444	115098444
NM_015545	chr7	-	99014361	99036462	PTCD1	22101	99033962	99038962
NM_001284404	chr5	+	71616193	71655180	PTCD2	38987	71613693	71618693
NM_017952	chr2	+	86333304	86369280	PTCD3	35976	86330804	86335804
NM_001083602	chr9	-	98205263	98279247	PTCH1	73984	98276747	98281747
NM_001166292	chr1	-	45285515	45308616	PTCH2	23101	45306116	45311116
NM_173495	chrX	+	23352984	23414918	PTCHD1	61934	23350484	23355484
NR_073010	chrX	-	22211121	23311263	PTCHD1-AS	1100142	23308763	23313763
NM_001034842	chr10	-	27687116	27703297	PTCHD3	16181	27700797	27705797
NM_001013732	chr6	-	47845763	48036425	PTCHD4	190662	48033925	48038925
NM_138296	chr6	+	42883726	42893575	PTCRA	9849	42881226	42886226
NR_146773	chr8	+	134067203	134070012	PTCSC1	2809	134064703	134069703
NR_147055	chr9	-	100461906	100615362	PTCSC2	153456	100612862	100617862
NR_049735	chr14	-	36604915	36645857	PTCSC3	40942	36643357	36648357
NM_001290225	chr8	+	97274113	97346779	PTDSS1	72666	97271613	97276613
NM_001329548	chr11	+	448267	491400	PTDSS2	43133	445767	450767
NM_001304717	chr10	+	89623194	89731687	PTEN	108493	89620694	89625694
NR_023917	chr9	-	33673501	33677418	PTENP1	3917	33674918	33679918
NR_103745	chr9	+	33677265	33688008	PTENP1-AS	10743	33674765	33679765
NM_001261837	chr10	+	16478941	16555744	PTER	76803	16476441	16481441
NM_001281469	chr14	+	52734430	52743442	PTGDR	9012	52731930	52736930
NM_004778	chr11	-	60618397	60623444	PTGDR2	5047	60620944	60625944
NM_000954	chr9	+	139871955	139876194	PTGDS	4239	139869455	139874455
NM_000955	chr19	-	14583277	14586174	PTGER1	2897	14583674	14588674
NM_000956	chr14	+	52781015	52795322	PTGER2	14307	52778515	52783515
NM_198717	chr1	-	71318035	71513491	PTGER3	195456	71510991	71515991
NM_000958	chr5	+	40680031	40693837	PTGER4	13806	40677531	40682531
NR_024496	chr9	+	66494268	66503030	PTGER4P2-CDK2AP2P2	8762	66491768	66496768
NM_004878	chr9	-	132500614	132515344	PTGES	14730	132512844	132517844
NM_198938	chr9	-	130882971	130890741	PTGES2	7770	130888241	130893241
NM_001282601	chr12	-	57057124	57082192	PTGES3	25068	57079692	57084692
NM_001142654	chr17	-	41120104	41132545	PTGES3L	12441	41130045	41135045
NM_001136042	chr17	-	41102542	41132545	PTGES3L-AARSD1	30003	41130045	41135045
NM_000959	chr1	+	78956727	79006386	PTGFR	49659	78954227	78959227
NM_020440	chr1	+	117452544	117532980	PTGFRN	80436	117450044	117455044
NM_000960	chr19	-	47123724	47128354	PTGIR	4630	47125854	47130854
NM_000961	chr20	-	48120410	48184707	PTGIS	64297	48182207	48187207
NM_001146109	chr9	-	114312001	114362135	PTGR1	50134	114359635	114364635
NM_001146154	chr14	+	74318533	74352168	PTGR2	33635	74316033	74321033
NM_001271368	chr9	+	125132808	125157982	PTGS1	25174	125130308	125135308
NM_000963	chr1	-	186640943	186649559	PTGS2	8616	186647059	186652059
NM_001316352	chr11	-	13513591	13517722	PTH	4131	13515222	13520222
NM_000316	chr3	+	46919235	46945289	PTH1R	26054	46916735	46921735
NM_001309516	chr2	+	209224568	209359231	PTH2R	134663	209222068	209227068
NM_198965	chr12	-	28111016	28124916	PTHLH	13900	28122416	28127416
NM_001352699	chr8	-	141668480	142012178	PTK2	343698	142009678	142014678
NM_173174	chr8	+	27168998	27316908	PTK2B	147910	27166498	27171498
NM_001256358	chr20	-	62159775	62168723	PTK6	8948	62166223	62171223
NM_152882	chr6	+	43044005	43129458	PTK7	85453	43041505	43046505
NM_001099285	chr2	+	232573234	232578250	PTMA	5016	232570734	232575734
NM_002824	chr12	+	6875482	6880118	PTMS	4636	6872982	6877982
NM_001321387	chr7	-	136912091	137028736	PTN	116645	137026236	137031236
NR_130963	chr19	+	50353991	50364001	PTOV1	10010	50351491	50356491
NR_040037	chr19	-	50341902	50354933	PTOV1-AS1	13031	50352433	50357433
NR_110730	chr19	-	50359721	50362546	PTOV1-AS2	2825	50360046	50365046
NM_003463	chr6	+	64281916	64293493	PTP4A1	11577	64279416	64284416
NM_080391	chr1	-	32372021	32403988	PTP4A2	31967	32401488	32406488
NM_032611	chr8	+	142431487	142442554	PTP4A3	11067	142428987	142433987
NM_021131	chr9	+	131873227	131911225	PTPA	37998	131870727	131875727
NM_177995	chr9	+	96793075	96872138	PTPDC1	79063	96790575	96795575
NM_175732	chr11	+	47586981	47595013	PTPMT1	8032	47584481	47589481
NM_002827	chr20	+	49126857	49201300	PTPN1	74443	49124357	49129357
NM_002834	chr12	+	112856701	112947722	PTPN11	91021	112854201	112859201
NM_002835	chr7	+	77166772	77269388	PTPN12	102616	77164272	77169272
NM_006264	chr4	+	87515467	87736328	PTPN13	220861	87512967	87517967
NM_005401	chr1	-	214522038	214725024	PTPN14	202986	214722524	214727524
NM_014369	chr2	+	131113579	131132982	PTPN18	19403	131111079	131116079
NM_001207013	chr18	-	12785476	12884334	PTPN2	98858	12881834	12886834
NM_015605	chr10	-	48737041	48827966	PTPN20	90925	48825466	48830466
NM_007039	chr14	-	88932121	89021123	PTPN21	89002	89018623	89023623
NM_012411	chr1	-	114356432	114414381	PTPN22	57949	114411881	114416881
NM_015466	chr3	+	47422471	47454931	PTPN23	32460	47419971	47424971
NM_001145368	chr9	-	112137973	112260593	PTPN3	122620	112258093	112263093
NM_002830	chr2	+	120517206	120742474	PTPN4	225268	120514706	120519706
NM_001278236	chr11	-	18749474	18814268	PTPN5	64794	18811768	18816768
NM_080548	chr12	+	7055739	7070479	PTPN6	14740	7053239	7058239
NM_001199797	chr1	-	202116140	202130716	PTPN7	14576	202128216	202133216
NM_002833	chr15	-	75759461	75871632	PTPN9	112171	75869132	75874132
NM_002836	chr20	+	2844840	3019315	PTPRA	174475	2842340	2847340
NM_001330204	chr12	-	70909650	71031220	PTPRB	121570	71028720	71033720
NM_002838	chr1	+	198608097	198726605	PTPRC	118508	198605597	198610597
NM_002839	chr9	-	8314245	10612723	PTPRD	2298478	10610223	10615223
NR_121600	chr9	+	8858017	8861727	PTPRD-AS1	3710	8855517	8860517
NR_110696	chr9	+	10613205	10620420	PTPRD-AS2	7215	10610705	10615705
NM_001323355	chr10	+	129705324	129884119	PTPRE	178795	129702824	129707824
NM_001329137	chr1	+	43991707	44089343	PTPRF	97636	43989207	43994207
NM_002841	chr3	+	61547242	62280573	PTPRG	733331	61544742	61549742
NR_038281	chr3	-	62247493	62304622	PTPRG-AS1	57129	62302122	62307122
NM_002842	chr19	-	55692614	55720874	PTPRH	28260	55718374	55723374
NM_002843	chr11	+	48002109	48192394	PTPRJ	190285	47999609	48004609
NM_001291984	chr6	-	128289923	128841819	PTPRK	551896	128839319	128844319
NM_002845	chr18	+	7567313	8406859	PTPRM	839546	7564813	7569813
NM_002846	chr2	-	220154344	220174295	PTPRN	19951	220171795	220176795
NM_130843	chr7	-	157331745	158380494	PTPRN2	1048749	158377994	158382994
NM_002848	chr12	+	15475190	15751265	PTPRO	276075	15472690	15477690
NM_001145026	chr12	+	80838125	81073968	PTPRQ	235843	80835625	80840625
NM_002849	chr12	-	71031852	71314584	PTPRR	282732	71312084	71317084
NM_002850	chr19	-	5205518	5340814	PTPRS	135296	5338314	5343314
NM_133170	chr20	-	40701391	41818557	PTPRT	1117166	41816057	41821057
NM_005704	chr1	+	29563027	29653325	PTPRU	90298	29560527	29565527
NR_002930	chr1	+	202137178	202158577	PTPRVP	21399	202134678	202139678
NM_001206838	chr7	+	121513158	121702090	PTPRZ1	188932	121510658	121515658
NM_016077	chr17	-	57774666	57784959	PTRH2	10293	57782459	57787459
NM_001013663	chr2	-	25013135	25016251	PTRHD1	3116	25013751	25018751
NM_000317	chr11	+	112097087	112104695	PTS	7608	112094587	112099587
NM_004219	chr5	+	159848813	159855751	PTTG1	6938	159846313	159851313
NM_004339	chr21	-	46269499	46293818	PTTG1IP	24319	46291318	46296318
NM_002852	chr3	+	157154579	157161417	PTX3	6838	157152079	157157079
NM_001328608	chr16	-	1535939	1538910	PTX4	2971	1536410	1541410
NM_001178136	chrX	-	6966960	7066231	PUDP	99271	7063731	7068731
NM_001271097	chr8	-	144898513	144911556	PUF60	13043	144909056	144914056
NM_014676	chr1	-	31404352	31538564	PUM1	134212	31536064	31541064
NM_001352920	chr2	-	20448451	20552189	PUM2	103738	20549689	20554689
NM_014878	chr9	-	2804154	2844130	PUM3	39976	2841630	2846630
NM_005859	chr5	+	139493707	139499001	PURA	5294	139491207	139496207
NM_033224	chr7	-	44915891	44924984	PURB	9093	44922484	44927484
NM_001015508	chr8	-	30853317	30891231	PURG	37914	30888731	30893731
NM_001002020	chr12	+	132413744	132428406	PUS1	14662	132411244	132416244
NM_001322127	chr2	-	61167547	61245394	PUS10	77847	61242894	61247894
NM_001271985	chr11	-	125763379	125773116	PUS3	9737	125770616	125775616
NM_019042	chr7	-	105096947	105162705	PUS7	65758	105160205	105165205
NM_001271826	chr12	-	44122409	44152620	PUS7L	30211	44150120	44155120
NM_153339	chr1	+	1243959	1247057	PUSL1	3098	1241459	1246459
NM_002854	chr22	-	37196744	37215517	PVALB	18773	37213017	37218017
NR_027255	chr17	+	79139306	79156964	PVALEF	17658	79136806	79141806
NM_001135768	chr19	+	45147097	45169428	PVR	22331	45144597	45149597
NR_003367	chr8	+	128806778	129113499	PVT1	306721	128804278	128809278
NR_022008	chr15	+	25230006	25233379	PWAR5	3373	25227506	25232506
NR_146168	chr15	+	25277019	25281635	PWAR6	4616	25274519	25279519
NM_001317963	chr12	+	108079508	108106939	PWP1	27431	108077008	108082008
NM_005049	chr21	+	45527207	45551063	PWP2	23856	45524707	45529707
NR_026646	chr15	+	24803303	24832926	PWRN1	29623	24800803	24805803
NR_026647	chr15	-	24409925	24415053	PWRN2	5128	24412553	24417553
NR_130780	chr15	+	24686273	24693114	PWRN3	6841	24683773	24688773
NR_126392	chr15	+	24220293	24333301	PWRN4	113008	24217793	24222793
NM_001267035	chr5	-	159502884	159546452	PWWP2A	43568	159543952	159548952
NM_138499	chr10	+	134210701	134231358	PWWP2B	20657	134208201	134213201
NM_183373	chr6	-	3722835	3752246	PXDC1	29411	3749746	3754746
NM_012293	chr2	-	1635658	1748319	PXDN	112661	1745819	1750819
NM_144651	chr8	-	52232136	52722005	PXDNL	489869	52719505	52724505
NM_001289101	chr3	+	58318616	58411854	PXK	93238	58316116	58321116
NM_018663	chr12	+	133264191	133281577	PXMP2	17386	133261691	133266691
NM_183397	chr20	-	32290549	32308136	PXMP4	17587	32305636	32310636
NM_001080855	chr12	-	120648241	120703574	PXN	55333	120701074	120706074
NR_038924	chr12	+	120639093	120650631	PXN-AS1	11538	120636593	120641593
NM_152990	chr6	-	36358328	36410666	PXT1	52338	36408166	36413166
NM_152282	chr3	+	140950666	141013745	PXYLP1	63079	140948166	140953166
NM_001282280	chr17	-	79890261	79895204	PYCR1	4943	79892704	79897704
NM_013328	chr1	-	226107576	226112040	PYCR2	4464	226109540	226114540
NM_023078	chr8	-	144685393	144691784	PYCR3	6391	144689284	144694284
NM_002862	chr20	+	25228705	25278648	PYGB	49943	25226205	25231205
NM_002863	chr14	-	51371934	51411248	PYGL	39314	51408748	51413748
NM_001164716	chr11	-	64513860	64528187	PYGM	14327	64525687	64530687
NM_015617	chr15	-	55831084	55881050	PYGO1	49966	55878550	55883550
NM_138300	chr1	-	154929501	154934258	PYGO2	4757	154931758	154936758
NM_152501	chr1	+	158901336	158946849	PYHIN1	45513	158898836	158903836
NM_032345	chr12	-	56295196	56321697	PYM1	26501	56319197	56324197
NM_001350913	chr12	+	21590537	21624186	PYROXD1	33649	21588037	21593037
NM_032709	chr10	-	100143321	100174978	PYROXD2	31657	100172478	100177478
NM_032906	chr4	-	89442128	89444952	PYURF	2824	89442452	89447452
NM_004160	chr17	-	42030100	42081837	PYY	51737	42079337	42084337
NM_002864	chr12	-	9301435	9360966	PZP	59531	9358466	9363466
NM_005051	chr3	-	49133364	49142562	QARS	9198	49140062	49145062
NM_000320	chr4	-	17488015	17513857	QDPR	25842	17511357	17516357
NM_001301085	chr6	+	163835674	163999628	QKI	163954	163833174	163838174
NM_012413	chr2	+	37571752	37600465	QPCT	28713	37569252	37574252
NM_001163377	chr19	+	46195740	46207248	QPCTL	11508	46193240	46198240
NR_134536	chr16	+	29690328	29710021	QPRT	19693	29687828	29692828
NM_198180	chr9	-	133768814	133772199	QRFP	3385	133769699	133774699
NM_198179	chr4	-	122249796	122302181	QRFPR	52385	122299681	122304681
NM_001320585	chr3	-	49067139	49131806	QRICH1	64667	49129306	49134306
NM_032134	chr17	-	74270129	74303761	QRICH2	33632	74301261	74306261
NM_018292	chr6	+	107077440	107116292	QRSL1	38852	107074940	107079940
NM_001076786	chr11	+	32914723	33001814	QSER1	87091	32912223	32917223
NM_002826	chr1	+	180123967	180167169	QSOX1	43202	180121467	180126467
NM_181701	chr9	-	139098181	139137687	QSOX2	39506	139135187	139140187
NM_031209	chr19	+	10812111	10824043	QTRT1	11932	10809611	10814611
NM_001256836	chr3	+	113775581	113807268	QTRT2	31687	113773081	113778081
NM_001301650	chr8	+	23145604	23153792	R3HCC1	8188	23143104	23148104
NM_014472	chr10	+	99894380	100004654	R3HCC1L	110274	99891880	99896880
NM_015361	chr2	+	136289024	136482840	R3HDM1	193816	136286524	136291524
NM_014925	chr12	-	57647546	57824788	R3HDM2	177242	57822288	57827288
NM_138774	chr19	-	896502	913225	R3HDM4	16723	910725	915725
NM_178491	chr20	+	42965797	42979432	R3HDML	13635	42963297	42968297
NM_016131	chr2	+	26256728	26360323	RAB10	103595	26254228	26259228
NM_001206836	chr15	+	66161796	66184329	RAB11A	22533	66159296	66164296
NM_004218	chr19	+	8455204	8469317	RAB11B	14113	8452704	8457704
NR_038237	chr19	-	8439259	8455575	RAB11B-AS1	16316	8453075	8458075
NM_025151	chr8	-	37716464	37757015	RAB11FIP1	40551	37754515	37759515
NM_001330167	chr10	-	119764426	119806395	RAB11FIP2	41969	119803895	119808895
NM_014700	chr16	+	475667	572481	RAB11FIP3	96814	473167	478167
NM_032932	chr17	+	29718641	29865236	RAB11FIP4	146595	29716141	29721141
NM_015470	chr2	-	73300509	73340146	RAB11FIP5	39637	73337646	73342646
NM_001025300	chr18	+	8609442	8639380	RAB12	29938	8606942	8611942
NM_002870	chr1	-	153954092	153958853	RAB13	4761	153956353	153961353
NM_016322	chr9	-	123940414	123964365	RAB14	23951	123961865	123966865
NM_001330182	chr14	-	65412531	65438921	RAB15	26390	65436421	65441421
NM_022449	chr2	-	238482964	238499769	RAB17	16805	238497269	238502269
NM_021252	chr10	+	27793102	27831166	RAB18	38064	27790602	27795602
NM_001008749	chr7	+	140103842	140126050	RAB19	22208	140101342	140106342
NM_015543	chr2	-	65313987	65357435	RAB1A	43448	65354935	65359935
NM_030981	chr11	+	66036055	66044963	RAB1B	8908	66033555	66038555
NM_017817	chr13	-	111175412	111214084	RAB20	38672	111211584	111216584
NM_014999	chr12	+	72148642	72187256	RAB21	38614	72146142	72151142
NM_020673	chr20	+	56884770	56942563	RAB22A	57793	56882270	56887270
NM_016277	chr6	-	57051790	57087112	RAB23	35322	57084612	57089612
NR_109790	chr5	-	176728190	176730745	RAB24	2555	176728245	176733245
NR_133653	chr1	+	156030939	156040305	RAB25	9366	156028439	156033439
NM_001308053	chr16	+	2198144	2204162	RAB26	6018	2195644	2200644
NM_183235	chr15	-	55495163	55582013	RAB27A	86850	55579513	55584513
NM_004163	chr18	+	52495707	52562747	RAB27B	67040	52493207	52498207
NM_004249	chr4	-	13369346	13485989	RAB28	116643	13483489	13488489
NM_001135663	chr1	-	205737113	205744610	RAB29	7497	205742110	205747110
NM_001242644	chr8	+	61429468	61536203	RAB2A	106735	61426968	61431968
NR_028074	chr14	-	21927178	21945132	RAB2B	17954	21942632	21947632
NM_014488	chr11	-	82684174	82782965	RAB30	98791	82780465	82785465
NM_006868	chr18	+	9708227	9862553	RAB31	154326	9705727	9710727
NM_006834	chr6	+	146864827	146876092	RAB32	11265	146862327	146867327
NM_004794	chrX	+	129305772	129318844	RAB33A	13072	129303272	129308272
NM_031296	chr4	+	140374960	140397069	RAB33B	22109	140372460	140377460
NM_001144943	chr17	-	27041298	27045286	RAB34	3988	27042786	27047786
NM_006861	chr12	-	120532898	120554643	RAB35	21745	120552143	120557143
NM_001349877	chr22	+	23487510	23507830	RAB36	20320	23485010	23490010
NM_175738	chr17	+	72667255	72743474	RAB37	76219	72664755	72669755
NM_022337	chr11	-	87846414	87908635	RAB38	62221	87906135	87911135
NM_017516	chr11	+	107799200	107834208	RAB39A	35008	107796700	107801700
NM_171998	chrX	-	154487518	154493874	RAB39B	6356	154491374	154496374
NM_002866	chr19	-	18307610	18314874	RAB3A	7264	18312374	18317374
NM_002867	chr1	-	52373627	52456436	RAB3B	82809	52453936	52458936
NM_001317915	chr5	+	57878014	58155222	RAB3C	277208	57875514	57880514
NM_004283	chr19	-	11432721	11450344	RAB3D	17623	11447844	11452844
NM_012233	chr2	+	135809834	135928279	RAB3GAP1	118445	135807334	135812334
NM_012414	chr1	-	220321609	220445843	RAB3GAP2	124234	220443343	220448343
NM_001271686	chr11	-	61664767	61687741	RAB3IL1	22974	61685241	61690241
NR_103519	chr12	+	70132465	70216984	RAB3IP	84519	70129965	70134965
NM_080879	chrX	-	102754680	102774417	RAB40A	19737	102771917	102776917
NM_006822	chr17	-	80614942	80656598	RAB40B	41656	80654098	80659098
NM_001172663	chr16	+	639356	679273	RAB40C	39917	636856	641856
NM_001032726	chrX	+	69502021	69504852	RAB41	2831	69499521	69504521
NM_152304	chr1	+	28918711	28921955	RAB42	3244	28916211	28921211
NM_001204883	chr3	-	128806411	128840993	RAB43	34582	128838493	128843493
NM_001257357	chr6	+	36665627	36700960	RAB44	35333	36663127	36668127
NM_004578	chr1	+	229406808	229441640	RAB4A	34832	229404308	229409308
NM_016154	chr19	+	41284123	41302849	RAB4B	18726	41281623	41286623
NR_037791	chr19	+	41284123	41314346	RAB4B-EGLN2	30223	41281623	41286623
NM_004162	chr3	+	19988571	20026667	RAB5A	38096	19986071	19991071
NM_001252036	chr12	+	56367696	56390467	RAB5B	22771	56365196	56370196
NM_004583	chr17	-	40276993	40307062	RAB5C	30069	40304562	40309562
NM_002869	chr11	-	73386682	73472201	RAB6A	85519	73469701	73474701
NM_016577	chr3	-	133543079	133614691	RAB6B	71612	133612191	133617191
NM_032144	chr2	+	130737234	130740311	RAB6C	3077	130734734	130739734
NR_036537	chr2	-	130724164	130738045	RAB6C-AS1	13881	130735545	130740545
NM_004637	chr3	+	128444978	128533641	RAB7A	88663	128442478	128447478
NM_005370	chr19	+	16222489	16244445	RAB8A	21956	16219989	16224989
NM_016530	chr15	+	63481727	63559973	RAB8B	78246	63479227	63484227
NM_001195328	chrX	+	13707239	13727944	RAB9A	20705	13704739	13709739
NR_146558	chrX	-	103031251	103087212	RAB9B	55961	103084712	103089712
NM_006423	chr19	-	42460832	42463528	RABAC1	2696	42461028	42466028
NM_004703	chr17	+	5185557	5289659	RABEP1	104102	5183057	5188057
NM_024816	chr16	-	28915741	28936532	RABEP2	20791	28934032	28939032
NM_001174152	chr9	+	127962820	127996438	RABEPK	33618	127960320	127965320
NM_012197	chr9	+	125703287	125867147	RABGAP1	163860	125700787	125705787
NM_014857	chr1	+	174128551	174927327	RABGAP1L	798776	174126051	174131051
NM_001287060	chr7	+	66147077	66276448	RABGEF1	129371	66144577	66149577
NM_004581	chr14	-	24734743	24740833	RABGGTA	6090	24738333	24743333
NM_004582	chr1	+	76251878	76260775	RABGGTB	8897	76249378	76254378
NM_002871	chr1	-	202847409	202858385	RABIF	10976	202855885	202860885
NM_001306159	chr2	+	114384805	114400975	RABL2A	16170	114382305	114387305
NM_007081	chr22	-	51205919	51222110	RABL2B	16191	51219610	51224610
NM_173825	chr3	-	120405527	120461384	RABL3	55857	120458884	120463884
NM_024718	chr9	+	139702373	139735639	RABL6	33266	139699873	139704873
NM_006908	chr7	+	6414125	6443598	RAC1	29473	6411625	6416625
NM_002872	chr22	-	37621300	37640339	RAC2	19039	37637839	37642839
NM_001316307	chr17	+	79989531	79992080	RAC3	2549	79987031	79992031
NM_001320005	chr12	-	50382944	50419340	RACGAP1	36396	50416840	50421840
NR_026583	chr12	-	45456400	45459194	RACGAP1P	2794	45456694	45461694
NM_006098	chr5	-	180663927	180670906	RACK1	6979	180668406	180673406
NM_002853	chr5	-	34905365	34915780	RAD1	10415	34913280	34918280
NM_133343	chr5	+	68665123	68710630	RAD17	45507	68662623	68667623
NM_020165	chr3	-	8918879	9005159	RAD18	86280	9002659	9007659
NM_006265	chr8	-	117858172	117887105	RAD21	28933	117884605	117889605
NM_001136566	chr20	+	1206763	1235145	RAD21L1	28382	1204263	1209263
NM_001270363	chr19	+	13056627	13064457	RAD23A	7830	13054127	13059127
NM_002874	chr9	+	110045516	110094475	RAD23B	48959	110043016	110048016
NM_005732	chr5	+	131892615	131980313	RAD50	87698	131890115	131895115
NM_001164270	chr15	+	40987326	41024356	RAD51	37030	40984826	40989826
NM_001130862	chr12	+	4647949	4669213	RAD51AP1	21264	4645449	4650449
NM_001321233	chr2	-	17691850	17711681	RAD51AP2	19831	17709181	17714181
NM_001321818	chr14	+	68286495	69149823	RAD51B	863328	68283995	68288995
NR_103872	chr17	+	56769933	56811703	RAD51C	41770	56767433	56772433
NM_133629	chr17	-	33426810	33446888	RAD51D	20078	33444388	33449388
NR_037714	chr17	-	33336130	33448541	RAD51L3-RFFL	112411	33446041	33451041
NM_001297419	chr12	-	1020901	1099207	RAD52	78306	1096707	1101707
NM_012415	chr8	-	95384187	95487343	RAD54B	103156	95484843	95489843
NM_003579	chr1	+	46713366	46744145	RAD54L	30779	46710866	46715866
NM_001322256	chr3	+	51572698	51702676	RAD54L2	129978	51570198	51575198
NM_004584	chr11	+	67159422	67165883	RAD9A	6461	67156922	67161922
NM_001286533	chr12	+	110940004	110969891	RAD9B	29887	110937504	110942504
NM_018059	chr7	-	4838739	4923335	RADIL	84596	4920835	4925835
NM_003610	chr20	+	55926144	55953519	RAE1	27375	55923644	55928644
NM_001243328	chr6	-	150204510	150217195	RAET1E	12685	150214695	150219695
NR_045126	chr6	+	150184633	150240644	RAET1E-AS1	56011	150182133	150187133
NR_130110	chr6	-	150238013	150244288	RAET1G	6275	150241788	150246788
NR_024045	chr6	-	150319154	150326280	RAET1K	7126	150323780	150328780
NM_130900	chr6	-	150341265	150346668	RAET1L	5403	150344168	150349168
NM_002880	chr3	-	12625099	12705700	RAF1	80601	12703200	12708200
NM_000448	chr11	+	36589562	36601310	RAG1	11748	36587062	36592062
NM_001243785	chr11	-	36613492	36619829	RAG2	6337	36617329	36622329
NM_030665	chr17	+	17584786	17714765	RAI1	129979	17582286	17587286
NR_130894	chr17	-	17662467	17669616	RAI1-AS1	7149	17667116	17672116
NM_015577	chr5	+	34656432	34832717	RAI14	176285	34653932	34658932
NM_001172743	chrX	-	17818168	17879457	RAI2	61289	17876957	17881957
NM_005402	chr7	+	39663151	39747723	RALA	84572	39660651	39665651
NM_002881	chr2	+	121010413	121052286	RALB	41873	121007913	121012913
NM_006788	chr18	+	9475529	9538106	RALBP1	62577	9473029	9478029
NM_001283044	chr14	-	36007557	36278529	RALGAPA1	270972	36276029	36281029
NR_104269	chr14	-	36007960	36278350	RALGAPA1P1	270390	36275850	36280850
NM_020343	chr20	-	20370271	20693266	RALGAPA2	322995	20690766	20695766
NM_001282918	chr20	+	37101448	37207504	RALGAPB	106056	37098948	37103948
NM_001042368	chr9	-	135973106	136024607	RALGDS	51501	136022107	136027107
NM_001322321	chr9	+	129677052	129985445	RALGPS1	308393	129674552	129679552
NM_152663	chr1	+	178694281	178890977	RALGPS2	196696	178691781	178696781
NM_016732	chr20	+	32581457	32670991	RALY	89534	32578957	32583957
NM_001100393	chr8	+	85095452	85834078	RALYL	738626	85092952	85097952
NM_001308353	chr2	+	238768186	238820759	RAMP1	52573	238765686	238770686
NR_024462	chr17	-	40905946	40913275	RAMP2-AS1	7329	40910775	40915775
NM_005856	chr7	+	45197366	45223850	RAMP3	26484	45194866	45199866
NM_001300796	chr12	+	131356538	131362223	RAN	5685	131354038	131359038
NM_001278639	chr22	+	20103460	20114880	RANBP1	11420	20100960	20105960
NM_001320238	chr16	-	67756968	67840555	RANBP10	83587	67838055	67843055
NM_022897	chr5	+	170288885	170727019	RANBP17	438134	170286385	170291385
NM_006267	chr2	+	109335936	109402267	RANBP2	66331	109333436	109338436
NM_001300865	chr19	-	5916150	5978320	RANBP3	62170	5975820	5980820
NM_145000	chr5	-	36247020	36302011	RANBP3L	54991	36299511	36304511
NM_001243202	chr9	-	6011018	6015640	RANBP6	4622	6013140	6018140
NM_005493	chr6	-	13621729	13711796	RANBP9	90067	13709296	13714296
NM_001317930	chr22	-	41640780	41698217	RANGAP1	57437	41695717	41700717
NM_002884	chr1	+	112162404	112259317	RAP1A	96913	112159904	112164904
NM_001251921	chr12	+	69004618	69054385	RAP1B	49767	69002118	69007118
NM_001330383	chr1	-	21922713	21995873	RAP1GAP	73160	21993373	21998373
NM_001330058	chr17	+	2680214	2941035	RAP1GAP2	260821	2677714	2682714
NM_001100427	chr4	+	99182526	99365012	RAP1GDS1	182486	99180026	99185026
NM_021033	chr13	+	98086474	98120252	RAP2A	33778	98083974	98088974
NM_002886	chr3	+	152880000	152888413	RAP2B	8413	152877500	152882500
NR_073150	chrX	-	131337051	131353508	RAP2C	16457	131351008	131356008
NR_110410	chrX	+	131352534	131566839	RAP2C-AS1	214305	131350034	131355034
NM_001304275	chr9	-	134452156	134615331	RAPGEF1	163175	134612831	134617831
NM_001351724	chr4	+	160025277	160281321	RAPGEF2	256044	160022777	160027777
NM_001098531	chr12	-	48128452	48152889	RAPGEF3	24437	48150389	48155389
NM_007023	chr2	+	173600524	173917620	RAPGEF4	317096	173598024	173603024
NR_026995	chr2	-	173587917	173600934	RAPGEF4-AS1	13017	173598434	173603434
NM_012294	chr7	-	22157907	22396533	RAPGEF5	238626	22394033	22399033
NM_001164388	chr5	-	130759613	130970929	RAPGEF6	211316	130968429	130973429
NM_001303533	chr17	+	38333262	38351908	RAPGEFL1	18646	38330762	38335762
NM_213589	chr2	-	204298404	204400058	RAPH1	101654	204397558	204402558
NM_032645	chr11	-	47459307	47470730	RAPSN	11423	47468230	47473230
NM_000964	chr17	+	38465422	38513895	RARA	48473	38462922	38467922
NM_001290216	chr3	+	24870813	25639422	RARB	768609	24868313	24873313
NM_000966	chr12	-	53604349	53626040	RARG	21691	53623540	53628540
NM_206963	chr3	-	158414896	158450275	RARRES1	35379	158447775	158452775
NM_002889	chr7	-	150035406	150038763	RARRES2	3357	150036263	150041263
NM_004585	chr11	+	63304272	63313930	RARRES3	9658	63301772	63306772
NM_002887	chr5	+	167913462	167946309	RARS	32847	167910962	167915962
NM_001350508	chr6	-	88223652	88299750	RARS2	76098	88297250	88302250
NM_002890	chr5	+	86564069	86687743	RASA1	123674	86561569	86566569
NM_001303245	chr3	+	141205888	141334205	RASA2	128317	141203388	141208388
NM_007368	chr13	-	114747193	114898098	RASA3	150905	114895598	114900598
NM_006989	chr7	-	102220092	102257205	RASA4	37113	102254705	102259705
NM_001277335	chr7	-	102123585	102158224	RASA4B	34639	102155724	102160724
NR_024116	chr7	-	44068485	44080222	RASA4CP	11737	44077722	44082722
NR_146066	chr7	-	102319154	102389141	RASA4DP	69987	102386641	102391641
NM_001193520	chr12	-	113536623	113574044	RASAL1	37421	113571544	113576544
NM_170692	chr1	+	178062863	178448648	RASAL2	385785	178060363	178065363
NM_022904	chr19	-	15562435	15575392	RASAL3	12957	15572892	15577892
NM_014310	chr22	+	35937351	35950045	RASD2	12694	35934851	35939851
NM_152573	chr9	-	85594499	85678043	RASEF	83544	85675543	85680543
NM_145313	chr10	-	43689980	43762367	RASGEF1A	72387	43759867	43764867
NM_152545	chr4	-	82347546	82393082	RASGEF1B	45536	82390582	82395582
NM_175062	chr5	-	179527794	179636130	RASGEF1C	108336	179633630	179638630
NM_001145648	chr15	-	79252288	79383215	RASGRF1	130927	79380715	79385715
NM_006909	chr5	+	80256507	80525981	RASGRF2	269474	80254007	80259007
NR_105015	chr5	-	80243511	80256726	RASGRF2-AS1	13215	80254226	80259226
NM_001306086	chr15	-	38780298	38857007	RASGRP1	76709	38854507	38859507
NM_153819	chr11	-	64494382	64512928	RASGRP2	18546	64510428	64515428
NM_170672	chr2	+	33661415	33789798	RASGRP3	128383	33658915	33663915
NM_001146203	chr19	-	38899697	38916945	RASGRP4	17248	38914445	38919445
NM_017805	chr19	-	49223841	49243970	RASIP1	20129	49241470	49246470
NM_006477	chr22	-	29708921	29711745	RASL10A	2824	29709245	29714245
NM_033315	chr17	+	34058678	34070540	RASL10B	11862	34056178	34061178
NM_206827	chr13	+	27844463	27847827	RASL11A	3364	27841963	27846963
NM_023940	chr4	+	53728494	53733002	RASL11B	4508	53725994	53730994
NM_001307930	chr15	-	65345674	65360450	RASL12	14776	65357950	65362950
NM_170714	chr3	-	50367216	50378367	RASSF1	11151	50375867	50380867
NM_001080521	chr11	+	13030969	13033653	RASSF10	2684	13028469	13033469
NM_014737	chr20	-	4760669	4804291	RASSF2	43622	4801791	4806791
NR_040718	chr12	+	65004292	65091347	RASSF3	87055	65001792	65006792
NM_032023	chr10	+	45455218	45490172	RASSF4	34954	45452718	45457718
NM_182664	chr1	+	206680862	206762616	RASSF5	81754	206678362	206683362
NM_001270392	chr4	-	74437266	74486348	RASSF6	49082	74483848	74488848
NM_001143993	chr11	+	560970	564025	RASSF7	3055	558470	563470
NM_007211	chr12	+	26111963	26232825	RASSF8	120862	26109463	26114463
NR_038228	chr12	-	26107587	26112375	RASSF8-AS1	4788	26109875	26114875
NM_005447	chr12	-	86198330	86230318	RASSF9	31988	86227818	86232818
NM_133452	chr19	-	10426888	10444314	RAVER1	17426	10441814	10446814
NM_018211	chr1	+	65210777	65298914	RAVER2	88137	65208277	65213277
NM_013435	chr18	-	56934266	56940625	RAX	6359	56938125	56943125
NM_032753	chr19	-	3769088	3772219	RAX2	3131	3769719	3774719
NM_000321	chr13	+	48877882	49056026	RB1	178144	48875382	48880382
NM_014781	chr8	-	53535017	53627026	RB1CC1	92009	53624526	53629526
NM_001204456	chr7	+	5085451	5109119	RBAK	23668	5082951	5087951
NM_001204513	chr7	+	5085451	5112854	RBAK-RBAKDN	27403	5082951	5087951
NM_005610	chr1	+	33116748	33151812	RBBP4	35064	33114248	33119248
NM_005057	chr1	-	205055269	205091150	RBBP5	35881	205088650	205093650
NM_006910	chr16	+	24550907	24584183	RBBP6	33276	24548407	24553407
NM_002893	chrX	-	16862774	16888534	RBBP7	25760	16886034	16891034
NM_002894	chr18	+	20513294	20606449	RBBP8	93155	20510794	20515794
NM_080833	chr20	-	60985292	61002629	RBBP8NL	17337	61000129	61005129
NM_006606	chr20	-	18467187	18477887	RBBP9	10700	18475387	18480387
NR_136659	chr20	+	388693	412781	RBCK1	24088	386193	391193
NM_001171967	chr18	+	77794345	77810652	RBFA	16307	77791845	77796845
NR_103445	chr18	+	77827255	77839206	RBFADN	11951	77824755	77829755
NM_018723	chr16	+	6069131	7763340	RBFOX1	1694209	6066631	6071631
NM_001082579	chr22	-	36134780	36424585	RBFOX2	289805	36422085	36427085
NM_001082575	chr17	-	77085426	77512230	RBFOX3	426804	77509730	77514730
NM_001287580	chr2	-	28004230	28113263	RBKS	109033	28110763	28115763
NM_001323281	chr20	-	35624754	35724618	RBL1	99864	35722118	35727118
NM_001323610	chr16	+	53468331	53525560	RBL2	57229	53465831	53470831
NM_001204466	chrX	+	47004616	47046214	RBM10	41598	47002116	47007116
NM_144770	chr21	+	15588450	15600693	RBM11	12243	15585950	15590950
NM_001198840	chr20	-	34236846	34252878	RBM12	16032	34250378	34255378
NM_203390	chr8	-	94743730	94753224	RBM12B	9494	94750724	94755724
NM_006328	chr11	+	66384052	66397397	RBM14	13345	66381552	66386552
NM_001198846	chr11	+	66384052	66413944	RBM14-RBM4	29892	66381552	66386552
NM_022768	chr1	+	110881944	110889303	RBM15	7359	110879444	110884444
NM_013286	chr3	+	51428698	51435336	RBM15B	6638	51426198	51431198
NM_032905	chr10	+	6130948	6159422	RBM17	28474	6128448	6133448
NR_027125	chr9	-	125001833	125027143	RBM18	25310	125024643	125029643
NM_001146699	chr12	-	114254542	114404176	RBM19	149634	114401676	114406676
NM_001134363	chr10	+	112404154	112599229	RBM20	195075	112401654	112406654
NM_018047	chr5	-	150070351	150080669	RBM22	10318	150078169	150083169
NM_018107	chr14	-	23369853	23388396	RBM23	18543	23385896	23390896
NM_001143942	chr6	+	17281808	17294099	RBM24	12291	17279308	17284308
NM_021239	chr14	+	73525220	73588076	RBM25	62856	73522720	73527720
NM_022118	chr13	-	79893002	79980356	RBM26	87354	79977856	79982856
NR_038991	chr13	+	79980443	79998468	RBM26-AS1	18025	79977943	79982943
NM_018989	chr5	+	145583162	145668784	RBM27	85622	145580662	145585662
NM_001166135	chr7	-	127950435	127983962	RBM28	33527	127981462	127986462
NM_006743	chrX	+	48432740	48439553	RBM3	6813	48430240	48435240
NM_053043	chr7	+	155437202	155574179	RBM33	136977	155434702	155439702
NR_027762	chr1	-	235294497	235324931	RBM34	30434	235322431	235327431
NM_017495	chr20	+	55966453	55984386	RBM38	17933	55963953	55968953
NM_184234	chr20	-	34291530	34330258	RBM39	38728	34327758	34332758
NM_001198844	chr11	+	66406087	66435858	RBM4	29771	66403587	66408587
NM_001324242	chrX	-	106305117	106362057	RBM41	56940	106359557	106364557
NM_024321	chr19	+	36119917	36128588	RBM42	8671	36117417	36122417
NM_198557	chr2	-	152104727	152118389	RBM43	13662	152115889	152120889
NM_001080504	chr2	+	238707387	238751451	RBM44	44064	238704887	238709887
NM_152945	chr2	+	178977150	178994382	RBM45	17232	178974650	178979650
NM_144979	chr4	+	155702423	155749965	RBM46	47542	155699923	155704923
NM_001098634	chr4	-	40425271	40631883	RBM47	206612	40629383	40634383
NM_032120	chr7	+	92158086	92169795	RBM48	11709	92155586	92160586
NM_031492	chr11	-	66432464	66445392	RBM4B	12928	66442892	66447892
NR_036627	chr3	+	50126340	50156397	RBM5	30057	50123840	50128840
NM_005777	chr3	+	49977476	50114685	RBM6	137209	49974976	49979976
NM_001286048	chr11	+	114271250	114281332	RBM7	10082	114268750	114273750
NM_005105	chr1	+	145507556	145513535	RBM8A	5979	145505056	145510056
NM_016836	chr2	-	161128661	161350318	RBMS1	221657	161347818	161352818
NM_002898	chr12	+	56915608	56989980	RBMS2	74372	56913108	56918108
NM_001177711	chr3	+	29322802	30051886	RBMS3	729084	29320302	29325302
NR_046556	chr3	-	29968301	29975647	RBMS3-AS1	7346	29973147	29978147
NR_109804	chr3	-	29305684	29322430	RBMS3-AS3	16746	29319930	29324930
NM_001164803	chrX	-	135951352	135962939	RBMX	11587	135960439	135965439
NM_016024	chrX	+	129535922	129547630	RBMX2	11708	129533422	129538422
NM_019610	chr1	-	89445138	89458643	RBMXL1	13505	89456143	89461143
NM_001145346	chrX	+	114423962	114427431	RBMXL3	3469	114421462	114426462
NM_005058	chrY	-	24026222	24040673	RBMY1A1	14451	24038173	24043173
NR_001547	chrY	-	9154669	9160483	RBMY1A3P	5814	9157983	9162983
NM_001006121	chrY	-	24026454	24040673	RBMY1B	14219	24038173	24043173
NM_001320949	chrY	-	24026222	24040673	RBMY1D	14451	24038173	24043173
NM_001006118	chrY	-	24026222	24040633	RBMY1E	14411	24038133	24043133
NM_152585	chrY	+	24455009	24564028	RBMY1F	109019	24452509	24457509
NM_001006117	chrY	+	24549556	24563796	RBMY1J	14240	24547056	24552056
NR_001574	chrY	-	23557033	23563448	RBMY2EP	6415	23560948	23565948
NR_002193	chrY	+	24455005	24462352	RBMY2FP	7347	24452505	24457505
NR_001573	chrY	-	9448329	9452762	RBMY3AP	4433	9450262	9455262
NM_002899	chr3	-	139236275	139258671	RBP1	22396	139256171	139261171
NM_004164	chr3	-	139171725	139195352	RBP2	23627	139192852	139197852
NM_002900	chr10	-	48381486	48390991	RBP3	9505	48388491	48393491
NM_001323518	chr10	-	95351592	95361501	RBP4	9909	95359001	95364001
NM_001329454	chr12	-	7276276	7282610	RBP5	6334	7280110	7285110
NM_052960	chr1	+	10057254	10076078	RBP7	18824	10054754	10059754
NM_005349	chr4	+	26321331	26436752	RBPJ	115421	26318831	26323831
NM_001281448	chr20	+	43935482	43946464	RBPJL	10982	43932982	43937982
NM_006867	chr8	+	30242016	30429778	RBPMS	187762	30239516	30244516
NR_046205	chr8	-	30239634	30242917	RBPMS-AS1	3283	30240417	30245417
NM_194272	chr15	-	65032089	65067786	RBPMS2	35697	65065286	65070286
NM_022340	chr3	-	15111575	15140664	RBSN	29089	15138164	15143164
NM_014248	chr22	+	41347350	41369019	RBX1	21669	41344850	41349850
NM_001300852	chr1	-	173900221	173962210	RC3H1	61989	173959710	173964710
NM_001100588	chr9	-	125611731	125667562	RC3H2	55831	125665062	125670062
NM_004414	chr21	-	35888739	35987441	RCAN1	98702	35984941	35989941
NM_001251973	chr6	-	46188466	46459804	RCAN2	271338	46457304	46462304
NM_001251984	chr1	+	24828840	24863510	RCAN3	34670	24826340	24831340
NR_045407	chr1	-	24822743	24828872	RCAN3AS	6129	24826372	24831372
NM_018191	chr13	-	50106081	50159719	RCBTB1	53638	50157219	50162219
NM_001352429	chr13	-	49063098	49110118	RCBTB2	47020	49107618	49112618
NM_001048199	chr1	+	28832454	28865708	RCC1	33254	28829954	28834954
NM_148842	chr7	-	74441223	74489717	RCC1L	48494	74487217	74492217
NM_018715	chr1	-	17733250	17766250	RCC2	33000	17763750	17768750
NM_033544	chr15	+	91498105	91506355	RCCD1	8250	91495605	91500605
NM_005133	chr11	+	66610882	66614003	RCE1	3121	66608382	66613382
NM_001278537	chr4	-	76404246	76439640	RCHY1	35394	76437140	76442140
NM_001286699	chr9	+	4792833	4861077	RCL1	68244	4790333	4795333
NM_002901	chr11	+	32112476	32127272	RCN1	14796	32109976	32114976
NM_002902	chr15	+	77223961	77242601	RCN2	18640	77221461	77226461
NM_020650	chr19	+	50030874	50046890	RCN3	16016	50028374	50033374
NM_015156	chr14	+	103058995	103196913	RCOR1	137918	103056495	103061495
NM_173587	chr11	-	63678692	63684316	RCOR2	5624	63681816	63686816
NM_001136223	chr1	+	211432618	211489725	RCOR3	57107	211430118	211435118
NM_001322923	chr1	+	167599429	167677933	RCSD1	78504	167596929	167601929
NM_002903	chr17	-	9801026	9808684	RCVRN	7658	9806184	9811184
NM_001164688	chr1	-	211649863	211666259	RD3	16396	211663759	211668759
NM_172037	chr8	+	74206836	74237520	RDH10	30684	74204336	74209336
NR_125388	chr8	-	74223140	74268696	RDH10-AS1	45556	74266196	74271196
NM_001252650	chr14	-	68143518	68162510	RDH11	18992	68160010	68165010
NM_152443	chr14	+	68168602	68201168	RDH12	32566	68166102	68171102
NM_138412	chr19	-	55555691	55580914	RDH13	25223	55578414	55583414
NM_020905	chr2	-	18735988	18741959	RDH14	5971	18739459	18744459
NM_001320108	chr12	-	57345214	57353158	RDH16	7944	57350658	57355658
NM_002905	chr12	+	56114150	56118526	RDH5	4376	56111650	56116650
NM_015725	chr19	+	10123924	10132954	RDH8	9030	10121424	10126424
NM_001163120	chr17	-	34245084	34257780	RDM1	12696	34255280	34260280
NM_001260493	chr11	-	110045604	110167437	RDX	121833	110164937	110169937
NM_001348772	chr15	+	73735498	73852353	REC114	116855	73732998	73737998
NM_005132	chr14	+	24641233	24649463	REC8	8230	24638733	24643733
NM_021111	chr9	+	36036909	36124452	RECK	87543	36034409	36039409
NM_002907	chr12	-	21621843	21654603	RECQL	32760	21652103	21657103
NM_004260	chr8	-	145736666	145743210	RECQL4	6544	145740710	145745710
NM_004259	chr17	-	73622924	73663269	RECQL5	40345	73660769	73665769
NM_001164730	chr2	-	86441119	86565206	REEP1	124087	86562706	86567706
NR_073449	chr5	+	137774689	137782658	REEP2	7969	137772189	137777189
NM_001001330	chr10	+	65281122	65384883	REEP3	103761	65278622	65283622
NM_001316965	chr8	-	21995526	21999464	REEP4	3938	21996964	22001964
NM_005669	chr5	-	112212080	112258031	REEP5	45951	112255531	112260531
NM_001329556	chr19	+	1491003	1497926	REEP6	6923	1488503	1493503
NM_002909	chr2	+	79347583	79350545	REG1A	2962	79345083	79350083
NM_006507	chr2	-	79312148	79315150	REG1B	3002	79312650	79317650
NR_002714	chr2	-	79362628	79365553	REG1CP	2925	79363053	79368053
NM_002580	chr2	-	79384131	79386880	REG3A	2749	79384380	79389380
NM_198448	chr2	+	79252811	79255630	REG3G	2819	79250311	79255311
NM_032044	chr1	-	120336640	120354203	REG4	17563	120351703	120356703
NM_001291746	chr2	+	61108629	61155291	REL	46662	61106129	61111129
NM_021975	chr11	-	65421066	65430443	RELA	9377	65427943	65432943
NM_006509	chr19	+	45504706	45541456	RELB	36750	45502206	45507206
NM_001085399	chr4	-	37592421	37687999	RELL1	95578	37685499	37690499
NM_001130029	chr5	+	141016516	141020631	RELL2	4115	141014016	141019016
NM_005045	chr7	-	103112230	103629963	RELN	517733	103627463	103632463
NM_152222	chr11	+	73087404	73108519	RELT	21115	73084904	73089904
NM_014012	chr20	+	30063090	30072708	REM1	9618	30060590	30065590
NM_173527	chr14	+	23352431	23356889	REM2	4458	23349931	23354931
NM_000537	chr1	-	204123943	204135465	REN	11522	204132965	204137965
NM_002910	chrX	-	153200721	153210232	RENBP	9511	153207732	153212732
NM_013400	chr7	+	150065878	150071133	REPIN1	5255	150063378	150068378
NM_031922	chr6	-	139225151	139309398	REPS1	84247	139306898	139311898
NM_001080975	chrX	+	16964813	17171403	REPS2	206590	16962313	16967313
NM_007033	chr1	+	2323213	2336885	RER1	13672	2320713	2325713
NM_001042681	chr1	-	8412463	8877699	RERE	465236	8875199	8880199
NR_033735	chr15	+	22546564	22570831	REREP3	24267	22544064	22549064
NM_032918	chr12	-	15260715	15374411	RERG	113696	15371911	15376911
NR_046559	chr12	+	15304856	15308215	RERG-AS1	3359	15302356	15307356
NM_024730	chr12	-	18233802	18243127	RERGL	9325	18240627	18245627
NM_001007089	chr2	-	220192130	220197899	RESP18	5769	220195399	220200399
NM_005612	chr4	+	57774041	57802010	REST	27969	57771541	57776541
NM_020975	chr10	+	43572516	43625797	RET	53281	43570016	43575016
NM_001034850	chr5	-	16473146	16617167	RETREG1	144021	16614667	16619667
NM_001321109	chr2	+	220042911	220050197	RETREG2	7286	220040411	220045411
NR_026697	chr17	-	40731525	40761445	RETREG3	29920	40758945	40763945
NM_017750	chr2	-	85569077	85581821	RETSAT	12744	85579321	85584321
NM_016316	chr2	-	100016937	100106518	REV1	89581	100104018	100109018
NM_001286431	chr6	-	111620233	111804918	REV3L	184685	111802418	111807418
NM_020695	chr19	-	1815244	1848452	REXO1	33208	1845952	1850952
NM_015523	chr11	+	114310107	114321000	REXO2	10893	114307607	114312607
NM_001279351	chr9	-	136271181	136283292	REXO4	12111	136280792	136285792
NM_030941	chr16	+	20817766	20860990	REXO5	43224	20815266	20820266
NM_002913	chr4	-	39289068	39368001	RFC1	78933	39365501	39370501
NM_001278791	chr7	-	73645831	73668788	RFC2	22957	73666288	73671288
NM_181558	chr13	+	34392205	34540695	RFC3	148490	34389705	34394705
NM_181573	chr3	-	186507681	186524484	RFC4	16803	186521984	186526984
NM_181578	chr12	+	118454465	118470042	RFC5	15577	118451965	118456965
NM_001131066	chr5	+	94982480	94992849	RFESD	10369	94979980	94984980
NR_037713	chr17	-	33336130	33416348	RFFL	80218	33413848	33418848
NM_018339	chr9	-	79000432	79009444	RFK	9012	79006944	79011944
NM_181709	chr12	+	124773709	124800570	RFLNA	26861	124771209	124776209
NM_182705	chr17	-	289770	295731	RFLNB	5961	293231	298231
NM_002917	chr17	-	80005777	80009650	RFNG	3873	80007150	80012150
NM_021026	chr22	+	29834571	29838444	RFPL1	3873	29832071	29837071
NR_002727	chr22	-	29833003	29838118	RFPL1S	5115	29835618	29840618
NM_001159545	chr22	-	32586421	32600718	RFPL2	14297	32598218	32603218
NM_006604	chr22	+	32750871	32757148	RFPL3	6277	32748371	32753371
NR_104232	chr22	-	32755892	32767251	RFPL3S	11359	32764751	32769751
NM_001145014	chr19	+	56270506	56274541	RFPL4A	4035	56268006	56273006
NM_001013734	chr6	+	112668531	112672498	RFPL4B	3967	112666031	112671031
NM_052859	chr3	-	53122500	53164470	RFT1	41970	53161970	53166970
NM_015150	chr3	-	16357351	16555222	RFTN1	197871	16552722	16557722
NM_144629	chr2	-	198435526	198540584	RFTN2	105058	198538084	198543084
NM_022457	chr1	-	175913961	176176380	RFWD2	262419	176173880	176178880
NM_018124	chr16	-	74655296	74700779	RFWD3	45483	74698279	74703279
NM_002918	chr19	-	14072341	14117134	RFX1	44793	14114634	14119634
NM_000635	chr19	-	5993174	6110664	RFX2	117490	6108164	6113164
NM_001282116	chr9	-	3218296	3526001	RFX3	307705	3523501	3528501
NR_121586	chr9	+	3668085	3691756	RFX3-AS1	23671	3665585	3670585
NM_213594	chr12	+	106976684	107156582	RFX4	179898	106974184	106979184
NM_000449	chr1	-	151313115	151319769	RFX5	6654	151317269	151322269
NM_173560	chr6	+	117198375	117253326	RFX6	54951	117195875	117200875
NM_022841	chr15	-	56382730	56535483	RFX7	152753	56532983	56537983
NM_001145664	chr2	-	102013822	102091165	RFX8	77343	102088665	102093665
NM_001278727	chr19	+	19303007	19312678	RFXANK	9671	19300507	19305507
NM_000538	chr13	+	37393338	37403740	RFXAP	10402	37390838	37395838
NM_014059	chr13	+	42031541	42045013	RGCC	13472	42029041	42034041
NM_015149	chr1	+	183605181	183897685	RGL1	292504	183602681	183607681
NM_004761	chr6	-	33259430	33267165	RGL2	7735	33264665	33269665
NM_001161616	chr19	-	11504731	11530018	RGL3	25287	11527518	11532518
NM_153615	chr22	+	24033047	24041363	RGL4	8316	24030547	24035547
NM_020211	chr15	-	93586635	93632443	RGMA	45808	93629943	93634943
NM_001012761	chr5	+	98104998	98132198	RGMB	27200	98102498	98107498
NR_033932	chr5	-	98105321	98108788	RGMB-AS1	3467	98106288	98111288
NM_004683	chrX	+	46937753	46952713	RGN	14960	46935253	46940253
NM_001080496	chr9	+	35749276	35753264	RGP1	3988	35746776	35751776
NM_001024457	chr2	-	88055478	88285309	RGPD1	229831	88282809	88287809
NM_001078170	chr2	+	87140934	87239861	RGPD2	98927	87138434	87143434
NM_001144013	chr2	-	107021135	107084801	RGPD3	63666	107082301	107087301
NM_182588	chr2	+	108443387	108509000	RGPD4	65613	108440887	108445887
NR_024439	chr2	-	108439519	108442583	RGPD4-AS1	3064	108440083	108445083
NM_005054	chr2	-	113125964	113191107	RGPD5	65143	113188607	113193607
NM_001123363	chr2	+	110550334	110615282	RGPD6	64948	110547834	110552834
NM_001164463	chr2	-	113125945	113191222	RGPD8	65277	113188722	113193722
NM_002921	chr10	+	86004808	86018944	RGR	14136	86002308	86007308
NM_002922	chr1	+	192544856	192549159	RGS1	4303	192542356	192547356
NM_001005339	chr10	-	121259338	121302222	RGS10	42884	121299722	121304722
NM_003834	chr16	-	318299	325943	RGS11	7644	323443	328443
NM_198229	chr4	+	3315873	3441640	RGS12	125767	3313373	3318373
NM_002927	chr1	+	192605267	192629440	RGS13	24173	192602767	192607767
NM_006480	chr5	+	176784843	176799599	RGS14	14756	176782343	176787343
NM_002928	chr1	-	182567757	182573548	RGS16	5791	182571048	182576048
NM_012419	chr6	-	153332031	153452389	RGS17	120358	153449889	153454889
NM_130782	chr1	+	192127591	192154945	RGS18	27354	192125091	192130091
NM_001039467	chr20	-	62704534	62711324	RGS19	6790	62708824	62713824
NM_002923	chr1	+	192778168	192781407	RGS2	3239	192775668	192780668
NM_170587	chr8	+	54764367	54871864	RGS20	107497	54761867	54766867
NM_001039152	chr1	+	192286121	192336414	RGS21	50293	192283621	192288621
NM_001286692	chr8	-	100973165	101118344	RGS22	145179	101115844	101120844
NM_144488	chr9	+	116207008	116360023	RGS3	153015	116204508	116209508
NM_001102445	chr1	+	163038395	163046592	RGS4	8197	163035895	163040895
NM_001254748	chr1	-	163112088	163291581	RGS5	179493	163289081	163294081
NM_001204423	chr14	+	72398816	73033238	RGS6	634422	72396316	72401316
NM_001282773	chr1	-	240938813	241520530	RGS7	581717	241518030	241523030
NM_001029875	chr5	+	63801773	63908121	RGS7BP	106348	63799273	63804273
NM_033345	chr1	-	182610948	182642067	RGS8	31119	182639567	182644567
NM_003835	chr17	+	63133455	63223821	RGS9	90366	63130955	63135955
NM_207391	chr19	+	33166312	33169206	RGS9BP	2894	33163812	33168812
NM_001137669	chr1	+	182419255	182529732	RGSL1	110477	182416755	182421755
NM_000324	chr6	-	49572889	49604587	RHAG	31698	49602087	49607087
NM_001349069	chr2	+	227664874	227863923	RHBDD1	199049	227662374	227667374
NM_001040456	chr7	+	75508309	75518244	RHBDD2	9935	75505809	75510809
NM_001329536	chr22	-	29655840	29664152	RHBDD3	8312	29661652	29666652
NM_022450	chr16	-	108057	122629	RHBDF1	14572	120129	125129
NM_024599	chr17	-	74466974	74497509	RHBDF2	30535	74495009	74500009
NM_001278721	chr16	+	725665	728268	RHBDL1	2603	723165	728165
NM_017821	chr1	-	39351477	39407502	RHBDL2	56025	39405002	39410002
NM_138328	chr17	+	30593194	30651680	RHBDL3	58486	30590694	30595694
NM_001256395	chr1	+	156338979	156355013	RHBG	16034	156336479	156341479
NM_138618	chr1	-	25688739	25747405	RHCE	58666	25744905	25749905
NR_110261	chr15	-	90014639	90039844	RHCG	25205	90037344	90042344
NM_001282869	chr1	+	25598976	25656936	RHD	57960	25596476	25601476
NM_005614	chr7	-	151163097	151217010	RHEB	53913	151214510	151219510
NR_130123	chr12	-	49458458	49463808	RHEBL1	5350	49461308	49466308
NR_046433	chr12	+	2985423	2998691	RHNO1	13268	2982923	2987923
NM_000539	chr3	+	129247481	129254187	RHO	6706	129244981	129249981
NM_001313941	chr3	-	49396568	49449530	RHOA	52962	49447030	49452030
NM_001350902	chr10	-	62629195	62761226	RHOBTB1	132031	62758726	62763726
NM_001160036	chr8	+	22844929	22877710	RHOBTB2	32781	22842429	22847429
NM_014899	chr5	+	95066849	95132071	RHOBTB3	65222	95064349	95069349
NM_175744	chr1	-	113243748	113250025	RHOC	6277	113247525	113252525
NM_001300886	chr11	+	66824288	66839488	RHOD	15200	66821788	66826788
NM_019034	chr12	-	122215659	122231594	RHOF	15935	122229094	122234094
NM_001665	chr11	-	3848207	3862213	RHOG	14006	3859713	3864713
NM_001278368	chr4	+	40192630	40246384	RHOH	53754	40190130	40195130
NM_020663	chr14	+	63671101	63760230	RHOJ	89129	63668601	63673601
NM_012249	chr2	+	46769866	46811827	RHOQ	41961	46767366	46772366
NM_001288755	chr17	+	30469472	30552790	RHOT1	83318	30466972	30471972
NM_138769	chr16	+	718082	724174	RHOT2	6092	715582	720582
NR_037962	chr1	+	228780393	228882416	RHOU	102023	228777893	228782893
NM_139282	chrX	-	119243010	119249847	RHOXF1	6837	119247347	119252347
NR_131238	chrX	+	119170200	119280761	RHOXF1-AS1	110561	119167700	119172700
NR_131250	chrX	-	119144673	119149508	RHOXF1P1	4835	119147008	119152008
NM_032498	chrX	-	119206228	119211707	RHOXF2	5479	119209207	119214207
NM_001099685	chrX	-	119206228	119211707	RHOXF2B	5479	119209207	119214207
NM_052924	chr8	+	144451024	144466390	RHPN1	15366	144448524	144453524
NM_033103	chr19	-	33469497	33555824	RHPN2	86327	33553324	33558324
NM_001031745	chrX	+	53449804	53458068	RIBC1	8264	53447304	53452304
NM_015653	chr22	+	45809571	45828302	RIBC2	18731	45807071	45812071
NM_001206557	chr9	+	5629118	5776556	RIC1	147438	5626618	5631618
NR_144485	chr11	-	8114511	8190641	RIC3	76130	8188141	8193141
NM_021932	chr11	+	207510	215175	RIC8A	7665	205010	210010
NM_018157	chr12	+	107168333	107283095	RIC8B	114762	107165833	107170833
NM_152756	chr5	-	38938022	39074510	RICTOR	136488	39072010	39077010
NM_005836	chr8	-	99114566	99129418	RIDA	14852	99126918	99131918
NM_001177663	chr2	+	152266396	152333860	RIF1	67464	152263896	152268896
NM_001144956	chr1	+	151694012	151702082	RIIAD1	8070	151691512	151696512
NM_031430	chr17	-	1549444	1553392	RILP	3948	1550892	1555892
NM_001319243	chr12	-	123955634	124018265	RILPL1	62631	124015765	124020765
NR_130703	chr12	-	123899585	123921280	RILPL2	21695	123918780	123923780
NM_001351226	chr12	-	130880680	131200850	RIMBP2	320170	131198350	131203350
NM_015672	chr22	-	20455993	20461786	RIMBP3	5793	20459286	20464286
NM_001128635	chr22	+	21738039	21743455	RIMBP3B	5416	21735539	21740539
NM_001128633	chr22	+	21737662	21743455	RIMBP3C	5793	21735162	21740162
NM_173642	chr1	+	42846467	42889900	RIMKLA	43433	42843967	42848967
NR_123740	chr12	+	8834272	8935694	RIMKLB	101422	8831772	8836772
NM_014989	chr6	+	72596405	73112845	RIMS1	516440	72593905	72598905
NM_001348497	chr8	+	104512975	105266656	RIMS2	753681	104510475	104515475
NM_014747	chr1	-	41086351	41131324	RIMS3	44973	41128824	41133824
NM_001205317	chr20	-	43380444	43438979	RIMS4	58535	43436479	43441479
NM_004292	chr11	-	66099541	66104000	RIN1	4459	66101500	66106500
NM_001242581	chr20	+	19867164	19983103	RIN2	115939	19864664	19869664
NM_024832	chr14	+	92980124	93155339	RIN3	175215	92977624	92982624
NM_002931	chr6	+	33176285	33180499	RING1	4214	33173785	33178785
NM_001195833	chr19	-	39358471	39368919	RINL	10448	39366419	39371419
NM_001346599	chr7	+	105172527	105208132	RINT1	35605	105170027	105175027
NM_031480	chr6	+	7390061	7418270	RIOK1	28209	7387561	7392561
NM_018343	chr5	-	96496570	96519005	RIOK2	22435	96516505	96521505
NM_003831	chr18	+	21033184	21063104	RIOK3	29920	21030684	21035684
NM_153182	chr3	-	97660660	97691295	RIOX2	30635	97688795	97693795
NM_001317061	chr6	+	3064121	3115421	RIPK1	51300	3061621	3066621
NM_003821	chr8	+	90769974	90803292	RIPK2	33318	90767474	90772474
NM_006871	chr14	-	24805226	24809242	RIPK3	4016	24806742	24811742
NM_020639	chr21	-	43159528	43187249	RIPK4	27721	43184749	43189749
NM_024519	chr16	+	67562716	67580691	RIPOR1	17975	67560216	67565216
NM_001286446	chr6	-	24839594	25042516	RIPOR2	202922	25040016	25045016
NM_001290268	chr20	-	49202644	49308067	RIPOR3	105423	49305567	49310567
NM_001171706	chrX	-	106143292	106146561	RIPPLY1	3269	106144061	106149061
NM_001009994	chr6	+	84562984	84567234	RIPPLY2	4250	84560484	84565484
NM_001317768	chr21	+	38378449	38391958	RIPPLY3	13509	38375949	38380949
NM_001256820	chr1	-	155867598	155881193	RIT1	13595	155878693	155883693
NM_002930	chr18	-	40323182	40695657	RIT2	372475	40693157	40698157
NM_032848	chr12	+	113623330	113630173	RITA1	6843	113620830	113625830
NM_000326	chr15	-	89753097	89764922	RLBP1	11825	89762422	89767422
NM_012421	chr1	+	40627040	40706593	RLF	79553	40624540	40629540
NM_016120	chrX	-	73802810	73834461	RLIM	31651	73831961	73836961
NM_006911	chr9	-	5334931	5339873	RLN1	4942	5337373	5342373
NM_005059	chr9	-	5299865	5304611	RLN2	4746	5302111	5307111
NM_080864	chr19	+	14138959	14142370	RLN3	3411	14136459	14141459
NM_001317807	chr8	-	87484577	87526577	RMDN1	42000	87524077	87529077
NM_001322212	chr2	+	38152461	38294280	RMDN2	141819	38149961	38154961
NR_102712	chr2	-	38177476	38263484	RMDN2-AS1	86008	38260984	38265984
NM_001323896	chr15	-	41028081	41047534	RMDN3	19453	41045034	41050034
NM_024945	chr9	+	86595636	86618987	RMI1	23351	86593136	86598136
NM_152308	chr16	+	11439294	11445620	RMI2	6326	11436794	11441794
NM_017909	chr6	-	151725896	151773316	RMND1	47420	151770816	151775816
NM_022780	chr2	+	86947413	87005164	RMND5A	57751	86944913	86949913
NM_001288794	chr5	+	177557961	177575571	RMND5B	17610	177555461	177560461
NR_024037	chr12	+	97858798	97927544	RMST	68746	97856298	97861298
NR_145822	chrUn_gl000220	+	113347	118417	RNA28SN1	5070	110847	115847
NR_146148	chrUn_gl000220	+	113347	118417	RNA28SN2	5070	110847	115847
NR_146154	chrUn_gl000220	+	113347	118417	RNA28SN3	5070	110847	115847
NR_146118	chrUn_gl000220	+	113347	118417	RNA28SN4	5070	110847	115847
NR_003287	chrUn_gl000220	+	113347	118417	RNA28SN5	5070	110847	115847
NR_145819	chrUn_gl000220	+	105423	118780	RNA45SN1	13357	102923	107923
NR_146144	chrUn_gl000220	+	105423	118780	RNA45SN2	13357	102923	107923
NR_146151	chrUn_gl000220	+	105423	118780	RNA45SN3	13357	102923	107923
NR_146117	chrUn_gl000220	+	105423	118780	RNA45SN4	13357	102923	107923
NR_046235	chrUn_gl000220	+	105423	118780	RNA45SN5	13357	102923	107923
NM_145250	chr14	-	21051051	21058417	RNASE11	7366	21055917	21060917
NM_002937	chr14	+	21152371	21168761	RNASE4	16390	21149871	21154871
NM_001001673	chr14	-	21024251	21029090	RNASE9	4839	21026590	21031590
NM_001286834	chr2	-	3592481	3605961	RNASEH1	13480	3603461	3608461
NR_038429	chr2	+	3605975	3609340	RNASEH1-AS1	3365	3603475	3608475
NM_006397	chr19	+	12917427	12924462	RNASEH2A	7035	12914927	12919927
NM_001142279	chr13	+	51483813	51544596	RNASEH2B	60783	51481313	51486313
NR_046552	chr13	-	51456514	51484848	RNASEH2B-AS1	28334	51482348	51487348
NM_032193	chr11	-	65485143	65488409	RNASEH2C	3266	65485909	65490909
NR_037717	chr17	+	6915735	6920843	RNASEK-C17orf49	5108	6913235	6918235
NM_021133	chr1	-	182542768	182558394	RNASEL	15626	182555894	182560894
NM_003730	chr6	-	167343003	167370077	RNASET2	27074	167367577	167372577
NM_014470	chr12	-	49250915	49259653	RND1	8738	49257153	49262153
NM_005440	chr17	+	41177257	41184058	RND2	6801	41174757	41179757
NM_001254738	chr2	-	151324706	151344209	RND3	19503	151341709	151346709
NM_014868	chr12	+	120972131	121015397	RNF10	43266	120969631	120974631
NM_005667	chr2	-	86830515	86851000	RNF103	20485	86848500	86853500
NM_001198954	chr2	-	86730552	86948245	RNF103-CHMP3	217693	86945745	86950745
NM_014372	chr1	+	51701944	51739119	RNF11	37175	51699444	51704444
NM_001330331	chr15	+	59279786	59389618	RNF111	109832	59277286	59282286
NM_007148	chr17	+	19314490	19320589	RNF112	6099	19311990	19316990
NM_018683	chr20	+	48552913	48570422	RNF114	17509	48550413	48555413
NM_014455	chr1	+	145610989	145689005	RNF115	78016	145608489	145613489
NM_001300926	chr11	+	71639767	71708643	RNF121	68876	71637267	71642267
NM_024787	chr8	-	33405271	33424646	RNF122	19375	33422146	33427146
NM_022064	chr3	+	49726931	49758962	RNF123	32031	49724431	49729431
NM_017831	chr18	+	29598444	29653154	RNF125	54710	29595944	29600944
NM_194460	chr19	-	647525	663233	RNF126	15708	660733	665733
NM_024539	chrX	+	105937067	106040246	RNF128	103179	105934567	105939567
NM_183381	chr3	+	149530474	149679925	RNF13	149451	149527974	149532974
NM_018434	chr5	-	179382066	179499118	RNF130	117052	179496618	179501618
NM_001184992	chr17	+	29297955	29326929	RNF135	28974	29295455	29300455
NM_016271	chr18	+	29671817	29711524	RNF138	39707	29669317	29674317
NR_001575	chr5	-	54824669	54830370	RNF138P1	5701	54827870	54832870
NM_007218	chr8	+	125487007	125500859	RNF139	13852	125484507	125489507
NR_108047	chr8	-	125474737	125486804	RNF139-AS1	12067	125484304	125489304
NM_001201365	chr5	+	141346401	141369856	RNF14	23455	141343901	141348901
NM_016422	chr11	-	10533224	10562774	RNF141	29550	10560274	10565274
NM_001349181	chr2	+	7057548	7216484	RNF144A	158936	7055048	7060048
NR_033997	chr2	-	7052406	7058813	RNF144A-AS1	6407	7056313	7061313
NM_182757	chr6	+	18387580	18469105	RNF144B	81525	18385080	18390080
NM_001199380	chr5	-	158584416	158637061	RNF145	52645	158634561	158639561
NM_001242851	chr6	+	127587826	127609705	RNF146	21879	127585326	127590326
NM_173647	chr2	-	101892062	101925178	RNF149	33116	101922678	101927678
NM_020724	chr4	-	141786724	142054616	RNF150	267892	142052116	142057116
NM_173557	chr18	-	59482303	59560304	RNF152	78001	59557804	59562804
NM_001330501	chr17	-	74138533	74236392	RNF157	97859	74233892	74238892
NR_040017	chr17	+	74136636	74150729	RNF157-AS1	14093	74134136	74139136
NM_001256758	chr18	+	43914186	44040783	RNF165	126597	43911686	43916686
NM_178841	chr16	-	88762902	88772829	RNF166	9927	88770329	88775329
NM_015528	chr17	+	4843302	4848518	RNF167	5216	4840802	4845802
NM_152617	chr3	-	196195656	196230639	RNF168	34983	196228139	196233139
NM_001098638	chr11	+	74459912	74553458	RNF169	93546	74457412	74462412
NM_001184993	chr13	+	25338300	25454058	RNF17	115758	25335800	25340800
NM_001160224	chr8	-	42704779	42751866	RNF170	47087	42749366	42754366
NM_173662	chr4	-	154631311	154681387	RNF175	50076	154678887	154683887
NM_001113561	chr5	+	63461669	63668696	RNF180	207027	63459169	63464169
NM_001165034	chr6	+	13924676	13980240	RNF182	55564	13922176	13927176
NM_001135825	chr22	+	31556137	31603005	RNF185	46868	31553637	31558637
NM_001010858	chr1	+	228675067	228683889	RNF187	8822	228672567	228677567
NM_001280539	chr8	-	101269286	101348446	RNF19A	79160	101345946	101350946
NM_001300826	chr1	-	33402046	33430414	RNF19B	28368	33427914	33432914
NM_007212	chr1	+	185014550	185071740	RNF2	57190	185012050	185017050
NM_019592	chr9	+	104296130	104325626	RNF20	29496	104293630	104298630
NM_207396	chr1	+	6266188	6281359	RNF207	15171	6263688	6268688
NM_194439	chr4	-	1065265	1107352	RNF212	42087	1104852	1109852
NM_001282322	chr14	+	23707126	23743494	RNF212B	36368	23704626	23709626
NM_001256071	chr17	+	78234659	78372581	RNF213	137922	78232159	78237159
NM_207343	chr11	+	117103340	117156404	RNF214	53064	117100840	117105840
NM_001017981	chr22	-	30774802	30783302	RNF215	8500	30780802	30785802
NM_207116	chr7	-	5659671	5821361	RNF216	161690	5818861	5823861
NR_046834	chr7	-	5702062	5720092	RNF216-IT1	18030	5717592	5722592
NR_023385	chr7	+	5013615	5037800	RNF216P1	24185	5011115	5016115
NR_136734	chr6	+	125283690	125413780	RNF217	130090	125281190	125286190
NR_026876	chr6	-	125229391	125284173	RNF217-AS1	54782	125281673	125286673
NM_024546	chr13	-	79188420	79233314	RNF219	44894	79230814	79235814
NR_047001	chr13	+	78628989	79191460	RNF219-AS1	562471	78626489	78631489
NM_001319956	chr1	+	44870831	45117396	RNF220	246565	44868331	44873331
NM_001146684	chr17	-	8294022	8301144	RNF222	7122	8298644	8303644
NM_001205252	chr1	-	1007125	1009687	RNF223	2562	1007187	1012187
NM_001134338	chr20	-	3907955	3996238	RNF24	88283	3993738	3998738
NM_022453	chr2	-	219528586	219536781	RNF25	8195	219534281	219539281
NM_032015	chr11	+	119205209	119208024	RNF26	2815	119202709	119207709
NM_001310332	chr14	+	24616083	24629870	RNF31	13787	24613583	24618583
NM_030936	chr7	+	156433352	156469820	RNF32	36468	156430852	156435852
NM_025126	chr12	+	121837885	121862155	RNF34	24270	121835385	121840385
NM_194330	chr9	-	36336398	36401195	RNF38	64797	36398695	36403695
NM_025236	chr6	-	30038042	30043628	RNF39	5586	30041128	30046128
NM_001185010	chr4	+	2470794	2517586	RNF4	46792	2468294	2473294
NM_001207033	chr16	+	30772932	30787628	RNF40	14696	30770432	30775432
NM_194359	chr12	-	56596287	56615753	RNF41	19466	56613253	56618253
NM_017763	chr17	-	56429860	56494943	RNF43	65083	56492443	56497443
NM_014901	chr5	-	175953699	175964421	RNF44	10722	175961921	175966921
NM_183045	chr13	-	26706252	26796508	RNF6	90256	26794008	26799008
NR_037703	chr3	+	141457050	141465645	RNF7	8595	141454550	141459550
NM_003958	chr6	+	37321747	37362514	RNF8	40767	37319247	37324247
NM_016125	chr17	-	58029722	58042117	RNFT1	12395	58039617	58044617
NM_001109903	chr12	+	117176095	117291436	RNFT2	115341	117173595	117178595
NM_001286428	chr6	-	89319615	89673348	RNGTT	353733	89670848	89675848
NM_203386	chr11	-	494511	507283	RNH1	12772	504783	509783
NM_018363	chr10	-	90033620	90343082	RNLS	309462	90340582	90345582
NM_003799	chr18	+	13726658	13764555	RNMT	37897	13724158	13729158
NM_017619	chr1	+	104068577	104097859	RNPC3	29282	104066077	104071077
NM_020216	chr1	+	201951765	201975275	RNPEP	23510	201949265	201954265
NM_018226	chr2	+	241508003	241518149	RNPEPL1	10146	241505503	241510503
NR_104485	chr16	-	2303116	2318413	RNPS1	15297	2315913	2320913
NR_002755	chr5	+	80501462	80746718	RNU5D-1	245256	80498962	80503962
NR_002754	chr5	+	80501461	80746718	RNU5E-1	245257	80498961	80503961
NR_002753	chr1	+	220046618	220292777	RNU5F-1	246159	220044118	220049118
NM_002941	chr3	-	78646387	79817059	ROBO1	1170672	79814559	79819559
NM_001290039	chr3	+	77089293	77699114	ROBO2	609821	77086793	77091793
NM_022370	chr11	+	124735304	124751370	ROBO3	16066	124732804	124737804
NM_001301088	chr11	-	124754113	124767831	ROBO4	13718	124765331	124770331
NM_005406	chr18	-	18529702	18691812	ROCK1	162110	18689312	18694312
NR_033770	chr18	+	109064	122222	ROCK1P1	13158	106564	111564
NM_001321643	chr2	-	11319884	11485533	ROCK2	165649	11483033	11488033
NR_046480	chr16	-	4846962	4852951	ROGDI	5989	4850451	4855451
NM_001317774	chr3	-	123687862	123711017	ROPN1	23155	123708517	123713517
NM_001012337	chr3	+	125687986	125702296	ROPN1B	14310	125685486	125690486
NM_001201466	chr5	+	10441973	10465138	ROPN1L	23165	10439473	10444473
NM_005012	chr1	+	64239689	64647179	ROR1	407490	64237189	64242189
NR_110666	chr1	-	64560124	64577888	ROR1-AS1	17764	64575388	64580388
NM_004560	chr9	-	94484877	94712444	ROR2	227567	94709944	94714944
NM_134261	chr15	-	60780482	61521502	RORA	741020	61519002	61524002
NR_120342	chr15	+	60771376	60922838	RORA-AS1	151462	60768876	60773876
NR_120318	chr15	+	60973767	60979448	RORA-AS2	5681	60971267	60976267
NM_006914	chr9	+	77112251	77302117	RORB	189866	77109751	77114751
NR_125791	chr9	-	77088350	77113469	RORB-AS1	25119	77110969	77115969
NM_005060	chr1	-	151778546	151804348	RORC	25802	151801848	151806848
NM_002944	chr6	-	117609529	117747018	ROS1	137489	117744518	117749518
NM_006269	chr8	+	55528626	55543394	RP1	14768	55526126	55531126
NM_178857	chr8	-	10463859	10512617	RP1L1	48758	10510117	10515117
NM_006915	chrX	+	46696346	46741791	RP2	45445	46693846	46698846
NM_203288	chr7	-	33134409	33149002	RP9	14593	33146502	33151502
NR_003500	chr7	-	32956426	32982782	RP9P	26356	32980282	32985282
NM_002945	chr17	+	1733272	1802848	RPA1	69576	1730772	1735772
NM_002946	chr1	-	28218035	28241308	RPA2	23273	28238808	28243808
NM_002947	chr7	-	7676193	7758238	RPA3	82045	7755738	7760738
NM_001160246	chr17	+	5322960	5336340	RPAIN	13380	5320460	5325460
NM_015540	chr15	-	41809374	41836475	RPAP1	27101	41833975	41838975
NM_024813	chr1	+	92764521	92853732	RPAP2	89211	92762021	92767021
NM_001146075	chr12	-	48055714	48099844	RPAP3	44130	48097344	48102344
NR_038938	chr10	+	104209573	104216050	RPARP-AS1	6477	104207073	104212073
NM_006916	chr2	+	210867288	210886984	RPE	19696	210864788	210869788
NM_000329	chr1	-	68894506	68915642	RPE65	21136	68913142	68918142
NM_025065	chr1	+	84944919	84964033	RPF1	19114	84942419	84947419
NM_032194	chr6	+	111303219	111349466	RPF2	46247	111300719	111305719
NM_000328	chrX	-	38128422	38186788	RPGR	58366	38184288	38189288
NM_020366	chr14	+	21756135	21819460	RPGRIP1	63325	21753635	21758635
NM_015272	chr16	-	53633150	53737850	RPGRIP1L	104700	53735350	53740350
NM_001347952	chr12	+	113012900	113336684	RPH3A	323784	113010400	113015400
NM_001190412	chr17	-	62179	202633	RPH3AL	140454	200133	205133
NM_144563	chr2	+	88991175	89050452	RPIA	59277	88988675	88993675
NM_006013	chrX	+	153626405	153630680	RPL10	4275	153623905	153628905
NM_000975	chr1	+	24018268	24022915	RPL11	4647	24015768	24020768
NM_000976	chr9	-	130209952	130213711	RPL12	3759	130211211	130216211
NM_000977	chr16	+	89627064	89633237	RPL13	6173	89624564	89629564
NR_073024	chr19	+	49990810	49995564	RPL13A	4754	49988310	49993310
NR_003680	chr7	+	77976558	77988770	RPL13AP17	12212	77974058	77979058
NR_026712	chr19	+	49990864	49995096	RPL13AP5	4232	49988364	49993364
NM_003973	chr3	+	40498782	40503863	RPL14	5081	40496282	40501282
NM_001253384	chr3	+	23958035	23966122	RPL15	8087	23955535	23960535
NM_001199340	chr18	-	47014850	47018935	RPL17	4085	47016435	47021435
NM_001199356	chr18	-	47007547	47018935	RPL17-C18orf32	11388	47016435	47021435
NM_000979	chr19	-	49118583	49122675	RPL18	4092	49120175	49125175
NM_000980	chr19	+	17970686	17974133	RPL18A	3447	17968186	17973186
NM_000981	chr17	+	37356535	37360980	RPL19	4445	37354035	37359035
NM_000982	chr13	+	27825691	27830702	RPL21	5011	27823191	27828191
NR_026911	chr13	+	27825692	27830699	RPL21P28	5007	27823192	27828192
NM_000983	chr1	-	6245079	6259679	RPL22	14600	6257179	6262179
NR_135259	chr3	-	170582664	170588045	RPL22L1	5381	170585545	170590545
NM_000978	chr17	-	37006320	37010053	RPL23	3733	37007553	37012553
NM_000984	chr17	+	27046999	27051374	RPL23A	4375	27044499	27049499
NR_003572	chr8	-	158344	182318	RPL23AP53	23974	179818	184818
NR_000029	chr2	-	114368815	114384715	RPL23AP7	15900	114382215	114387215
NR_026981	chr22	+	51195513	51238065	RPL23AP82	42552	51193013	51198013
NR_029406	chr17	+	81174665	81188573	RPL23AP87	13908	81172165	81177165
NM_000986	chr3	-	101399933	101405563	RPL24	5630	101403063	101408063
NM_000987	chr17	-	8280833	8286568	RPL26	5735	8284068	8289068
NM_001317981	chr5	+	172385731	172396774	RPL26L1	11043	172383231	172388231
NM_001349921	chr17	+	41150289	41154971	RPL27	4682	41147789	41152789
NM_000990	chr11	+	8703994	8711419	RPL27A	7425	8701494	8706494
NM_001136134	chr19	+	55897299	55903451	RPL28	6152	55894799	55899799
NM_000967	chr22	-	39708886	39715670	RPL3	6784	39713170	39718170
NM_000989	chr8	-	99053937	99057818	RPL30	3881	99055318	99060318
NM_001098577	chr2	+	101618690	101636155	RPL31	17465	101616190	101621190
NM_000994	chr3	-	12876443	12883081	RPL32	6638	12880581	12885581
NR_003111	chr3	-	129101676	129118282	RPL32P3	16606	129115782	129120782
NM_000995	chr4	+	109541713	109551639	RPL34	9926	109539213	109544213
NR_026968	chr4	-	109459345	109541613	RPL34-AS1	82268	109539113	109544113
NM_007209	chr9	-	127620157	127624240	RPL35	4083	127621740	127626740
NM_000996	chr3	+	197677051	197682721	RPL35A	5670	197674551	197679551
NM_021029	chrX	+	100645877	100651142	RPL36A	5265	100643377	100648377
NM_001199974	chrX	+	100645877	100669128	RPL36A-HNRNPH2	23251	100643377	100648377
NM_000997	chr5	-	40831429	40835387	RPL37	3958	40832887	40837887
NM_000998	chr2	+	217363519	217366188	RPL37A	2669	217361019	217366019
NM_000999	chr17	+	72199794	72206019	RPL38	6225	72197294	72202294
NM_001000	chrX	-	118920466	118925622	RPL39	5156	118923122	118928122
NM_052969	chr3	-	186838738	186857311	RPL39L	18573	186854811	186859811
NM_005061	chr16	-	1994579	2004679	RPL3L	10100	2002179	2007179
NM_000968	chr15	-	66791652	66797193	RPL4	5541	66794693	66799693
NM_000969	chr1	+	93297542	93307481	RPL5	9939	93295042	93300042
NM_001320141	chr12	-	112842984	112856647	RPL6	13663	112854147	112859147
NM_000971	chr8	-	74202873	74205869	RPL7	2996	74203369	74208369
NM_000972	chr9	+	136215068	136218280	RPL7A	3212	136212568	136217568
NR_134563	chr6	+	42847353	42857634	RPL7L1	10281	42844853	42849853
NM_000973	chr8	-	146015149	146017831	RPL8	2682	146015331	146020331
NM_001024921	chr4	-	39455744	39460568	RPL9	4824	39458068	39463068
NM_001002	chr12	-	120634502	120639014	RPLP0	4512	120636514	120641514
NR_002775	chr11	+	61382507	61406921	RPLP0P2	24414	61380007	61385007
NM_001003	chr15	+	69745158	69747884	RPLP1	2726	69742658	69747658
NM_001004	chr11	+	809935	812876	RPLP2	2941	807435	812435
NM_002950	chr3	-	128338812	128369719	RPN1	30907	128367219	128372219
NM_001324306	chr20	+	35807448	35870025	RPN2	62577	35804948	35809948
NM_007042	chr3	+	58291971	58305920	RPP14	13949	58289471	58294471
NM_001104546	chr10	+	92631708	92668312	RPP30	36604	92629208	92634208
NM_001097590	chr10	+	15139178	15146256	RPP38	7078	15136678	15141678
NM_001286133	chr6	-	4995279	5004297	RPP40	9018	5001797	5006797
NM_001303412	chr18	-	33569786	33647557	RPRD1A	77771	33645057	33650057
NM_021215	chr20	+	36661947	36720766	RPRD1B	58819	36659447	36664447
NM_001297674	chr1	+	150336586	150449041	RPRD2	112455	150334086	150339086
NM_001204091	chr6	-	34385230	34393902	RPS10	8672	34391402	34396402
NM_001202470	chr6	-	34254972	34393902	RPS10-NUDT3	138930	34391402	34396402
NM_001015	chr19	+	49999621	50002969	RPS11	3348	49997121	50002121
NM_001016	chr6	+	133135707	133138703	RPS12	2996	133133207	133138207
NM_001017	chr11	-	17095938	17099220	RPS13	3282	17096720	17101720
NM_005617	chr5	-	149823791	149829319	RPS14	5528	149826819	149831819
NM_001019	chr16	-	18794276	18801656	RPS15A	7380	18799156	18804156
NM_001321111	chr19	-	39923776	39926660	RPS16	2884	39924160	39929160
NR_046241	chr6	-	53199257	53202415	RPS16P5	3158	53199915	53204915
NM_001021	chr15	-	82821157	82824952	RPS17	3795	82822452	82827452
NM_022551	chr6_mcf_hap5	+	4713621	4718055	RPS18	4434	4711121	4716121
NM_001321485	chr19	+	42363987	42375484	RPS19	11497	42361487	42366487
NM_194326	chr22	-	39925097	39928860	RPS19BP1	3763	39926360	39931360
NM_002952	chr16	-	2012061	2014827	RPS2	2766	2012327	2017327
NM_001146227	chr8	-	56980738	56987140	RPS20	6402	56984640	56989640
NM_001025	chr5	-	81569138	81574235	RPS23	5097	81571735	81576735
NM_001142285	chr10	+	79793517	79816571	RPS24	23054	79791017	79796017
NM_001028	chr11	-	118886421	118889057	RPS25	2636	118886557	118891557
NM_001135592	chr2	+	55459038	55462989	RPS27A	3951	55456538	55461538
NM_015920	chr15	-	63445538	63449741	RPS27L	4203	63447241	63452241
NM_001030001	chr14	-	50037701	50053134	RPS29	15433	50050634	50055634
NM_001256802	chr11	+	75110534	75133345	RPS3	22811	75108034	75113034
NM_001006	chr4	+	152020724	152025804	RPS3A	5080	152018224	152023224
NM_001007	chrX	-	71492452	71497141	RPS4X	4689	71494641	71499641
NM_001008	chrY	+	2709622	2734997	RPS4Y1	25375	2707122	2712122
NM_001039567	chrY	+	22917953	22942918	RPS4Y2	24965	22915453	22920453
NM_001009	chr19	+	58898635	58906171	RPS5	7536	58896135	58901135
NM_001010	chr9	-	19376253	19380235	RPS6	3982	19377735	19382735
NM_002953	chr1	+	26856248	26901520	RPS6KA1	45272	26853748	26858748
NM_001318937	chr6	-	166822851	167276039	RPS6KA2	453188	167273539	167278539
NR_046793	chr6	-	166874150	166878871	RPS6KA2-IT1	4721	166876371	166881371
NM_004586	chrX	-	20168028	20284750	RPS6KA3	116722	20282250	20287250
NM_001318361	chr11	+	64126624	64139687	RPS6KA4	13063	64124124	64129124
NM_001322228	chr14	-	91334465	91526993	RPS6KA5	192528	91524493	91529493
NM_001330512	chrX	-	83313353	83442943	RPS6KA6	129590	83440443	83445443
NM_001272060	chr17	+	57970406	58027786	RPS6KB1	57380	57967906	57972906
NM_003952	chr11	+	67195934	67202879	RPS6KB2	6945	67193434	67198434
NM_012424	chr1	+	213224574	213448117	RPS6KC1	223543	213222074	213227074
NM_031464	chr14	-	75370656	75389145	RPS6KL1	18489	75386645	75391645
NM_001011	chr2	+	3622852	3628509	RPS7	5657	3620352	3625352
NR_036695	chr1	+	240170823	240176560	RPS7P5	5737	240168323	240173323
NM_001012	chr1	+	45241245	45244412	RPS8	3167	45238745	45243745
NM_001321704	chr19	+	54704725	54711515	RPS9	6790	54702225	54707225
NM_001304288	chr3	+	39448179	39454032	RPSA	5853	39445679	39450679
NR_026825	chr12	-	66151799	66220754	RPSAP52	68955	66218254	66223254
NR_003662	chr19	+	23945815	24010919	RPSAP58	65104	23943315	23948315
NM_001122965	chr1	-	152126070	152131704	RPTN	5634	152129204	152134204
NM_001163034	chr17	+	78518624	78940173	RPTOR	421549	78516124	78521124
NM_058192	chr16	-	834973	838383	RPUSD1	3410	835883	840883
NM_152260	chr15	+	40861491	40866893	RPUSD2	5402	40858991	40863991
NM_173659	chr3	-	9879486	9885743	RPUSD3	6257	9883243	9888243
NM_032795	chr11	-	126071988	126081587	RPUSD4	9599	126079087	126084087
NM_001128850	chr16	-	66955581	66959439	RRAD	3858	66956939	66961939
NM_016656	chrX	+	55744109	55785207	RRAGB	41098	55741609	55746609
NM_022157	chr1	-	39303868	39325495	RRAGC	21627	39322995	39327995
NM_021244	chr6	-	90074334	90121995	RRAGD	47661	90119495	90124495
NM_006270	chr19	-	50138548	50143400	RRAS	4852	50140900	50145900
NM_001177314	chr11	-	14299465	14386052	RRAS2	86587	14383552	14388552
NM_001042576	chr20	-	17594322	17662928	RRBP1	68606	17660428	17665428
NM_001168344	chr6	+	7107829	7252213	RREB1	144384	7105329	7110329
NM_006583	chr4	+	110749149	110765861	RRH	16712	110746649	110751649
NM_001033	chr11	+	4115914	4160155	RRM1	44241	4113414	4118414
NM_001165931	chr2	+	10262694	10271546	RRM2	8852	10260194	10265194
NM_001172478	chr8	-	103216728	103251346	RRM2B	34618	103248846	103253846
NM_001301064	chr16	-	15153878	15188192	RRN3	34314	15185692	15190692
NR_003370	chr16	-	21807950	21830495	RRN3P1	22545	21827995	21832995
NR_003369	chr16	+	29086162	29128038	RRN3P2	41876	29083662	29088662
NR_027460	chr16	-	22430866	22449036	RRN3P3	18170	22446536	22451536
NM_015997	chr1	+	156698262	156706752	RRNAD1	8490	156695762	156700762
NM_003683	chr21	+	45209417	45223983	RRP1	14566	45206917	45211917
NM_001284337	chr10	-	99116457	99161127	RRP12	44670	99158627	99163627
NM_016052	chr1	+	218458628	218511325	RRP15	52697	218456128	218461128
NM_015056	chr21	+	45079431	45115960	RRP1B	36529	45076931	45081931
NM_001329704	chr6	+	42989339	42997337	RRP36	7998	42986839	42991839
NM_015703	chr22	-	42904340	42915829	RRP7A	11489	42913329	42918329
NR_002184	chr22	-	42969265	42978017	RRP7BP	8752	42975517	42980517
NM_015324	chr11	-	6621143	6624880	RRP8	3737	6622380	6627380
NM_004704	chr3	-	51967441	51975957	RRP9	8516	51973457	51978457
NR_040434	chr8	-	67331821	67341212	RRS1-AS1	9391	67338712	67343712
NM_000330	chrX	-	18657807	18690223	RS1	32416	18687723	18692723
NR_130911	chr17	+	48556160	48563341	RSAD1	7181	48553660	48558660
NM_080657	chr2	+	7017795	7038363	RSAD2	20568	7015295	7020295
NR_130896	chr1	-	114304453	114355098	RSBN1	50645	114352598	114357598
NM_198467	chr7	+	77325742	77409120	RSBN1L	83378	77323242	77328242
NM_016578	chr11	-	77377273	77531880	RSF1	154607	77529380	77534380
NM_030907	chr1	-	16558181	16563659	RSG1	5478	16561159	16566159
NM_015659	chr16	-	11928054	11945442	RSL1D1	17388	11942942	11947942
NM_016304	chr15	-	55473511	55489231	RSL24D1	15720	55486731	55491731
NM_001286506	chr21	-	43892596	43916464	RSPH1	23868	43913964	43918964
NM_173565	chr7	+	6793739	6838396	RSPH10B	44657	6791239	6796239
NM_001099697	chr7	+	6793739	6838396	RSPH10B2	44657	6791239	6796239
NM_014433	chr22	-	23401592	23484241	RSPH14	82649	23481741	23486741
NM_031924	chr6	-	159393902	159421219	RSPH3	27317	159418719	159423719
NM_001010892	chr6	+	116937641	116954148	RSPH4A	16507	116935141	116940141
NM_030785	chr19	-	46298967	46318605	RSPH6A	19638	46316105	46321105
NM_001193341	chr6	+	43612766	43638748	RSPH9	25982	43610266	43615266
NM_001038633	chr1	-	38076950	38100595	RSPO1	23645	38098095	38103095
NM_178565	chr8	-	108911543	109095913	RSPO2	184370	109093413	109098413
NM_032784	chr6	+	127440047	127520626	RSPO3	80579	127437547	127442547
NM_001029871	chr20	-	939095	982907	RSPO4	43812	980407	985407
NM_001305163	chr16	+	57220195	57274387	RSPRY1	54192	57217695	57222695
NM_001271834	chr3	+	157827840	158262624	RSRC1	434784	157825340	157830340
NR_036435	chr12	-	122989189	123011560	RSRC2	22371	123009060	123014060
NM_001321772	chr1	-	25568727	25664745	RSRP1	96018	25662245	25667245
NM_012425	chr10	-	16632616	16859453	RSU1	226837	16856953	16861953
NR_024472	chr10	-	45594923	45650044	RSU1P2	55121	45647544	45652544
NM_031429	chr19	-	12936290	12946242	RTBDN	9952	12943742	12948742
NM_003729	chr1	+	100731713	100758325	RTCA	26612	100729213	100734213
NM_014306	chr22	-	32783561	32808274	RTCB	24713	32805774	32810774
NM_001283009	chr20	+	62289162	62327606	RTEL1	38444	62286662	62291662
NR_037882	chr20	+	62289162	62330051	RTEL1-TNFRSF6B	40889	62286662	62291662
NM_015138	chr15	+	41709301	41775761	RTF1	66460	41706801	41711801
NM_001283037	chr20	+	55043640	55093942	RTFDC1	50302	55041140	55046140
NM_001015055	chr2	-	74652987	74669060	RTKN	16073	74666560	74671560
NM_145307	chr10	-	63952844	64028622	RTKN2	75778	64026122	64031122
NM_001134888	chr14	-	101346991	101351184	RTL1	4193	101348684	101353684
NM_024627	chr22	-	19833660	19842371	RTL10	8711	19839871	19844871
NM_152694	chrX	-	77911565	77914825	RTL3	3260	77912325	77917325
NM_001004308	chrX	+	111326252	111700473	RTL4	374221	111323752	111328752
NM_001024455	chrX	-	71346960	71351751	RTL5	4791	71349251	71354251
NM_032287	chr22	-	44888449	44894005	RTL6	5556	44891505	44896505
NM_020769	chrX	+	109662284	109699562	RTL9	37278	109659784	109664784
NM_021136	chr14	-	60062693	60337557	RTN1	274864	60335057	60340057
NM_206900	chr19	-	45988545	46000313	RTN2	11768	45997813	46002813
NM_201430	chr11	+	63448921	63527363	RTN3	78442	63446421	63451421
NM_001321904	chr2	-	55199325	55364967	RTN4	165642	55362467	55367467
NM_001318746	chr6	-	107018645	107078366	RTN4IP1	59721	107075866	107080866
NM_023004	chr22	-	20228937	20255816	RTN4R	26879	20253316	20258316
NM_178568	chr17	-	1837970	1928639	RTN4RL1	90669	1926139	1931139
NM_178570	chr11	+	57228009	57245012	RTN4RL2	17003	57225509	57230509
NM_153708	chr3	+	186915273	186919253	RTP1	3980	186912773	186917773
NM_001004312	chr3	-	187416046	187420345	RTP2	4299	187417845	187422845
NM_031440	chr3	+	46539484	46542439	RTP3	2955	46536984	46541984
NM_022147	chr3	+	187086167	187089369	RTP4	3202	187083667	187088667
NM_173821	chr2	+	242811885	242815482	RTP5	3597	242809385	242814385
NM_001318520	chr18	-	67671042	67872962	RTTN	201920	67870462	67875462
NM_001145642	chr3	-	197395737	197476570	RUBCN	80833	197474070	197479070
NM_001286761	chr13	-	46915873	46964177	RUBCNL	48304	46961677	46966677
NM_025158	chr5	+	178977561	179037027	RUFY1	59466	178975061	178980061
NR_103476	chr10	-	70100863	70167051	RUFY2	66188	70164551	70169551
NM_001037442	chr4	+	71587558	71674339	RUFY3	86781	71585058	71590058
NR_034176	chr2	+	218899656	218955304	RUFY4	55648	218897156	218902156
NM_173079	chr17	+	41132578	41147160	RUNDC1	14582	41130078	41135078
NM_001144825	chr17	+	42385926	42396038	RUNDC3A	10112	42383426	42388426
NR_110802	chr17	-	42376941	42385799	RUNDC3A-AS1	8858	42383299	42388299
NM_001134405	chr7	+	87257728	87461613	RUNDC3B	203885	87255228	87260228
NM_001754	chr21	-	36160097	36421595	RUNX1	261498	36419095	36424095
NM_175634	chr8	-	92967194	93115454	RUNX1T1	148260	93112954	93117954
NM_001024630	chr6	+	45296053	45518819	RUNX2	222766	45293553	45298553
NM_001320672	chr1	-	25226001	25291501	RUNX3	65500	25289001	25294001
NM_001105203	chr1	+	155290639	155300909	RUSC1	10270	155288139	155293139
NR_145424	chr1	-	155286644	155293967	RUSC1-AS1	7323	155291467	155296467
NM_014806	chr9	+	35489829	35561895	RUSC2	72066	35487329	35492329
NM_001319086	chr3	-	127783627	127872757	RUVBL1	89130	127870257	127875257
NR_046645	chr3	+	127794652	127797899	RUVBL1-AS1	3247	127792152	127797152
NM_006666	chr19	+	49496704	49519252	RUVBL2	22548	49494204	49499204
NM_016104	chr6	+	116892529	116914764	RWDD1	22235	116890029	116895029
NM_001322339	chr6	+	83903031	83908654	RWDD2A	5623	83900531	83905531
NM_001320724	chr21	-	30378079	30391692	RWDD2B	13613	30389192	30394192
NM_001278247	chr1	+	95699710	95712781	RWDD3	13071	95697210	95702210
NM_001307922	chr4	-	184560787	184580372	RWDD4	19585	184577872	184582872
NM_001253730	chr4	+	159442865	159574521	RXFP1	131656	159440365	159445365
NM_001166058	chr13	+	32313678	32377009	RXFP2	63331	32311178	32316178
NM_016568	chr5	+	33936490	33939023	RXFP3	2533	33933990	33938990
NM_002957	chr9	+	137218308	137332432	RXRA	114124	137215808	137220808
NM_001291989	chr6_qbl_hap6	-	4393583	4400853	RXRB	7270	4398353	4403353
NM_006917	chr1	-	165370158	165414592	RXRG	44434	165412092	165417092
NM_012234	chr3	-	72423743	72495774	RYBP	72031	72493274	72498274
NM_002958	chr3	-	133875977	133969586	RYK	93609	133967086	133972086
NM_000540	chr19	+	38924339	39078204	RYR1	153865	38921839	38926839
NM_001035	chr1	+	237205701	237997288	RYR2	791587	237203201	237208201
NM_001036	chr15	+	33603162	34158304	RYR3	555142	33600662	33605662
NM_006271	chr1	+	153600872	153604513	S100A1	3641	153598372	153603372
NM_002966	chr1	-	151955385	151966714	S100A10	11329	151964214	151969214
NM_005620	chr1	-	152004981	152009511	S100A11	4530	152007011	152012011
NM_001024210	chr1	-	153591275	153606568	S100A13	15293	153604068	153609068
NR_133645	chr1	-	153579358	153585644	S100A16	6286	153583144	153588144
NM_005978	chr1	-	153533584	153538306	S100A2	4722	153535806	153540806
NM_002962	chr1	-	153509622	153514241	S100A5	4619	153511741	153516741
NM_002963	chr1	-	153430219	153433137	S100A7	2918	153430637	153435637
NM_176823	chr1	+	153388999	153395701	S100A7A	6702	153386499	153391499
NM_001045479	chr1	-	153409470	153412503	S100A7L2	3033	153410003	153415003
NM_001319198	chr1	-	153362507	153395059	S100A8	32552	153392559	153397559
NM_002965	chr1	+	153330329	153333503	S100A9	3174	153327829	153332829
NM_006272	chr21	-	48018530	48025035	S100B	6505	48022535	48027535
NM_004057	chrX	+	16668280	16672791	S100G	4511	16665780	16670780
NM_005980	chr4	+	6695565	6698897	S100P	3332	6693065	6698065
NM_001256121	chr1	+	33283042	33324480	S100PBP	41438	33280542	33285542
NM_130772	chr5	+	76145825	76217056	S100Z	71231	76143325	76148325
NM_001400	chr1	+	101702304	101707076	S1PR1	4772	101699804	101704804
NM_004230	chr19	-	10332108	10341948	S1PR2	9840	10339448	10344448
NM_005226	chr9	+	91606323	91620069	S1PR3	13746	91603823	91608823
NM_001166215	chr19	-	10623417	10628668	S1PR5	5251	10626168	10631168
NM_000331	chr11	+	18287771	18291523	SAA1	3752	18285271	18290271
NM_001127380	chr11	-	18259779	18270221	SAA2	10442	18267721	18272721
NM_001199744	chr11	-	18252901	18270221	SAA2-SAA4	17320	18267721	18272721
NR_026576	chr11	-	18134018	18137679	SAA3P	3661	18135179	18140179
NM_006512	chr11	-	18252901	18258384	SAA4	5483	18255884	18260884
NM_138421	chr11	-	18101889	18127638	SAAL1	25749	18125138	18130138
NM_013299	chr11	+	64808375	64812300	SAC3D1	3925	64805875	64810875
NM_001319072	chr3	+	45730732	45786917	SACM1L	56185	45728232	45733232
NM_014363	chr13	-	23902961	24007867	SACS	104906	24005367	24010367
NR_103450	chr13	+	23993109	24003008	SACS-AS1	9899	23990609	23995609
NM_001145713	chr19	+	47634079	47713893	SAE1	79814	47631579	47636579
NM_001201339	chr19	+	5623045	5668489	SAFB	45444	5620545	5625545
NM_014649	chr19	-	5587009	5622938	SAFB2	35929	5620438	5625438
NM_000541	chr2	+	234216308	234255701	SAG	39393	234213808	234218808
NM_018666	chrX	+	134975784	134995220	SAGE1	19436	134973284	134978284
NR_147090	chrX	-	134812380	134819809	SAGE2P	7429	134817309	134822309
NM_002968	chr16	-	51169885	51185183	SALL1	15298	51182683	51187683
NR_111966	chr14	-	21989230	22005350	SALL2	16120	22002850	22007850
NM_171999	chr18	+	76740274	76758969	SALL3	18695	76737774	76742774
NM_001318031	chr20	-	50399255	50419062	SALL4	19807	50416562	50421562
NM_138352	chr19	-	14198657	14201387	SAMD1	2730	14198887	14203887
NM_080621	chr20	-	62605465	62610995	SAMD10	5530	62608495	62613495
NM_152486	chr1	+	861120	879961	SAMD11	18841	858620	863620
NR_146234	chr8	-	119144066	119634184	SAMD12	490118	119631684	119636684
NR_038210	chr8	+	119633239	119738306	SAMD12-AS1	105067	119630739	119635739
NM_001010971	chr1	+	84764048	84816481	SAMD13	52433	84761548	84766548
NM_001257359	chr17	-	48188672	48207246	SAMD14	18574	48204746	48209746
NM_001010860	chr14	+	77843720	77857643	SAMD15	13923	77841220	77846220
NM_001258275	chr6	-	130465446	130686570	SAMD3	221124	130684070	130689070
NM_015589	chr14	+	55034329	55260033	SAMD4A	225704	55031829	55036829
NM_018028	chr19	+	39833098	39875537	SAMD4B	42439	39830598	39835598
NM_001030060	chr6	+	147829827	147891157	SAMD5	61330	147827327	147832327
NM_001304366	chr3	+	169629359	169656956	SAMD7	27597	169626859	169631859
NM_144660	chr10	+	76871392	76941881	SAMD8	70489	76868892	76873892
NM_001193307	chr7	-	92728825	92747336	SAMD9	18511	92744836	92749836
NM_001350084	chr7	-	92759366	92777712	SAMD9L	18346	92775212	92780212
NM_015474	chr20	-	35520226	35580246	SAMHD1	60020	35577746	35582746
NM_015380	chr22	+	44351260	44392412	SAMM50	41152	44348760	44353760
NR_110000	chr3	+	70048894	70064451	SAMMSON	15557	70046394	70051394
NM_001256370	chr21	-	15857548	15955723	SAMSN1	98175	15953223	15958223
NR_046512	chr21	+	15954522	15970624	SAMSN1-AS1	16102	15952022	15957022
NM_001330302	chr2	-	128698790	128785694	SAP130	86904	128783194	128788194
NM_005870	chr13	+	21714652	21723224	SAP18	8572	21712152	21717152
NM_003864	chr4	+	174292092	174298683	SAP30	6591	174289592	174294592
NM_001301855	chr17	+	73663195	73704142	SAP30BP	40947	73660695	73665695
NM_001131063	chr5	+	153825516	153840613	SAP30L	15097	153823016	153828016
NR_037897	chr5	-	153769328	153825382	SAP30L-AS1	56054	153822882	153827882
NM_178448	chr9	-	139956578	139965028	SAPCD2	8450	139962528	139967528
NM_001142648	chr10	-	71909960	71930285	SAR1A	20325	71927785	71932785
NM_016103	chr5	-	133936838	133968533	SAR1B	31695	133966033	133971033
NM_001284239	chr8	-	29920527	29940724	SARAF	20197	29938224	29943224
NM_007101	chr9	-	136528683	136605077	SARDH	76394	136602577	136607577
NM_015077	chr17	+	26698682	26728055	SARM1	29373	26696182	26701182
NR_026723	chr12	-	56146246	56211540	SARNP	65294	56209040	56214040
NM_001330669	chr1	+	109756514	109780804	SARS	24290	109754014	109759014
NM_017827	chr19	-	39405903	39421536	SARS2	15633	39419036	39424036
NM_005146	chr11	+	65729159	65747607	SART1	18448	65726659	65731659
NM_014706	chr12	-	108915990	108955165	SART3	39175	108952665	108957665
NM_001346505	chr6	+	148593411	148873186	SASH1	279775	148590911	148595911
NM_018990	chrX	+	128913891	128929176	SASH3	15285	128911391	128916391
NM_194292	chr1	-	100549100	100598651	SASS6	49551	100596151	100601151
NR_027783	chrX	+	23801274	23804340	SAT1	3066	23798774	23803774
NM_001322874	chr3	-	18386879	18487080	SATB1	100201	18484580	18489580
NR_125803	chr3	+	18486728	18571606	SATB1-AS1	84878	18484228	18489228
NM_015265	chr2	-	200134222	200335989	SATB2	201767	200333489	200338489
NR_026830	chr2	+	200332820	200337481	SATB2-AS1	4661	200330320	200335320
NM_001012980	chrX	-	84347291	84363974	SATL1	16683	84361474	84366474
NM_021818	chr14	-	51100297	51135071	SAV1	34774	51132571	51137571
NM_001287049	chr9	-	18927657	19049352	SAXO1	121695	19046852	19051852
NM_001348703	chr15	+	82555151	82577267	SAXO2	22116	82552651	82557651
NM_018322	chr6	-	39071838	39082962	SAYSD1	11124	39080462	39085462
NM_016038	chr7	-	66452663	66460683	SBDS	8020	66458183	66463183
NR_024111	chr7	+	72299951	72307978	SBDSP1	8027	72297451	72302451
NM_002972	chr22	-	50883430	50913500	SBF1	30070	50911e3	50916e3
NR_027765	chr8	-	56361756	56367881	SBF1P1	6125	56365381	56370381
NM_030962	chr11	-	9800213	10315754	SBF2	515541	10313254	10318254
NR_036485	chr11	+	9779839	9832866	SBF2-AS1	53027	9777339	9782339
NM_001024401	chr16	+	28303839	28335170	SBK1	31331	28301339	28306339
NM_001101401	chr19	-	56041099	56048435	SBK2	7336	56045935	56050935
NM_001199824	chr19	-	56052022	56056909	SBK3	4887	56054409	56059409
NM_001167856	chr12	-	123773655	123849756	SBNO1	76101	123847256	123852256
NM_014963	chr19	-	1107632	1174282	SBNO2	66650	1171782	1176782
NM_001166035	chr19	-	36014268	36019253	SBSN	4985	36016753	36021753
NM_153225	chr8	-	73976777	74005507	SBSPON	28730	74003007	74008007
NM_006918	chr11	+	121163387	121184119	SC5D	20732	121160887	121165887
NM_021228	chr19	+	50145381	50161906	SCAF1	16525	50142881	50147881
NM_004719	chr12	-	46312913	46384401	SCAF11	71488	46381901	46386901
NM_020706	chr21	-	33043312	33104431	SCAF4	61119	33101931	33106931
NM_014892	chr6	+	155054511	155155378	SCAF8	100867	155052011	155057011
NM_001144877	chr9	-	127704887	127905838	SCAI	200951	127903338	127908338
NM_001290229	chr5	+	77656326	77776562	SCAMP1	120236	77653826	77658826
NM_001320778	chr15	-	75136070	75165720	SCAMP2	29650	75163220	75168220
NM_005698	chr1	-	155225769	155232176	SCAMP3	6407	155229676	155234676
NM_001329539	chr19	+	1905212	1926016	SCAMP4	20804	1902712	1907712
NM_001178111	chr15	+	75287875	75313836	SCAMP5	25961	75285375	75290375
NR_004859	chr15	+	85174690	85185694	SCAND2P	11004	85172190	85177190
NM_012235	chr3	-	47455174	47517449	SCAP	62275	47514949	47519949
NM_001353009	chr15	-	76640525	77197798	SCAPER	557273	77195298	77200298
NM_182826	chr8	+	27491576	27534286	SCARA3	42710	27489076	27494076
NM_173833	chr8	-	27727398	27850369	SCARA5	122971	27847869	27852869
NM_005505	chr12	-	125262173	125348519	SCARB1	86346	125346019	125351019
NM_005506	chr4	-	77079891	77135052	SCARB2	55161	77132552	77137552
NR_028075	chr17	-	1537151	1549083	SCARF1	11932	1546583	1551583
NM_153334	chr22	-	20778873	20792146	SCARF2	13273	20789646	20794646
NR_002934	chr10	+	135267431	135281949	SCART1	14518	135264931	135269931
NM_016002	chr1	+	246887377	246931440	SCCPDH	44063	246884877	246889877
NM_005063	chr10	+	102106771	102124588	SCD	17817	102104271	102109271
NM_001037582	chr4	-	83550689	83720010	SCD5	169321	83717510	83722510
NM_001160706	chr13	+	78109808	78219398	SCEL	109590	78107308	78112308
NR_126412	chr13	-	78173890	78180686	SCEL-AS1	6796	78178186	78183186
NM_001283031	chr14	+	31091459	31205033	SCFD1	113574	31088959	31093959
NM_152540	chr4	-	53739150	54232242	SCFD2	493092	54229742	54234742
NM_003469	chr2	-	224461657	224467217	SCG2	5560	224464717	224469717
NM_001165257	chr15	+	51973549	52013223	SCG3	39674	51971049	51976049
NM_003020	chr15	+	32933813	32989299	SCG5	55486	32931313	32936313
NM_003357	chr11	+	62186506	62190678	SCGB1A1	4172	62184006	62189006
NR_027620	chr19	-	35067637	35167936	SCGB1B2P	100299	35165436	35170436
NM_006552	chr11	+	61957709	61961009	SCGB1D1	3300	61955209	61960209
NM_006551	chr11	+	62009723	62012280	SCGB1D2	2557	62007223	62012223
NM_206998	chr11	-	62063753	62066536	SCGB1D4	2783	62064036	62069036
NM_002407	chr11	+	61976139	61981411	SCGB2A1	5272	61973639	61978639
NM_002411	chr11	+	62037626	62040629	SCGB2A2	3003	62035126	62040126
NM_001025591	chr19	-	35081529	35085490	SCGB2B2	3961	35082990	35087990
NM_054023	chr5	+	147258273	147261756	SCGB3A2	3483	147255773	147260773
NM_006998	chr6	+	25652428	25702008	SCGN	49580	25649928	25654928
NM_001197108	chr3	+	158991035	159615155	SCHIP1	624120	158988535	158993535
NR_104319	chr2	+	181556830	181781666	SCHLAP1	224836	181554330	181559330
NM_001271842	chr17	-	5112215	5138155	SCIMP	25940	5135655	5140655
NM_001112706	chr7	+	12610202	12693228	SCIN	83026	12607702	12612702
NM_144643	chr4	-	129805147	130014762	SCLT1	209615	130012262	130017262
NM_016510	chr2	+	238969564	239008054	SCLY	38490	238967064	238972064
NM_001172218	chr1	-	41492870	41707815	SCMH1	214945	41705315	41710315
NM_001037540	chrX	+	17755568	17773108	SCML1	17540	17753068	17758068
NR_033717	chrX	-	18257432	18372844	SCML2	115412	18370344	18375344
NM_198081	chr6	-	108023360	108145521	SCML4	122161	108143021	108148021
NM_001293307	chr3	-	38738836	38835501	SCN10A	96665	38833001	38838001
NM_001349253	chr3	-	38887259	39093436	SCN11A	206177	39090936	39095936
NM_001202435	chr2	-	166845669	167005642	SCN1A	159973	167003142	167008142
NM_001037	chr19	+	35521591	35531353	SCN1B	9762	35519091	35524091
NM_001040142	chr2	+	166095911	166248820	SCN2A	152909	166093411	166098411
NM_004588	chr11	-	118033518	118047337	SCN2B	13819	118044837	118049837
NM_001081676	chr2	-	165944029	166060577	SCN3A	116548	166058077	166063077
NM_018400	chr11	-	123499894	123525315	SCN3B	25421	123522815	123527815
NM_000334	chr17	-	62015913	62050278	SCN4A	34365	62047778	62052778
NM_174934	chr11	-	118004091	118023630	SCN4B	19539	118021130	118026130
NM_001160161	chr3	-	38589552	38691164	SCN5A	101612	38688664	38693664
NM_002976	chr2	-	167260082	167343481	SCN7A	83399	167340981	167345981
NM_001177984	chr12	+	51985019	52206648	SCN8A	221629	51982519	51987519
NM_002977	chr2	-	167051696	167232497	SCN9A	180801	167229997	167234997
NM_024041	chr1	+	151138497	151142773	SCNM1	4276	151135997	151140997
NM_001159575	chr12	-	6456008	6486523	SCNN1A	30515	6484023	6489023
NM_000336	chr16	+	23313590	23392620	SCNN1B	79030	23311090	23316090
NR_037668	chr1	+	1215815	1227409	SCNN1D	11594	1213315	1218315
NM_001039	chr16	+	23194039	23228200	SCNN1G	34161	23191539	23196539
NM_004589	chr17	-	10583648	10600885	SCO1	17237	10598385	10603385
NM_001169109	chr22	-	50961996	50964868	SCO2	2872	50962368	50967368
NM_032547	chr4	+	141178439	141303710	SCOC	125271	141175939	141180939
NR_033939	chr4	-	141204879	141294546	SCOC-AS1	89667	141292046	141297046
NM_002979	chr1	+	53392900	53517289	SCP2	124389	53390400	53395400
NM_021626	chr17	+	55055467	55084129	SCPEP1	28662	55052967	55057967
NM_001329597	chr4	-	174309298	174440389	SCRG1	131091	174437889	174442889
NM_015356	chr8	-	144873089	144897549	SCRIB	24460	144895049	144900049
NM_001145514	chr7	-	29959718	30029905	SCRN1	70187	30027405	30032405
NM_138355	chr17	-	45915046	45918699	SCRN2	3653	45916199	45921199
NM_024583	chr2	+	175260456	175294303	SCRN3	33847	175257956	175262956
NM_031309	chr8	-	145554227	145559943	SCRT1	5716	145557443	145562443
NM_033129	chr20	-	642239	656823	SCRT2	14584	654323	659323
NM_002980	chr2	-	120197418	120282028	SCTR	84610	120279528	120284528
NM_173050	chr22	-	43599228	43739394	SCUBE1	140166	43736894	43741894
NM_001330199	chr11	-	9041046	9113154	SCUBE2	72108	9110654	9115654
NM_001303136	chr6	+	35181838	35220856	SCUBE3	39018	35179338	35184338
NM_020680	chr11	+	65292547	65306182	SCYL1	13635	65290047	65295047
NM_001317784	chr12	+	100660917	100735502	SCYL2	74585	100658417	100663417
NM_181093	chr1	-	169822214	169863100	SCYL3	40886	169860600	169865600
NM_018115	chr4	-	76871058	76912115	SDAD1	41057	76909615	76914615
NR_144550	chr8	-	26236775	26240469	SDAD1P1	3694	26237969	26242969
NM_001006946	chr2	-	20400557	20425194	SDC1	24637	20422694	20427694
NM_002998	chr8	+	97505881	97624037	SDC2	118156	97503381	97508381
NM_014654	chr1	-	31342312	31381480	SDC3	39168	31378980	31383980
NM_002999	chr20	-	43953928	43977064	SDC4	23136	43974564	43979564
NM_001348341	chr8	+	59465482	59495419	SDCBP	29937	59462982	59467982
NM_080489	chr20	-	1290554	1309879	SDCBP2	19325	1307379	1312379
NR_040047	chr20	+	1305986	1359379	SDCBP2-AS1	53393	1303486	1308486
NM_006643	chr9	-	139296373	139305054	SDCCAG3	8681	139302554	139307554
NM_001350249	chr1	+	243419306	243663394	SDCCAG8	244088	243416806	243421806
NM_152608	chr1	-	226170402	226187066	SDE2	16664	226184566	226189566
NR_045585	chr17	-	26975373	26989207	SDF2	13834	26986707	26991707
NM_016176	chr1	-	1152287	1167447	SDF4	15160	1164947	1169947
NM_004168	chr5	+	218337	257197	SDHA	38860	215837	220837
NM_017841	chr11	+	61197596	61214239	SDHAF2	16643	61195096	61200096
NM_020186	chr7	+	96745904	96811075	SDHAF3	65171	96743404	96748404
NM_145267	chr6	+	71276624	71298606	SDHAF4	21982	71274124	71279124
NR_003264	chr3	-	195686791	195717150	SDHAP1	30359	195714650	195719650
NR_003265	chr3	+	195384909	195415735	SDHAP2	30826	195382409	195387409
NR_003263	chr5	-	1572072	1594646	SDHAP3	22574	1592146	1597146
NM_003000	chr1	-	17345224	17380665	SDHB	35441	17378165	17383165
NM_001278172	chr1	+	161284165	161334535	SDHC	50370	161281665	161286665
NR_077060	chr11	+	111957547	111966525	SDHD	8978	111955047	111960047
NM_152744	chr7	+	3341079	4308631	SDK1	967552	3338579	3343579
NM_001144952	chr17	-	71330522	71640227	SDK2	309705	71637727	71642727
NM_138969	chr8	-	57212206	57233335	SDR16C5	21129	57230835	57235835
NR_103832	chr8	-	57287276	57303269	SDR16C6P	15993	57300769	57305769
NM_001290292	chr14	-	24908971	24912111	SDR39U1	3140	24909611	24914611
NM_145168	chr16	-	82031250	82045093	SDR42E1	13843	82042593	82047593
NM_148897	chr12	-	57316937	57328189	SDR9C7	11252	57325689	57330689
NM_006843	chr12	-	113830250	113841692	SDS	11442	113839192	113844192
NM_001304993	chr12	+	113860194	113876081	SDSL	15887	113857694	113862694
NM_014300	chr15	-	85212767	85259691	SEC11A	46924	85257191	85262191
NM_001307941	chr18	+	56807088	56826069	SEC11C	18981	56804588	56809588
NM_030673	chr3	-	10342612	10362872	SEC13	20260	10360372	10365372
NM_001204408	chr17	+	75084724	75213181	SEC14L1	128457	75082224	75087224
NR_026952	chr11	+	43918852	43921424	SEC14L1P1	2572	43916352	43921352
NM_001204204	chr22	+	30792929	30821291	SEC14L2	28362	30790429	30795429
NM_001257378	chr22	-	30855215	30868034	SEC14L3	12819	30865534	30870534
NM_001161368	chr22	-	30884897	30901698	SEC14L4	16801	30899198	30904198
NM_014692	chr16	+	5008317	5069156	SEC14L5	60839	5005817	5010817
NM_001193336	chr22	-	30920916	30942669	SEC14L6	21753	30940169	30945169
NM_001276418	chr9	-	139334547	139378211	SEC16A	43664	139375711	139380711
NM_033127	chr1	-	177898241	177939050	SEC16B	40809	177936550	177941550
NR_004401	chr19	+	49141295	49185502	SEC1P	44207	49138795	49143795
NM_012430	chr3	+	122920773	122992982	SEC22A	72209	122918273	122923273
NM_004892	chr1	+	145096406	145116997	SEC22B	20591	145093906	145098906
NM_001201572	chr3	-	42589458	42642572	SEC22C	53114	42640072	42645072
NM_006364	chr14	-	39501122	39572732	SEC23A	71610	39570232	39575232
NM_006363	chr20	+	18488187	18542050	SEC23B	53863	18485687	18490687
NR_037771	chr10	+	121652084	121704170	SEC23IP	52086	121649584	121654584
NM_021982	chr5	+	133984474	134063601	SEC24A	79127	133981974	133986974
NM_001300813	chr4	+	110354870	110461615	SEC24B	106745	110352370	110357370
NR_039978	chr4	-	110351118	110354973	SEC24B-AS1	3855	110352473	110357473
NM_198597	chr10	+	75504130	75531933	SEC24C	27803	75501630	75506630
NM_001318066	chr4	-	119643977	119757351	SEC24D	113374	119754851	119759851
NM_001318120	chr4	-	83739661	83821724	SEC31A	82063	83819224	83824224
NM_015490	chr10	-	102246402	102279595	SEC31B	33193	102277095	102282095
NM_013336	chr3	+	127771211	127790526	SEC61A1	19315	127768711	127773711
NR_024577	chr10	+	12171639	12211957	SEC61A2	40318	12169139	12174139
NM_006808	chr9	+	101984569	101992901	SEC61B	8332	101982069	101987069
NM_001012456	chr7	-	54819939	54826939	SEC61G	7000	54824439	54829439
NM_003262	chr3	+	169684579	169716161	SEC62	31582	169682079	169687079
NM_007214	chr6	-	108188959	108279482	SEC63	90523	108276982	108281982
NM_001282689	chr9	+	91933387	91974578	SECISBP2	41191	91930887	91935887
NM_001193489	chr15	-	49280834	49338760	SECISBP2L	57926	49336260	49341260
NM_003004	chr17	-	80278899	80291921	SECTM1	13022	80289421	80294421
NM_031216	chr18	+	12947982	12987536	SEH1L	39554	12945482	12950482
NM_005065	chr14	-	81937890	82000205	SEL1L	62315	81997705	82002705
NR_073207	chr20	-	13830043	13975979	SEL1L2	145936	13973479	13978479
NM_001297594	chr4	-	25749048	25865217	SEL1L3	116169	25862717	25867717
NM_000450	chr1	-	169691780	169703220	SELE	11440	169700720	169705720
NM_001258289	chr1	-	151336777	151345210	SELENBP1	8433	151342710	151347710
NR_144513	chr1	-	87328127	87380260	SELENOF	52133	87377760	87382760
NM_033505	chr2	+	26568953	26618759	SELENOI	49806	26566453	26571453
NM_021237	chr3	-	53919002	53926042	SELENOK	7040	53923542	53928542
NM_080430	chr22	-	31500757	31503573	SELENOM	2816	31501073	31506073
NM_020451	chr1	+	26126666	26144713	SELENON	18047	26124166	26129166
NM_031454	chr22	+	50639407	50656045	SELENOO	16638	50636907	50641907
NM_005410	chr5	-	42799981	42812178	SELENOP	12197	42809678	42814678
NM_203472	chr15	-	101811113	101817725	SELENOS	6612	101815225	101820225
NM_016275	chr3	+	150321049	150348234	SELENOT	27185	150318549	150323549
NM_182704	chr19	+	40005752	40011326	SELENOV	5574	40003252	40008252
NM_003009	chr19	+	48281828	48287938	SELENOW	6110	48279328	48284328
NM_000655	chr1	-	169659805	169680843	SELL	21038	169678343	169683343
NM_003005	chr1	-	169558087	169599377	SELP	41290	169596877	169601877
NM_003006	chr12	-	109015679	109027670	SELPLG	11991	109025170	109030170
NM_001349701	chr7	-	96110937	96339087	SEM1	228150	96336587	96341587
NM_006080	chr7	-	83587658	83824217	SEMA3A	236559	83821717	83826717
NM_004636	chr3	+	50304989	50314602	SEMA3B	9613	50302489	50307489
NM_001350120	chr7	-	80371851	80551695	SEMA3C	179844	80549195	80554195
NM_152754	chr7	-	84624871	84751247	SEMA3D	126376	84748747	84753747
NM_012431	chr7	-	82993221	83278479	SEMA3E	285258	83275979	83280979
NM_001318798	chr3	+	50192477	50226508	SEMA3F	34031	50189977	50194977
NR_135301	chr3	-	50153454	50193518	SEMA3F-AS1	40064	50191018	50196018
NM_020163	chr3	-	52467050	52479101	SEMA3G	12051	52476601	52481601
NM_001193301	chr1	+	156119734	156147542	SEMA4A	27808	156117234	156122234
NM_001324029	chr15	+	90728151	90772892	SEMA4B	44741	90725651	90730651
NM_017789	chr2	-	97525472	97535735	SEMA4C	10263	97533235	97538235
NM_001142287	chr9	-	91975705	92094611	SEMA4D	118906	92092111	92097111
NR_073398	chr2	+	74881354	74910981	SEMA4F	29627	74878854	74883854
NM_001203244	chr10	+	102732285	102745373	SEMA4G	13088	102729785	102734785
NM_003966	chr5	-	9035137	9546233	SEMA5A	511096	9543733	9548733
NR_109935	chr5	+	9511444	9518198	SEMA5A-AS1	6754	9508944	9513944
NR_046079	chr3	-	122628039	122747452	SEMA5B	119413	122744952	122749952
NM_020796	chr5	-	115779250	115910622	SEMA6A	131372	115908122	115913122
NR_109879	chr5	+	115783193	115807369	SEMA6A-AS1	24176	115780693	115785693
NR_147170	chr5	+	115910113	115946896	SEMA6A-AS2	36783	115907613	115912613
NM_032108	chr19	-	4542599	4559771	SEMA6B	17172	4557271	4562271
NM_001178062	chr1	-	151104162	151119140	SEMA6C	14978	151116640	151121640
NM_001198999	chr15	+	47476402	48066420	SEMA6D	590018	47473902	47478902
NM_003612	chr15	-	74701624	74726300	SEMA7A	24676	74723800	74728800
NM_003007	chr20	+	43835604	43838414	SEMG1	2810	43833104	43838104
NM_003008	chr20	+	43850009	43853099	SEMG2	3090	43847509	43852509
NR_038908	chr11	-	128561566	128565918	SENCR	4352	128563418	128568418
NM_001267594	chr12	-	48436680	48500091	SENP1	63411	48497591	48502591
NM_021627	chr3	+	185304030	185348885	SENP2	44855	185301530	185306530
NM_015670	chr17	+	7465308	7475287	SENP3	9979	7462808	7467808
NR_037926	chr17	+	7465308	7482324	SENP3-EIF4A1	17016	7462808	7467808
NM_152699	chr3	+	196594726	196661584	SENP5	66858	196592226	196597226
NM_015571	chr6	+	76311224	76428001	SENP6	116777	76308724	76313724
NM_001282803	chr3	-	101043032	101232085	SENP7	189053	101229585	101234585
NM_001166340	chr15	+	72406598	72433311	SENP8	26713	72404098	72409098
NM_001195602	chr10	-	13359437	13390298	SEPHS1	30861	13387798	13392798
NM_016955	chr4	-	25121626	25162204	SEPSECS	40578	25159704	25164704
NR_037934	chr4	+	25162293	25200127	SEPSECS-AS1	37834	25159793	25164793
NM_052838	chr16	-	30389453	30394171	SEPT1	4718	30391671	30396671
NM_178584	chr2	-	110300373	110371783	SEPT10	71410	110369283	110374283
NM_001306147	chr4	+	77870866	77959768	SEPT11	88902	77868366	77873366
NM_001154458	chr16	-	4827614	4838522	SEPT12	10908	4836022	4841022
NM_207366	chr7	-	55861236	55930482	SEPT14	69246	55927982	55932982
NM_001349315	chr2	+	242254601	242293441	SEPT2	38840	242252101	242257101
NM_145733	chr22	+	42372930	42394225	SEPT3	21295	42370430	42375430
NM_001198713	chr17	-	56597610	56618179	SEPT4	20569	56615679	56620679
NR_110810	chr17	+	56597197	56634286	SEPT4-AS1	37089	56594697	56599697
NM_002688	chr22	+	19701986	19710845	SEPT5	8859	19699486	19704486
NR_037611	chr22	+	19704742	19712297	SEPT5-GP1BB	7555	19702242	19707242
NM_145800	chrX	-	118749687	118827333	SEPT6	77646	118824833	118829833
NM_001788	chr7	+	35840595	35946715	SEPT7	106120	35838095	35843095
NR_120511	chr7	-	35794573	35840235	SEPT7-AS1	45662	35837735	35842735
NR_024271	chr7	-	45763385	45808617	SEPT7P2	45232	45806117	45811117
NR_027269	chr10	-	38671997	38691780	SEPT7P9	19783	38689280	38694280
NM_001098811	chr5	-	132086508	132113067	SEPT8	26559	132110567	132115567
NM_001113491	chr17	+	75277491	75496678	SEPT9	219187	75274991	75279991
NM_032861	chr6	-	158530535	158589312	SERAC1	58777	158586812	158591812
NM_015640	chr1	-	67873492	67896123	SERBP1	22631	67893623	67898623
NM_021967	chr5	+	69321071	69338940	SERF1A	17869	69318571	69323571
NM_022978	chr5	+	69321077	69338934	SERF1B	17857	69318577	69323577
NM_001199877	chr15	+	44069293	44088287	SERF2	18994	44066793	44071793
NR_037673	chr15	+	44084173	44094769	SERF2-C15ORF63	10596	44081673	44086673
NR_104040	chr11	-	17809595	18034709	SERGEF	225114	18032209	18037209
NR_027786	chr22	+	42896584	42908566	SERHL	11982	42894084	42899084
NM_001284334	chr22	+	42949867	42970388	SERHL2	20521	42947367	42952367
NM_020755	chr6	-	122764492	122793026	SERINC1	28534	122790526	122795526
NM_001199038	chr1	+	31882411	31907527	SERINC2	25116	31879911	31884911
NM_198941	chr20	-	43124861	43150757	SERINC3	25896	43148257	43153257
NM_001258031	chr15	-	44086371	44092295	SERINC4	5924	44089795	44094795
NM_178276	chr5	-	79407049	79551901	SERINC5	144852	79549401	79554401
NM_014445	chr3	-	150259779	150264428	SERP1	4649	150261928	150266928
NM_001346980	chr13	+	44947785	44971850	SERP2	24065	44945285	44950285
NM_001127700	chr14	-	94843083	94857029	SERPINA1	13946	94854529	94859529
NM_001100607	chr14	-	94749649	94759608	SERPINA10	9959	94757108	94762108
NM_001080451	chr14	-	94908800	94919122	SERPINA11	10322	94916622	94921622
NM_173850	chr14	-	94953619	94984181	SERPINA12	30562	94981681	94986681
NR_015340	chr14	+	95107061	95113331	SERPINA13P	6270	95104561	95109561
NM_006220	chr14	-	94829974	94833039	SERPINA2	3065	94830539	94835539
NM_001085	chr14	+	95078713	95090390	SERPINA3	11677	95076213	95081213
NM_001289032	chr14	+	95027756	95036250	SERPINA4	8494	95025256	95030256
NM_000624	chr14	+	95047705	95059457	SERPINA5	11752	95045205	95050205
NM_001756	chr14	-	94770584	94789688	SERPINA6	19104	94787188	94792188
NM_000354	chrX	-	105277189	105282718	SERPINA7	5529	105280218	105285218
NM_001042518	chr14	-	94929057	94942670	SERPINA9	13613	94940170	94945170
NR_073112	chr6	-	2832565	2842283	SERPINB1	9718	2839783	2844783
NM_005024	chr18	+	61575223	61603345	SERPINB10	28122	61572723	61577723
NM_080475	chr18	+	61369537	61391127	SERPINB11	21590	61367037	61372037
NM_001307928	chr18	+	61223392	61236560	SERPINB12	13168	61220892	61225892
NM_012397	chr18	+	61254533	61266433	SERPINB13	11900	61252033	61257033
NM_002575	chr18	+	61554938	61571124	SERPINB2	16186	61552438	61557438
NM_006919	chr18	-	61322430	61329197	SERPINB3	6767	61326697	61331697
NM_175041	chr18	-	61304492	61311553	SERPINB4	7061	61309053	61314053
NM_002639	chr18	+	61144143	61172318	SERPINB5	28175	61141643	61146643
NM_001271824	chr6	-	2948392	2972399	SERPINB6	24007	2969899	2974899
NM_001040147	chr18	+	61420280	61472610	SERPINB7	52330	61417780	61422780
NM_001348367	chr18	+	61637262	61687013	SERPINB8	49751	61634762	61639762
NM_004155	chr6	-	2887499	2903546	SERPINB9	16047	2901046	2906046
NR_033851	chr6	-	2854890	2876744	SERPINB9P1	21854	2874244	2879244
NM_000488	chr1	-	173872941	173886516	SERPINC1	13575	173884016	173889016
NM_000185	chr22	+	21128382	21142008	SERPIND1	13626	21125882	21130882
NM_000602	chr7	+	100770369	100782547	SERPINE1	12178	100767869	100772869
NM_001136528	chr2	-	224839764	224904036	SERPINE2	64272	224901536	224906536
NM_001101320	chr13	+	51915167	51936239	SERPINE3	21072	51912667	51917667
NM_002615	chr17	+	1665218	1680868	SERPINF1	15650	1662718	1667718
NM_001165921	chr17	+	1646129	1658559	SERPINF2	12430	1643629	1648629
NM_000062	chr11	+	57365026	57382326	SERPING1	17300	57362526	57367526
NM_001207014	chr11	+	75273100	75283849	SERPINH1	10749	75270600	75275600
NM_001122752	chr3	+	167453431	167543357	SERPINI1	89926	167450931	167455931
NM_006217	chr3	-	167159576	167191920	SERPINI2	32344	167189420	167194420
NM_013376	chr19	-	40928408	40931932	SERTAD1	3524	40929432	40934432
NM_014755	chr2	-	64858754	64881046	SERTAD2	22292	64878546	64883546
NM_203344	chr19	-	40946747	40950282	SERTAD3	3535	40947782	40952782
NM_019605	chr1	+	210406194	210416440	SERTAD4	10246	210403694	210408694
NR_024337	chr1	-	210404803	210407466	SERTAD4-AS1	2663	210404966	210409966
NM_203451	chr13	+	37248048	37271975	SERTM1	23927	37245548	37250548
NM_014454	chr6	-	109307639	109415708	SESN1	108069	109413208	109418208
NM_031459	chr1	+	28585962	28609002	SESN2	23040	28583462	28588462
NM_001271594	chr11	-	94898676	94965705	SESN3	67029	94963205	94968205
NM_178123	chr2	-	179966418	180129350	SESTD1	162932	180126850	180131850
NM_001122821	chr9	+	131445933	131458675	SET	12742	131443433	131448433
NM_015559	chr18	+	42260862	42648475	SETBP1	387613	42258362	42263362
NM_014712	chr16	+	30968614	30995983	SETD1A	27369	30966114	30971114
NM_001353345	chr12	+	122242629	122270562	SETD1B	27933	122240129	122245129
NM_014159	chr3	-	47057897	47205467	SETD2	147570	47202967	47207967
NM_032233	chr14	-	99864082	99947226	SETD3	83144	99944726	99949726
NR_040087	chr21	-	37406838	37433116	SETD4	26278	37430616	37435616
NM_001292043	chr3	+	9439383	9519838	SETD5	80455	9436883	9441883
NM_024860	chr16	+	58549382	58554436	SETD6	5054	58546882	58551882
NM_001306199	chr4	-	140417088	140477923	SETD7	60835	140475423	140480423
NM_001171990	chr5	+	56205086	56224726	SETD9	19640	56202586	56207586
NM_012432	chr1	+	150898814	150937220	SETDB1	38406	150896314	150901314
NM_001160308	chr13	+	50018428	50069139	SETDB2	50711	50015928	50020928
NM_001320727	chr13	+	50018428	50103127	SETDB2-PHF11	84699	50015928	50020928
NM_001243723	chr3	+	4344987	4358949	SETMAR	13962	4342487	4347487
NM_001351528	chr9	-	135136742	135230373	SETX	93631	135227873	135232873
NM_001290202	chr17	-	27281946	27333458	SEZ6	51512	27330958	27335958
NM_001184776	chr22	+	26565439	26779563	SEZ6L	214124	26562939	26567939
NM_012410	chr16	-	29882479	29910585	SEZ6L2	28106	29908085	29913085
NM_201998	chr11	-	64532075	64546316	SF1	14241	64543816	64548816
NM_005877	chr22	-	30727976	30752936	SF3A1	24960	30750436	30755436
NM_007165	chr19	+	2236815	2248678	SF3A2	11863	2234315	2239315
NM_001320830	chr1	-	38422651	38455782	SF3A3	33131	38453282	38458282
NM_012433	chr2	-	198256697	198299817	SF3B1	43120	198297317	198302317
NM_006842	chr11	+	65819815	65836382	SF3B2	16567	65817315	65822315
NM_012426	chr16	+	70557690	70611571	SF3B3	53881	70555190	70560190
NM_005850	chr1	-	149895208	149900144	SF3B4	4936	149897644	149902644
NM_016047	chr2	-	24290453	24299314	SF3B6	8861	24296814	24301814
NM_001007467	chr22	+	31892124	32014537	SFI1	122413	31889624	31894624
NM_016329	chr3	-	52937582	53080089	SFMBT1	142507	53077589	53082589
NM_001029880	chr10	-	7200585	7453448	SFMBT2	252863	7450948	7455948
NR_136703	chr1	-	35641978	35658746	SFPQ	16768	35656246	35661246
NM_145247	chr10	+	105881815	105886143	SFR1	4328	105879315	105884315
NM_003012	chr8	-	41119475	41166990	SFRP1	47515	41164490	41169490
NM_003013	chr4	-	154701741	154710228	SFRP2	8487	154707728	154712728
NM_003014	chr7	-	37945534	37956525	SFRP4	10991	37954025	37959025
NM_003015	chr10	-	99526507	99531756	SFRP5	5249	99529256	99534256
NM_001261411	chr12	+	132195631	132284283	SFSWAP	88652	132193131	132198131
NM_145169	chr6	-	166733215	166756094	SFT2D1	22879	166753594	166758594
NM_199344	chr1	+	168195254	168212088	SFT2D2	16834	168192754	168197754
NM_032740	chr2	+	128458596	128461407	SFT2D3	2811	128456096	128461096
NR_027082	chr10	-	10826401	10836877	SFTA1P	10476	10834377	10839377
NR_138595	chr14	-	36942493	36988726	SFTA3	46233	36986226	36991226
NM_001093770	chr10	+	81370694	81375199	SFTPA1	4505	81368194	81373194
NM_001098668	chr10	-	81315607	81320217	SFTPA2	4610	81317717	81322717
NM_000542	chr2	-	85884439	85895864	SFTPB	11425	85893364	85898364
NM_001172410	chr8	+	22019183	22021991	SFTPC	2808	22016683	22021683
NM_003019	chr10	-	81697495	81708861	SFTPD	11366	81706361	81711361
NM_001322977	chr5	+	174905500	174956744	SFXN1	51244	174903e3	174908e3
NM_178858	chr10	+	104474274	104498947	SFXN2	24673	104471774	104476774
NM_030971	chr10	+	102790995	102800998	SFXN3	10003	102788495	102793495
NR_110305	chr10	-	120900424	120925204	SFXN4	24780	120922704	120927704
NM_144579	chr2	-	73169164	73298965	SFXN5	129801	73296465	73301465
NM_001135697	chr17	+	48243345	48253293	SGCA	9948	48240845	48245845
NM_000232	chr4	-	52886860	52904485	SGCB	17625	52901985	52906985
NM_001128209	chr5	+	155753766	156194798	SGCD	441032	155751266	155756266
NM_001099400	chr7	-	94214535	94285521	SGCE	70986	94283021	94288021
NM_000231	chr13	+	23755059	23899304	SGCG	144245	23752559	23757559
NM_001322879	chr8	-	13942343	15095792	SGCZ	1153449	15093292	15098292
NM_138414	chr16	+	28565248	28603111	SGF29	37863	28562748	28567748
NM_001308203	chr1	+	66999251	67216822	SGIP1	217571	66996751	67001751
NM_001143676	chr6	-	134490383	134639196	SGK1	148813	134636696	134641696
NM_170693	chr20	+	42187634	42214273	SGK2	26639	42185134	42190134
NM_001033578	chr8	+	67624652	67774257	SGK3	149605	67622152	67627152
NM_001174103	chr17	-	26934981	26941211	SGK494	6230	26938711	26943711
NM_147156	chr10	-	52065344	52383737	SGMS1	318393	52381237	52386237
NR_126411	chr10	+	52384710	52391396	SGMS1-AS1	6686	52382210	52387210
NM_001136258	chr4	+	108745720	108836204	SGMS2	90484	108743220	108748220
NM_001012410	chr3	-	20202084	20227725	SGO1	25641	20225225	20230225
NR_132785	chr3	+	20215777	20227607	SGO1-AS1	11830	20213277	20218277
NM_001160033	chr2	+	201390864	201448818	SGO2	57954	201388364	201393364
NM_003901	chr10	+	72575703	72640932	SGPL1	65229	72573203	72578203
NM_030791	chr14	-	64150934	64194813	SGPP1	43879	64192313	64197313
NM_001320834	chr2	+	223288770	223427341	SGPP2	138571	223286270	223291270
NM_000199	chr17	-	78183074	78194199	SGSH	11125	78191699	78196699
NM_001039948	chr22	+	25202187	25322813	SGSM1	120626	25199687	25204687
NM_014853	chr17	+	2240805	2284348	SGSM2	43543	2238305	2243305
NM_001350041	chr22	+	40766565	40806293	SGSM3	39728	40764065	40769065
NM_003021	chr19	-	2754711	2783354	SGTA	28643	2780854	2785854
NM_019072	chr5	-	64961754	65017941	SGTB	56187	65015441	65020441
NM_001308293	chr16	+	28857920	28885534	SH2B1	27614	28855420	28860420
NM_020979	chr7	+	101928352	101962178	SH2B2	33826	101925852	101930852
NM_005475	chr12	+	111843751	111889427	SH2B3	45676	111841251	111846251
NM_002351	chrX	+	123480131	123507010	SH2D1A	26879	123477631	123482631
NM_053282	chr1	-	162365055	162381928	SH2D1B	16873	162379428	162384428
NM_003975	chr1	-	156776034	156786640	SH2D2A	10606	156784140	156789140
NM_005490	chr19	-	6752172	6767523	SH2D3A	15351	6765023	6770023
NM_170600	chr9	-	130500595	130541048	SH2D3C	40453	130538548	130543548
NM_001174160	chr8	+	19171080	19253729	SH2D4A	82649	19168580	19173580
NM_207372	chr10	+	82297657	82406316	SH2D4B	108659	82295157	82300157
NM_001103160	chr1	-	21046224	21059133	SH2D5	12909	21056633	21061633
NM_201594	chr2	+	85646053	85664152	SH2D6	18099	85643553	85648553
NM_001101404	chr15	+	78384926	78396393	SH2D7	11467	78382426	78387426
NM_001317742	chr21	+	40817790	40887433	SH3BGR	69643	40815290	40820290
NM_003022	chrX	+	80457302	80554046	SH3BGRL	96744	80454802	80459802
NM_031469	chr6	+	80340821	80413387	SH3BGRL2	72566	80338321	80343321
NM_018957	chr22	+	38035481	38052126	SH3BP1	16645	38032981	38037981
NM_001122681	chr4	+	2794749	2842823	SH3BP2	48074	2792249	2797249
NM_014521	chr2	+	235860627	235964358	SH3BP4	103731	235858127	235863127
NM_001018009	chr3	-	15295862	15382901	SH3BP5	87039	15380401	15385401
NR_046084	chr3	+	15295690	15306005	SH3BP5-AS1	10315	15293190	15298190
NM_001322464	chr1	-	249104644	249120484	SH3BP5L	15840	249117984	249122984
NM_001243349	chr4	-	152041432	152149182	SH3D19	107750	152146682	152151682
NM_001162530	chr1	+	36771993	36786948	SH3D21	14955	36769493	36774493
NM_003025	chr19	-	4360363	4400565	SH3GL1	40202	4398065	4403065
NM_003026	chr9	+	17578951	17797126	SH3GL2	218175	17576451	17581451
NM_001324184	chr15	+	84115979	84287493	SH3GL3	171514	84113479	84118479
NM_001206651	chr1	+	87170252	87213867	SH3GLB1	43615	87167752	87172752
NM_020145	chr9	-	131770071	131790632	SH3GLB2	20561	131788132	131793132
NM_031892	chrX	-	19552082	19905744	SH3KBP1	353662	19903244	19908244
NM_014631	chr10	-	105353783	105615164	SH3PXD2A	261381	105612664	105617664
NR_038940	chr10	+	105506536	105515167	SH3PXD2A-AS1	8631	105504036	105509036
NM_001308175	chr5	-	171752186	171881527	SH3PXD2B	129341	171879027	171884027
NM_020870	chr4	-	170015406	170192249	SH3RF1	176843	170189749	170194749
NM_152550	chr5	+	145316125	145442879	SH3RF2	126754	145313625	145318625
NM_001099289	chr2	+	109745996	110262213	SH3RF3	516217	109743496	109748496
NR_029193	chr2	-	109743783	109746575	SH3RF3-AS1	2792	109744075	109749075
NM_001318480	chr4	+	8200970	8242830	SH3TC1	41860	8198470	8203470
NM_024577	chr5	-	148361712	148442737	SH3TC2	81025	148440237	148445237
NM_001282682	chr2	-	218135	264866	SH3YL1	46731	262366	267366
NM_016148	chr19	-	51162513	51223040	SHANK1	60527	51220540	51225540
NM_012309	chr11	-	70313960	70935842	SHANK2	621882	70933342	70938342
NR_046567	chr11	+	70477198	70481595	SHANK2-AS1	4397	70474698	70479698
NM_033517	chr22	+	51113069	51171640	SHANK3	58571	51110569	51115569
NM_030974	chr8	-	145153535	145159140	SHARPIN	5605	145156640	145161640
NM_003028	chr9	-	37915894	38069210	SHB	153316	38066710	38071710
NM_001289114	chr17	+	7517381	7536701	SHBG	19320	7514881	7519881
NM_003029	chr1	-	154934773	154946959	SHC1	12186	154944459	154949459
NM_012435	chr19	-	416582	460996	SHC2	44414	458496	463496
NM_016848	chr9	-	91620685	91793682	SHC3	172997	91791182	91796182
NM_203349	chr15	-	49115933	49255641	SHC4	139708	49253141	49258141
NR_136738	chr16	-	46612504	46655314	SHCBP1	42810	46652814	46657814
NM_030933	chr1	-	182868997	182922660	SHCBP1L	53663	182920160	182925160
NM_020209	chr19	+	4278597	4290720	SHD	12123	4276097	4281097
NM_001010846	chr1	-	154451953	154474526	SHE	22573	154472026	154477026
NM_138356	chr15	-	45459411	45493373	SHF	33962	45490873	45495873
NM_000193	chr7	-	155594933	155604967	SHH	10034	155602467	155607467
NM_001007538	chr13	-	26618734	26625198	SHISA2	6464	26622698	26627698
NM_001080505	chr4	+	42399855	42404504	SHISA3	4649	42397355	42402355
NR_030775	chr1	+	201857796	201861715	SHISA4	3919	201855296	201860296
NM_001272066	chr3	-	48509196	48542259	SHISA5	33063	48539759	48544759
NM_001173462	chr17	+	11144739	11467380	SHISA6	322641	11142239	11147239
NM_001145176	chr19	-	55940104	55954230	SHISA7	14126	55951730	55956730
NM_001207020	chr22	-	42305557	42310671	SHISA8	5114	42308171	42313171
NM_001145204	chr16	+	12995476	13334273	SHISA9	338797	12992976	12997976
NM_138392	chr19	+	41082756	41097305	SHKBP1	14549	41080256	41085256
NM_148918	chr17	-	18231173	18266877	SHMT1	35704	18264377	18269377
NM_005412	chr12	+	57623355	57628718	SHMT2	5363	57620855	57625855
NM_001324336	chr10	+	112679127	112773425	SHOC2	94298	112676627	112681627
NM_006883	chrX	+	585078	620146	SHOX	35068	582578	587578
NM_006884	chr3	-	157813799	157823952	SHOX2	10153	157821452	157826452
NM_013276	chr17	-	3511555	3539616	SHPK	28061	3537116	3542116
NM_001042683	chr6	-	146205944	146285233	SHPRH	79289	146282733	146287733
NM_018130	chr3	-	72798427	72897598	SHQ1	99171	72895098	72900098
NM_001172700	chr5	-	132157832	132166590	SHROOM1	8758	132164090	132169090
NM_001649	chrX	+	9754495	9917483	SHROOM2	162988	9751995	9756995
NM_020859	chr4	+	77356252	77704405	SHROOM3	348153	77353752	77358752
NR_027121	chrX	-	50334642	50557044	SHROOM4	222402	50554544	50559544
NM_001258300	chr10	-	118659822	118886097	SHTN1	226275	118883597	118888597
NM_001041	chr3	-	164696685	164796283	SI	99598	164793783	164798783
NM_001199922	chr11	-	124505684	124546199	SIAE	40515	124543699	124548699
NM_003031	chr16	-	48394453	48419229	SIAH1	24776	48416729	48421729
NM_005067	chr3	-	150458909	150481263	SIAH2	22354	150478763	150483763
NM_198849	chr13	-	46354415	46425846	SIAH3	71431	46423346	46428346
NR_136283	chr3	+	113251217	113348422	SIDT1	97205	113248717	113253717
NM_001040455	chr11	+	117049938	117068161	SIDT2	18223	117047438	117052438
NM_001135053	chr11	-	405715	417397	SIGIRR	11682	414897	419897
NM_023068	chr20	-	3667616	3687775	SIGLEC1	20159	3685275	3690275
NM_001171159	chr19	-	51913274	51921057	SIGLEC10	7783	51918557	51923557
NM_052884	chr19	-	50452249	50464429	SIGLEC11	12180	50461929	50466929
NM_053003	chr19	-	51994480	52005043	SIGLEC12	10563	52002543	52007543
NM_001098612	chr19	-	52145805	52150132	SIGLEC14	4327	52147632	52152632
NM_213602	chr18	+	43405544	43422521	SIGLEC15	16977	43403044	43408044
NM_001348364	chr19	+	50472856	50479076	SIGLEC16	6220	50470356	50475356
NR_047531	chr19	+	51670584	51676780	SIGLEC17P	6196	51668084	51673084
NM_003830	chr19	-	52114755	52133727	SIGLEC5	18972	52131227	52136227
NM_001177549	chr19	-	52021072	52035110	SIGLEC6	14038	52032610	52037610
NM_016543	chr19	+	51645557	51656783	SIGLEC7	11226	51643057	51648057
NM_014442	chr19	-	51954250	51961708	SIGLEC8	7458	51959208	51964208
NM_001198558	chr19	+	51628136	51639520	SIGLEC9	11384	51625636	51630636
NR_102324	chr19	+	51754331	51772582	SIGLECL1	18251	51751831	51756831
NR_104108	chr9	-	34634718	34637823	SIGMAR1	3105	34635323	34640323
NM_173354	chr21	-	44834398	44847012	SIK1	12614	44844512	44849512
NM_015191	chr11	+	111473114	111597641	SIK2	124527	111470614	111475614
NM_001281749	chr11	-	116714117	116969131	SIK3	255014	116966631	116971631
NR_049742	chr1	-	115312104	115323308	SIKE1	11204	115320808	115325808
NM_022464	chr5	-	138282409	138534065	SIL1	251656	138531565	138536565
NM_005068	chr6	-	100836749	100911551	SIM1	74802	100909051	100914051
NM_005069	chr21	+	38071420	38122218	SIM2	50798	38068920	38073920
NM_001308196	chr5	+	175665361	175772994	SIMC1	107633	175662861	175667861
NM_001145357	chr15	-	75661719	75748124	SIN3A	86405	75745624	75750624
NM_001297595	chr19	+	16940197	16991164	SIN3B	50967	16937697	16942697
NM_006747	chr11	+	65405577	65418391	SIPA1	12814	65403077	65408077
NM_015556	chr14	+	71996028	72207946	SIPA1L1	211918	71993528	71998528
NM_020808	chr1	-	232533711	232651354	SIPA1L2	117643	232648854	232653854
NM_015073	chr19	+	38397860	38699012	SIPA1L3	301152	38395360	38400360
NM_001040022	chr20	+	1874812	1920540	SIRPA	45728	1872312	1877312
NM_006065	chr20	-	1545028	1600740	SIRPB1	55712	1598240	1603240
NM_001134836	chr20	-	1455235	1472233	SIRPB2	16998	1469733	1474733
NM_178460	chr20	-	1514896	1538343	SIRPD	23447	1535843	1540843
NM_018556	chr20	-	1609797	1638425	SIRPG	28628	1635925	1640925
NR_110090	chr20	+	1614153	1629119	SIRPG-AS1	14966	1611653	1616653
NM_012238	chr10	+	69644426	69678147	SIRT1	33721	69641926	69646926
NM_030593	chr19	-	39369194	39390502	SIRT2	21308	39388002	39393002
NM_012239	chr11	-	215029	236362	SIRT3	21333	233862	238862
NM_012240	chr12	+	120740123	120751045	SIRT4	10922	120737623	120742623
NM_001242827	chr6	+	13574760	13615390	SIRT5	40630	13572260	13577260
NM_001321062	chr19	-	4174105	4182601	SIRT6	8496	4180101	4185101
NM_016538	chr17	-	79869814	79876058	SIRT7	6244	79873558	79878558
NM_021709	chr14	+	105219469	105225996	SIVA1	6527	105216969	105221969
NM_005982	chr14	-	61111416	61116155	SIX1	4739	61113655	61118655
NM_016932	chr2	-	45232323	45236542	SIX2	4219	45234042	45239042
NM_005413	chr2	+	45169036	45173216	SIX3	4180	45166536	45171536
NM_017420	chr14	-	61176255	61190852	SIX4	14597	61188352	61193352
NM_175875	chr19	-	46268042	46272497	SIX5	4455	46269997	46274997
NM_007374	chr14	+	60975937	60978525	SIX6	2588	60973437	60978437
NM_001039535	chr18	+	47901391	47920538	SKA1	19147	47898891	47903891
NM_001330399	chr17	-	57187219	57232800	SKA2	45581	57230300	57235300
NM_145061	chr13	-	21727733	21750741	SKA3	23008	21748241	21753241
NM_003726	chr17	-	46210801	46507594	SKAP1	296793	46505094	46510094
NM_003930	chr7	-	26706680	26904362	SKAP2	197682	26901862	26906862
NM_003036	chr1	+	2160133	2241652	SKI	81519	2157633	2162633
NM_207371	chr10	-	21802408	21814611	SKIDA1	12203	21812111	21817111
NM_005414	chr3	+	170075472	170114637	SKIL	39165	170072972	170077972
NR_026749	chr1	-	48567386	48648100	SKINT1L	80714	48645600	48650600
NM_006929	chr6	+	31926580	31937532	SKIV2L	10952	31924080	31929080
NM_015360	chr5	+	54603575	54721409	SKIV2L2	117834	54601075	54606075
NM_001258024	chr15	+	68112041	68126174	SKOR1	14133	68109541	68114541
NM_001278063	chr18	-	44738459	44775554	SKOR2	37095	44773054	44778054
NM_170679	chr5	-	133492081	133512724	SKP1	20643	133510224	133515224
NM_001243120	chr5	+	36152144	36184142	SKP2	31998	36149644	36154644
NM_001045556	chr8	-	134048972	134115310	SLA	66338	134112810	134117810
NM_032214	chr20	-	35240923	35274619	SLA2	33696	35272119	35277119
NM_001242868	chr13	+	78271988	78338377	SLAIN1	66389	78269488	78274488
NM_020846	chr4	+	48343612	48428215	SLAIN2	84603	48341112	48346112
NR_104399	chr1	-	160577889	160617101	SLAMF1	39212	160614601	160619601
NM_001184716	chr1	-	160454819	160493052	SLAMF6	38233	160490552	160495552
NM_001282592	chr1	+	160708846	160724608	SLAMF7	15762	160706346	160711346
NM_020125	chr1	+	159796478	159807282	SLAMF8	10804	159793978	159798978
NM_001146173	chr1	-	159921281	159924044	SLAMF9	2763	159921544	159926544
NM_001306074	chr4	-	1694457	1714468	SLBP	20011	1711968	1716968
NM_003049	chr14	-	70242551	70264006	SLC10A1	21455	70261506	70266506
NM_000452	chr13	-	103696347	103719196	SLC10A2	22849	103716696	103721696
NM_001142391	chrX	-	153715644	153719029	SLC10A3	3385	153716529	153721529
NM_152679	chr4	+	48485359	48491541	SLC10A4	6182	48482859	48487859
NM_197965	chr4	-	87744620	87770416	SLC10A6	25796	87767916	87772916
NM_001300842	chr4	-	147175139	147443123	SLC10A7	267984	147440623	147445623
NM_000578	chr2	+	219246751	219261617	SLC11A1	14866	219244251	219249251
NM_001174127	chr12	-	51373565	51420199	SLC11A2	46634	51417699	51422699
NM_001184832	chr15	+	48498497	48596275	SLC12A1	97778	48495997	48500997
NM_001046	chr5	+	127419482	127525380	SLC12A2	105898	127416982	127421982
NM_000339	chr16	+	56899118	56949762	SLC12A3	50644	56896618	56901618
NM_001145962	chr16	-	67977376	68002597	SLC12A4	25221	68000097	68005097
NM_001134771	chr20	+	44650328	44688789	SLC12A5	38461	44647828	44652828
NM_001042495	chr15	-	34522196	34630265	SLC12A6	108069	34627765	34632765
NM_006598	chr5	-	1050488	1112172	SLC12A7	61684	1109672	1114672
NM_024628	chr3	-	124801479	124931609	SLC12A8	130130	124929109	124934109
NM_020246	chr7	+	100450340	100464634	SLC12A9	14294	100447840	100452840
NR_146550	chr7	-	100434935	100450236	SLC12A9-AS1	15301	100447736	100452736
NM_001324400	chr7	-	122753587	122840025	SLC13A1	86438	122837525	122842525
NM_001145975	chr17	+	26800663	26824798	SLC13A2	24135	26798163	26803163
NM_001193340	chr20	-	45186461	45313124	SLC13A3	126663	45310624	45315624
NM_012450	chr7	-	135365986	135412952	SLC13A4	46966	135410452	135415452
NM_001284509	chr17	-	6588031	6616740	SLC13A5	28709	6614240	6619240
NM_001308278	chr18	+	43304087	43332485	SLC14A1	28398	43301587	43306587
NM_001242692	chr18	+	42792946	43263060	SLC14A2	470114	42790446	42795446
NR_110899	chr18	-	43018148	43087001	SLC14A2-AS1	68853	43084501	43089501
NM_005073	chr13	-	99336054	99404929	SLC15A1	68875	99402429	99407429
NM_021082	chr3	+	121613170	121663034	SLC15A2	49864	121610670	121615670
NR_027391	chr11	-	60704554	60719257	SLC15A3	14703	60716757	60721757
NM_145648	chr12	-	129277738	129308541	SLC15A4	30803	129306041	129311041
NM_001170798	chr12	-	16341418	16430619	SLC15A5	89201	16428119	16433119
NM_003051	chr1	-	113454469	113498975	SLC16A1	44506	113496475	113501475
NR_103743	chr1	+	113499036	113506690	SLC16A1-AS1	7654	113496536	113501536
NM_018593	chr6	+	111408780	111544606	SLC16A10	135826	111406280	111411280
NM_213606	chr10	-	91190050	91295313	SLC16A12	105263	91292813	91297813
NR_120614	chr10	+	91215747	91227908	SLC16A12-AS1	12161	91213247	91218247
NM_201566	chr17	+	6939393	6943440	SLC16A13	4047	6936893	6941893
NM_152527	chr2	-	230899689	230933715	SLC16A14	34026	230931215	230936215
NM_006517	chrX	+	73641327	73753764	SLC16A2	112437	73638827	73643827
NM_001206950	chr17	+	80186281	80197375	SLC16A3	11094	80183781	80188781
NM_001319220	chr1	-	110905472	110933704	SLC16A4	28232	110931204	110936204
NM_001271765	chr17	+	73083821	73102255	SLC16A5	18434	73081321	73086321
NM_001174166	chr17	-	66263166	66287405	SLC16A6	24239	66284905	66289905
NM_001270623	chr12	+	59989820	60183635	SLC16A7	193815	59987320	59992320
NM_013356	chr22	-	38474143	38479170	SLC16A8	5027	38476670	38481670
NM_001323977	chr10	-	61410521	61469837	SLC16A9	59316	61467337	61472337
NM_005074	chr6	-	25783125	25832287	SLC17A1	49162	25829787	25834787
NM_005835	chr6	-	25912983	25930954	SLC17A2	17971	25928454	25933454
NM_006632	chr6	-	25845327	25874471	SLC17A3	29144	25871971	25876971
NM_001286121	chr6	+	25754926	25781403	SLC17A4	26477	25752426	25757426
NM_012434	chr6	-	74303101	74363737	SLC17A5	60636	74361237	74366237
NM_020346	chr11	+	22359666	22401046	SLC17A6	41380	22357166	22362166
NM_020309	chr19	-	49932654	49944808	SLC17A7	12154	49942308	49947308
NM_001145288	chr12	+	100750856	100815837	SLC17A8	64981	100748356	100753356
NM_001302643	chr20	+	61583998	61599949	SLC17A9	15951	61581498	61586498
NM_001135691	chr8	-	20002365	20040717	SLC18A1	38352	20038217	20043217
NM_003054	chr10	+	119000583	119038941	SLC18A2	38358	118998083	119003083
NM_052831	chr6	-	133090506	133119747	SLC18B1	29241	133117247	133122247
NM_001352511	chr21	-	46932480	46983029	SLC19A1	50549	46980529	46985529
NM_006996	chr1	-	169433148	169455208	SLC19A2	22060	169452708	169457708
NM_025243	chr2	-	228549925	228582745	SLC19A3	32820	228580245	228585245
NM_004170	chr9	+	4490426	4587469	SLC1A1	97043	4487926	4492926
NM_001195728	chr11	-	35272751	35441610	SLC1A2	168859	35439110	35444110
NM_001289939	chr5	+	36606456	36688436	SLC1A3	81980	36603956	36608956
NM_001193493	chr2	+	65215578	65251000	SLC1A4	35422	65213078	65218078
NM_005628	chr19	-	47278139	47291842	SLC1A5	13703	47289342	47294342
NR_073589	chr19	-	15060844	15121455	SLC1A6	60611	15118955	15123955
NR_109858	chr1	-	53552850	53608304	SLC1A7	55454	53605804	53610804
NM_005415	chr2	+	113403433	113421400	SLC20A1	17967	113400933	113405933
NM_006749	chr8	-	42273979	42397356	SLC20A2	123377	42394856	42399856
NM_153187	chr6	+	160542862	160579750	SLC22A1	36888	160540362	160545362
NR_134874	chr11	+	63057418	63079246	SLC22A10	21828	63054918	63059918
NM_001307985	chr11	+	64323072	64340347	SLC22A11	17275	64320572	64325572
NM_001276326	chr11	+	64358281	64369825	SLC22A12	11544	64355781	64360781
NM_004256	chr3	+	38307297	38319806	SLC22A13	12509	38304797	38309797
NM_001320033	chr3	+	38323784	38360066	SLC22A14	36282	38321284	38326284
NM_018420	chr1	+	116519118	116612675	SLC22A15	93557	116516618	116521618
NM_033125	chr6	-	110745891	110797844	SLC22A16	51953	110795344	110800344
NM_016609	chr14	-	23815519	23822121	SLC22A17	6602	23819621	23824621
NM_183233	chr11	+	2920950	2946476	SLC22A18	25526	2918450	2923450
NM_007105	chr11	-	2908574	2925175	SLC22A18AS	16601	2922675	2927675
NM_003058	chr6	-	160637793	160679963	SLC22A2	42170	160677463	160682463
NR_033396	chr11	+	64981310	65010228	SLC22A20	28918	64978810	64983810
NM_015482	chr6	-	3269206	3456793	SLC22A23	187587	3454293	3459293
NM_001136506	chr11	-	62847411	62911693	SLC22A24	64282	62909193	62914193
NM_199352	chr11	-	62930641	62997124	SLC22A25	66483	62994624	62999624
NM_021977	chr6	+	160769404	160873611	SLC22A3	104207	160766904	160771904
NM_001242757	chr16	-	89262168	89266529	SLC22A31	4361	89264029	89269029
NM_003059	chr5	+	131630144	131679899	SLC22A4	49755	131627644	131632644
NM_003060	chr5	+	131705400	131731306	SLC22A5	25906	131702900	131707900
NM_004790	chr11	-	62744068	62752495	SLC22A6	8427	62749995	62754995
NM_006672	chr6	+	43265997	43273276	SLC22A7	7279	43263497	43268497
NM_001184736	chr11	-	62760295	62783317	SLC22A8	23022	62780817	62785817
NM_080866	chr11	+	63137260	63177712	SLC22A9	40452	63134760	63139760
NM_152685	chr5	-	138702884	138719039	SLC23A1	16155	138716539	138721539
NM_203327	chr20	-	4833001	4990939	SLC23A2	157938	4988439	4993439
NM_144712	chr2	-	220026180	220034817	SLC23A3	8637	220032317	220037317
NM_001301033	chr15	+	65903742	65953256	SLC24A1	49514	65901242	65906242
NM_020344	chr9	-	19507449	19787017	SLC24A2	279568	19784517	19789517
NM_020689	chr20	+	19193289	19703541	SLC24A3	510252	19190789	19195789
NM_153648	chr14	+	92788924	92967825	SLC24A4	178901	92786424	92791424
NM_205850	chr15	+	48413168	48434589	SLC24A5	21421	48410668	48415668
NR_046298	chr22	-	19163087	19166376	SLC25A1	3289	19163876	19168876
NM_001270953	chr17	+	79679265	79688046	SLC25A10	8781	79676765	79681765
NM_003562	chr17	-	4840425	4843462	SLC25A11	3037	4840962	4845962
NR_047549	chr2	-	172639914	172750816	SLC25A12	110902	172748316	172753316
NM_014251	chr7	-	95749531	95951459	SLC25A13	201928	95948959	95953959
NR_104107	chrX	+	129473861	129507335	SLC25A14	33474	129471361	129476361
NM_014252	chr13	+	41363546	41386596	SLC25A15	23050	41361046	41366046
NM_001324317	chr10	-	70242089	70287280	SLC25A16	45191	70284780	70289780
NM_006358	chr22	-	41165633	41215403	SLC25A17	49770	41212903	41217903
NM_031481	chr22	+	18043138	18073656	SLC25A18	30518	18040638	18045638
NM_021734	chr17	-	73269060	73285530	SLC25A19	16470	73283030	73288030
NM_000387	chr3	-	48894355	48936426	SLC25A20	42071	48933926	48938926
NM_001171170	chr14	-	37147125	37641865	SLC25A21	494740	37639365	37644365
NM_001191061	chr11	-	790474	798269	SLC25A22	7795	795769	800769
NM_024103	chr19	-	6440074	6459781	SLC25A23	19707	6457281	6462281
NM_013386	chr1	-	108677343	108742980	SLC25A24	65637	108740480	108745480
NM_001006641	chr9	+	130830478	130871537	SLC25A25	41059	130827978	130832978
NR_033374	chr9	-	130873449	130881013	SLC25A25-AS1	7564	130878513	130883513
NM_173471	chr3	+	66119284	66429351	SLC25A26	310067	66116784	66121784
NM_001204051	chr6	+	46620651	46645927	SLC25A27	25276	46618151	46623151
NM_031212	chr10	-	101370274	101380221	SLC25A28	9947	101377721	101382721
NM_001291814	chr14	-	100757447	100772884	SLC25A29	15437	100770384	100775384
NM_005888	chr12	+	98987402	98995778	SLC25A3	8376	98984902	98989902
NM_001286807	chr13	-	45967453	45992590	SLC25A30	25137	45990090	45995090
NM_001318467	chr4	+	128651532	128695454	SLC25A31	43922	128649032	128654032
NM_030780	chr8	-	104410865	104427563	SLC25A32	16698	104425063	104430063
NM_032315	chr1	+	9599527	9642831	SLC25A33	43304	9597027	9602027
NM_207348	chr1	+	16062808	16067887	SLC25A34	5079	16060308	16065308
NM_001320871	chr17	-	8191080	8198661	SLC25A35	7581	8196161	8201161
NM_018155	chr3	+	140660661	140698785	SLC25A36	38124	140658161	140663161
NM_001317812	chr8	+	23386307	23432976	SLC25A37	46669	23383807	23388807
NM_017875	chr3	+	39424814	39438819	SLC25A38	14005	39422314	39427314
NM_001143780	chr17	-	42396992	42402238	SLC25A39	5246	42399738	42404738
NM_001151	chr4	+	186064416	186071538	SLC25A4	7122	186061916	186066916
NM_018843	chr7	-	87463813	87505692	SLC25A40	41879	87503192	87508192
NM_173637	chr19	-	6426047	6433790	SLC25A41	7743	6431290	6436290
NM_001321544	chr19	+	19174769	19223841	SLC25A42	49072	19172269	19177269
NM_145305	chrX	+	118533257	118588437	SLC25A43	55180	118530757	118535757
NR_104411	chr1	+	156163722	156182587	SLC25A44	18865	156161222	156166222
NM_001278251	chr11	-	65142662	65151172	SLC25A45	8510	65148672	65153672
NM_001303250	chr5	+	110073836	110100874	SLC25A46	27038	110071336	110076336
NM_001350877	chr14	+	100789673	100796758	SLC25A47	7085	100787173	100792173
NM_001349335	chr5	+	134914854	135224326	SLC25A48	309472	134912354	134917354
NM_001152	chrX	+	118602362	118605359	SLC25A5	2997	118599862	118604862
NR_028443	chrX	-	118599995	118603083	SLC25A5-AS1	3088	118600583	118605583
NR_024873	chr9	-	37877571	37904350	SLC25A51	26779	37901850	37906850
NM_001012755	chrX	-	103343897	103401708	SLC25A53	57811	103399208	103404208
NM_001636	chrX	-	1505044	1511039	SLC25A6	5995	1508539	1513539
NM_134425	chr4	-	972860	987228	SLC26A1	14368	984728	989728
NM_133489	chr12	+	58013692	58019934	SLC26A10	6242	58011192	58016192
NM_001166349	chr17	+	78194199	78227308	SLC26A11	33109	78191699	78196699
NM_000112	chr5	+	149340299	149366963	SLC26A2	26664	149337799	149342799
NM_000111	chr7	-	107405911	107443678	SLC26A3	37767	107441178	107446178
NM_000441	chr7	+	107301079	107358252	SLC26A4	57173	107298579	107303579
NR_028137	chr7	-	107296960	107302243	SLC26A4-AS1	5283	107299743	107304743
NM_206883	chr7	-	102993176	103086624	SLC26A5	93448	103084124	103089124
NM_134426	chr3	-	48663155	48672926	SLC26A6	9771	48670426	48675426
NM_001282357	chr8	+	92221721	92410382	SLC26A7	188661	92219221	92224221
NM_052961	chr6	-	35911290	35992413	SLC26A8	81123	35989913	35994913
NM_052934	chr1	-	205882176	205912588	SLC26A9	30412	205910088	205915088
NM_198580	chr19	+	17581252	17616977	SLC27A1	35725	17578752	17583752
NM_001159629	chr15	+	50474392	50528589	SLC27A2	54197	50471892	50476892
NR_145826	chr1	+	153746829	153752636	SLC27A3	5807	153744329	153749329
NM_005094	chr9	+	131102838	131123749	SLC27A4	20911	131100338	131105338
NM_001321196	chr19	-	59009699	59023432	SLC27A5	13733	59020932	59025932
NM_001317984	chr5	+	128300819	128369335	SLC27A6	68516	128298319	128303319
NM_001321721	chr15	+	85427891	85518876	SLC28A1	90985	85425391	85430391
NM_004212	chr15	+	45544427	45568132	SLC28A2	23705	45541927	45546927
NM_022127	chr9	-	86890764	86983413	SLC28A3	92649	86980913	86985913
NM_001304466	chr6	+	44187241	44201888	SLC29A1	14647	44184741	44189741
NM_001300869	chr11	-	66129991	66139947	SLC29A2	9956	66137447	66142447
NR_033414	chr10	+	73079009	73123147	SLC29A3	44138	73076509	73081509
NM_001040661	chr7	+	5322560	5343704	SLC29A4	21144	5320060	5325060
NM_006516	chr1	-	43391045	43424847	SLC2A1	33802	43422347	43427347
NR_033967	chr1	+	43424719	43449029	SLC2A1-AS1	24310	43422219	43427219
NM_030777	chr20	+	45338278	45364985	SLC2A10	26707	45335778	45340778
NM_030807	chr22	+	24198889	24228299	SLC2A11	29410	24196389	24201389
NM_145176	chr6	-	134308718	134373789	SLC2A12	65071	134371289	134376289
NM_052885	chr12	-	40148822	40499661	SLC2A13	350839	40497161	40502161
NM_001286237	chr12	-	7965107	8043792	SLC2A14	78685	8041292	8046292
NM_001278658	chr3	-	170714136	170744768	SLC2A2	30632	170742268	170747268
NM_006931	chr12	-	8071823	8088892	SLC2A3	17069	8086392	8091392
NM_001042	chr17	+	7185053	7191367	SLC2A4	6314	7182553	7187553
NM_020062	chr20	+	62371210	62375403	SLC2A4RG	4193	62368710	62373710
NM_001328619	chr1	-	9097004	9132286	SLC2A5	35282	9129786	9134786
NM_001145099	chr9	-	136336215	136344276	SLC2A6	8061	136341776	136346776
NM_207420	chr1	-	9063358	9086404	SLC2A7	23046	9083904	9088904
NR_073416	chr9	+	130159416	130170170	SLC2A8	10754	130156916	130161916
NM_001001290	chr4	-	9827847	10041872	SLC2A9	214025	10039372	10044372
NM_021194	chr1	-	211748380	211752099	SLC30A1	3719	211749599	211754599
NM_018713	chr1	-	220087605	220101993	SLC30A10	14388	220099493	220104493
NM_032513	chr1	-	26364512	26372629	SLC30A2	8117	26370129	26375129
NM_001318950	chr2	-	27477439	27498685	SLC30A3	21246	27496185	27501185
NM_013309	chr15	-	45771810	45815002	SLC30A4	43192	45812502	45817502
NM_022902	chr5	+	68389775	68426899	SLC30A5	37124	68387275	68392275
NM_001330476	chr2	+	32390909	32449448	SLC30A6	58539	32388409	32393409
NM_001144884	chr1	+	101361631	101447311	SLC30A7	85680	101359131	101364131
NM_001172811	chr8	+	117962511	118188953	SLC30A8	226442	117960011	117965011
NM_006345	chr4	+	41992522	42089551	SLC30A9	97029	41990022	41995022
NM_001859	chr9	+	115983807	116026772	SLC31A1	42965	115981307	115986307
NM_001860	chr9	+	115913237	115926422	SLC31A2	13185	115910737	115915737
NM_080552	chr20	+	37353104	37358015	SLC32A1	4911	37350604	37355604
NM_004733	chr3	-	155544300	155572248	SLC33A1	27948	155569748	155574748
NM_003052	chr5	+	176811431	176825849	SLC34A1	14418	176808931	176813931
NM_006424	chr4	+	25657434	25680368	SLC34A2	22934	25654934	25659934
NM_001177317	chr9	+	140125208	140131006	SLC34A3	5798	140122708	140127708
NM_001168398	chr6	+	88182642	88222057	SLC35A1	39415	88180142	88185142
NM_001282647	chrX	-	48760456	48769235	SLC35A2	8779	48766735	48771735
NM_012243	chr1	+	100435344	100492534	SLC35A3	57190	100432844	100437844
NM_080670	chr5	+	139944149	139948689	SLC35A4	4540	139941649	139946649
NM_001348906	chr3	+	112280166	112304424	SLC35A5	24258	112277666	112282666
NM_001278784	chr17	-	47778295	47785313	SLC35B1	7018	47782813	47787813
NM_001286511	chr6	-	44221837	44225627	SLC35B2	3790	44223127	44228127
NM_015948	chr6	-	8413299	8435800	SLC35B3	22501	8433300	8438300
NM_032826	chr7	-	133974089	134001827	SLC35B4	27738	133999327	134004327
NM_001145266	chr11	+	45825622	45834567	SLC35C1	8945	45823122	45828122
NM_001281457	chr20	-	44978166	44993097	SLC35C2	14931	44990597	44995597
NM_015139	chr1	-	67465014	67520080	SLC35D1	55066	67517580	67522580
NR_104627	chr9	-	99075718	99145992	SLC35D2	70274	99143492	99148492
NM_001008783	chr6	+	137243378	137246798	SLC35D3	3420	137240878	137245878
NM_024881	chr19	-	16660647	16683193	SLC35E1	22546	16680693	16685693
NM_001199787	chr1	-	1656276	1677438	SLC35E2	21162	1674938	1679938
NM_001290264	chr1	-	1592938	1624243	SLC35E2B	31305	1621743	1626743
NM_018656	chr12	+	69139935	69159853	SLC35E3	19918	69137435	69142435
NM_001318371	chr22	+	31031801	31065003	SLC35E4	33202	31029301	31034301
NM_001029858	chr6	+	118228688	118638839	SLC35F1	410151	118226188	118231188
NM_017515	chr11	-	107661716	107729914	SLC35F2	68198	107727414	107732414
NM_173508	chr1	+	234040457	234460264	SLC35F3	419807	234037957	234042957
NM_001206920	chr14	-	58030639	58332592	SLC35F4	301953	58330092	58335092
NM_001330315	chr2	-	114464297	114514400	SLC35F5	50103	114511900	114516900
NM_017877	chr2	+	26987141	27004099	SLC35F6	16958	26984641	26989641
NR_144336	chr10	+	95653726	95669590	SLC35G1	15864	95651226	95656226
NM_025246	chr3	+	136537860	136574734	SLC35G2	36874	136535360	136540360
NM_078483	chr5	+	150827156	150871942	SLC36A1	44786	150824656	150829656
NM_181776	chr5	-	150694538	150727151	SLC36A2	32613	150724651	150729651
NM_001145017	chr5	-	150655925	150683334	SLC36A3	27409	150680834	150685834
NM_152313	chr11	-	92877336	92931141	SLC36A4	53805	92928641	92933641
NM_018964	chr21	+	43919741	44001550	SLC37A1	81809	43917241	43922241
NM_198277	chr11	+	124933012	124960412	SLC37A2	27400	124930512	124935512
NM_001287498	chr7	-	140033551	140098350	SLC37A3	64799	140095850	140100850
NM_001164278	chr11	-	118895060	118901616	SLC37A4	6556	118899116	118904116
NM_001278388	chr12	-	46576839	46663208	SLC38A1	86369	46660708	46665708
NM_001037984	chr17	-	79218610	79269139	SLC38A10	50529	79266639	79271639
NM_001199148	chr2	-	165754708	165812035	SLC38A11	57327	165809535	165814535
NM_018976	chr12	-	46751970	46766645	SLC38A2	14675	46764145	46769145
NM_006841	chr3	+	50242678	50258411	SLC38A3	15733	50240178	50245178
NM_018018	chr12	-	47158543	47219780	SLC38A4	61237	47217280	47222280
NM_033518	chrX	-	48316919	48328644	SLC38A5	11725	48326144	48331144
NM_001172702	chr14	+	61447831	61550451	SLC38A6	102620	61445331	61450331
NM_018231	chr16	-	58699012	58718681	SLC38A7	19669	58716181	58721181
NM_001080442	chr16	-	84043271	84075762	SLC38A8	32491	84073262	84078262
NM_001282429	chr5	-	54921672	55008163	SLC38A9	86491	55005663	55010663
NM_001271960	chr1	-	153931574	153940660	SLC39A1	9086	153938160	153943160
NM_001127257	chr2	+	196521531	196602426	SLC39A10	80895	196519031	196524031
NM_001159770	chr17	-	70642084	71088853	SLC39A11	446769	71086353	71091353
NM_152725	chr10	+	18240767	18332221	SLC39A12	91454	18238267	18243267
NR_038419	chr10	-	18290714	18299491	SLC39A12-AS1	8777	18296991	18301991
NR_134854	chr11	+	47428826	47438051	SLC39A13	9225	47426326	47431326
NM_001135154	chr8	+	22224742	22291640	SLC39A14	66898	22222242	22227242
NM_001256588	chr14	+	21467413	21470034	SLC39A2	2621	21464913	21469913
NM_144564	chr19	-	2732522	2740074	SLC39A3	7552	2737574	2742574
NM_130849	chr8	-	145637797	145642279	SLC39A4	4482	145639779	145644779
NM_173596	chr12	+	56623819	56631629	SLC39A5	7810	56621319	56626319
NM_012319	chr18	-	33688493	33709357	SLC39A6	20864	33706857	33711857
NM_001077516	chr6	+	33168602	33172214	SLC39A7	3612	33166102	33171102
NM_001135147	chr4	-	103172197	103266410	SLC39A8	94213	103263910	103268910
NM_001252152	chr14	+	69865095	69929107	SLC39A9	64012	69862595	69867595
NM_000341	chr2	+	44502596	44547962	SLC3A1	45366	44500096	44505096
NM_002394	chr11	+	62623483	62656355	SLC3A2	32872	62620983	62625983
NM_014585	chr2	-	190425315	190445537	SLC40A1	20222	190443037	190448037
NM_173854	chr1	-	205758220	205782324	SLC41A1	24104	205779824	205784824
NM_001352169	chr12	-	105196330	105352522	SLC41A2	156192	105350022	105355022
NM_001164475	chr3	-	125725199	125820391	SLC41A3	95192	125817891	125822891
NM_003627	chr11	-	57252003	57283192	SLC43A1	31189	57280692	57285692
NM_152346	chr17	-	1472547	1532180	SLC43A2	59633	1529680	1534680
NM_017611	chr11	-	57174426	57195053	SLC43A3	20627	57192553	57197553
NM_001330731	chr9	+	108006885	108200796	SLC44A1	193911	108004385	108009385
NM_001145056	chr19	+	10713120	10755235	SLC44A2	42115	10710620	10715620
NM_001258342	chr1	+	95285897	95360803	SLC44A3	74906	95283397	95288397
NR_104131	chr1	-	95123088	95285837	SLC44A3-AS1	162749	95283337	95288337
NM_001178044	chr6_cox_hap2	-	3340716	3356577	SLC44A4	15861	3354077	3359077
NM_001320283	chr1	-	75671816	76081694	SLC44A5	409878	76079194	76084194
NM_001080397	chr1	+	8378144	8404227	SLC45A1	26083	8375644	8380644
NM_016180	chr5	-	33944720	33984780	SLC45A2	40060	33982280	33987280
NM_033102	chr1	-	205626980	205649630	SLC45A3	22650	205647130	205652130
NM_001286646	chr8	-	142217264	142264728	SLC45A4	47464	142262228	142267228
NM_001242366	chr17	-	26721660	26733230	SLC46A1	11570	26730730	26735730
NM_033051	chr9	-	115641199	115653193	SLC46A2	11994	115650693	115655693
NM_001135919	chr13	-	29274217	29293150	SLC46A3	18933	29290650	29295650
NM_018242	chr17	+	19437166	19482346	SLC47A1	45180	19434666	19439666
NR_135624	chr17	-	19581627	19622292	SLC47A2	40665	19619792	19624792
NM_017842	chr12	+	48166966	48176536	SLC48A1	9570	48164466	48169466
NM_000342	chr17	-	42325757	42345502	SLC4A1	19745	42343002	42348002
NM_022058	chr2	+	162480844	162841786	SLC4A10	360942	162478344	162483344
NM_001174089	chr20	-	3208062	3219887	SLC4A11	11825	3217387	3222387
NM_018158	chr2	+	27886337	27917847	SLC4A1AP	31510	27883837	27888837
NM_001199692	chr7	+	150755286	150773614	SLC4A2	18328	150752786	150757786
NM_001326559	chr2	+	220492291	220506702	SLC4A3	14411	220489791	220494791
NM_001134742	chr4	+	72053002	72437804	SLC4A4	384802	72050502	72055502
NM_133478	chr2	-	74443368	74570534	SLC4A5	127166	74568034	74573034
NM_001321107	chr3	-	27414211	27525911	SLC4A7	111700	27523411	27528411
NM_001258401	chr12	+	51785100	51909547	SLC4A8	124447	51782600	51787600
NM_001258428	chr5	+	139739786	139754722	SLC4A9	14936	139737286	139742286
NM_001287590	chr1	+	155107819	155111334	SLC50A1	3515	155105319	155110319
NM_152672	chr3	+	195943382	195960301	SLC51A	16919	195940882	195945882
NM_178859	chr15	+	65337707	65345734	SLC51B	8027	65335207	65340207
NM_001104577	chr17	-	4935896	4938727	SLC52A1	2831	4936227	4941227
NM_001253816	chr8	+	145582216	145584948	SLC52A2	2732	145579716	145584716
NM_033409	chr20	-	740723	749228	SLC52A3	8505	746728	751728
NM_000343	chr22	+	32439018	32509011	SLC5A1	69993	32436518	32441518
NM_001282417	chr17	+	18853988	18924004	SLC5A10	70016	18851488	18856488
NM_001258411	chr16	+	24857183	24922949	SLC5A11	65766	24854683	24859683
NM_178498	chr11	-	26688565	26743574	SLC5A12	55009	26741074	26746074
NR_130783	chr16	+	31494438	31502091	SLC5A2	7653	31491938	31496938
NM_006933	chr21	+	35445822	35478561	SLC5A3	32739	35443322	35448322
NM_014227	chr22	-	32614462	32651318	SLC5A4	36856	32648818	32653818
NM_000453	chr19	+	17982781	18005983	SLC5A5	23202	17980281	17985281
NM_021095	chr2	-	27422454	27435175	SLC5A6	12721	27432675	27437675
NM_021815	chr2	+	108602969	108630443	SLC5A7	27474	108600469	108605469
NM_145913	chr12	-	101549993	101604052	SLC5A8	54059	101601552	101606552
NM_001011547	chr1	+	48688356	48714316	SLC5A9	25960	48685856	48690856
NM_001348251	chr3	+	11034419	11080935	SLC6A1	46516	11031919	11036919
NR_046647	chr3	-	11047783	11060910	SLC6A1-AS1	13127	11058410	11063410
NR_003083	chr16	-	32888796	32896463	SLC6A10P	7667	32893963	32898963
NM_014229	chr3	+	10857884	10982419	SLC6A11	124535	10855384	10860384
NM_001206931	chr12	-	299242	323371	SLC6A12	24129	320871	325871
NM_001190997	chr12	-	329786	372039	SLC6A13	42253	369539	374539
NM_007231	chrX	+	115567746	115592625	SLC6A14	24879	115565246	115570246
NM_182767	chr12	-	85253266	85306608	SLC6A15	53342	85304108	85309108
NM_014037	chr19	-	49792891	49828474	SLC6A16	35583	49825974	49830974
NM_001010898	chr1	+	110693135	110744823	SLC6A17	51688	110690635	110695635
NM_182632	chr5	+	1225469	1246304	SLC6A18	20835	1222969	1227969
NM_001003841	chr5	+	1201709	1225230	SLC6A19	23521	1199209	1204209
NM_001172504	chr16	+	55690555	55740104	SLC6A2	49549	55688055	55693055
NM_022405	chr3	-	45796940	45838035	SLC6A20	41095	45835535	45840535
NM_001044	chr5	-	1392904	1445543	SLC6A3	52639	1443043	1448043
NM_001045	chr17	-	28521336	28562986	SLC6A4	41650	28560486	28565486
NM_001318369	chr11	+	20620945	20676610	SLC6A5	55665	20618445	20623445
NM_003043	chr3	+	14444075	14530857	SLC6A6	86782	14441575	14446575
NM_014228	chr5	+	149569423	149590635	SLC6A7	21212	149566923	149571923
NM_001142805	chrX	+	152953751	152962048	SLC6A8	8297	152951251	152956251
NM_001328626	chr1	-	44462154	44497164	SLC6A9	35010	44494664	44499664
NM_003045	chr13	-	30083550	30169825	SLC7A1	86275	30167325	30172325
NM_019849	chr19	-	33699569	33716756	SLC7A10	17187	33714256	33719256
NM_014331	chr4	-	139085247	139163503	SLC7A11	78256	139161003	139166003
NR_038380	chr4	+	139010167	139099331	SLC7A11-AS1	89164	139007667	139012667
NM_138817	chr8	-	87226287	87242604	SLC7A13	16317	87240104	87245104
NM_020949	chr3	-	170177341	170303863	SLC7A14	126522	170301363	170306363
NM_001008539	chr8	+	17354596	17428077	SLC7A2	73481	17352096	17357096
NM_001048164	chrX	-	70145429	70150975	SLC7A3	5546	70148475	70153475
NM_004173	chr22	-	21383006	21386847	SLC7A4	3841	21384347	21389347
NM_003486	chr16	-	87863621	87903105	SLC7A5	39484	87900605	87905605
NR_002594	chr16	-	21529229	21531765	SLC7A5P2	2536	21529265	21534265
NM_003983	chr16	+	68298418	68335726	SLC7A6	37308	68295918	68300918
NM_032178	chr16	-	68334517	68344868	SLC7A6OS	10351	68342368	68347368
NM_001126106	chr14	-	23242431	23289020	SLC7A7	46589	23286520	23291520
NM_012244	chr14	-	23594503	23652869	SLC7A8	58366	23650369	23655369
NM_014270	chr19	-	33321418	33360683	SLC7A9	39265	33358183	33363183
NM_001112802	chr2	-	40339285	40739575	SLC8A1	400290	40737075	40742075
NR_038441	chr2	+	40144773	40482349	SLC8A1-AS1	337576	40142273	40147273
NM_015063	chr19	-	47931278	47975307	SLC8A2	44029	47972807	47977807
NM_182932	chr14	-	70510933	70655787	SLC8A3	144854	70653287	70658287
NM_024959	chr12	-	113736570	113772973	SLC8B1	36403	113770473	113775473
NM_003047	chr1	-	27425299	27481621	SLC9A1	56322	27479121	27484121
NM_003048	chr2	+	103235992	103327809	SLC9A2	91817	103233492	103238492
NM_001284351	chr5	-	472100	524549	SLC9A3	52449	522049	527049
NR_125375	chr5	+	473350	481006	SLC9A3-AS1	7656	470850	475850
NM_004252	chr17	+	72744750	72765499	SLC9A3R1	20749	72742250	72747250
NM_001130012	chr16	+	2076868	2089027	SLC9A3R2	12159	2074368	2079368
NM_001011552	chr2	+	103089761	103150431	SLC9A4	60670	103087261	103092261
NR_136665	chr16	+	67282774	67306107	SLC9A5	23333	67280274	67285274
NM_001330652	chrX	+	135067582	135129428	SLC9A6	61846	135065082	135070082
NM_001257291	chrX	-	46458685	46618607	SLC9A7	159922	46616107	46621107
NR_033801	chr12	-	98847618	98850923	SLC9A7P1	3305	98848423	98853423
NR_048538	chr20	+	48429249	48508779	SLC9A8	79530	48426749	48431749
NM_173653	chr3	-	142984063	143567373	SLC9A9	583310	143564873	143569873
NR_048544	chr3	+	143061087	143065913	SLC9A9-AS1	4826	143058587	143063587
NR_047515	chr4	-	103806204	103940896	SLC9B1	134692	103938396	103943396
NM_001300754	chr4	-	103946647	103998528	SLC9B2	51881	103996028	104001028
NM_001320531	chr3	-	111859751	112013105	SLC9C1	153354	112010605	112015605
NM_178527	chr1	-	173469603	173572233	SLC9C2	102630	173569733	173574733
NM_134431	chr12	-	21417533	21548371	SLCO1A2	130838	21545871	21550871
NM_006446	chr12	+	21284127	21392730	SLCO1B1	108603	21281627	21286627
NM_019844	chr12	+	20963637	21069843	SLCO1B3	106206	20961137	20966137
NM_001009562	chr12	+	21168629	21243040	SLCO1B7	74411	21166129	21171129
NM_001145946	chr12	+	20848288	20906320	SLCO1C1	58032	20845788	20850788
NM_005630	chr3	-	133651539	133748920	SLCO2A1	97381	133746420	133751420
NM_007256	chr11	+	74862031	74917445	SLCO2B1	55414	74859531	74864531
NM_001145044	chr15	+	92396937	92715665	SLCO3A1	318728	92394437	92399437
NM_016354	chr20	+	61273796	61303647	SLCO4A1	29851	61271296	61276296
NR_024470	chr20	-	61294378	61297973	SLCO4A1-AS1	3595	61295473	61300473
NM_180991	chr5	-	101569691	101632253	SLCO4C1	62562	101629753	101634753
NM_030958	chr8	-	70584567	70747299	SLCO5A1	162732	70744799	70749799
NM_001289004	chr5	-	101707485	101834720	SLCO6A1	127235	101832220	101837220
NM_032290	chr5	+	93954390	94031573	SLF1	77183	93951890	93956890
NM_018121	chr10	+	102672325	102724891	SLF2	52566	102669825	102674825
NM_001104588	chr17	-	33677328	33700720	SLFN11	23392	33698220	33703220
NM_001289009	chr17	-	33737940	33760195	SLFN12	22255	33757695	33762695
NM_001195790	chr17	-	33801941	33814758	SLFN12L	12817	33812258	33817258
NM_144682	chr17	-	33762114	33775856	SLFN13	13742	33773356	33778356
NM_001129820	chr17	-	33875143	33885110	SLFN14	9967	33882610	33887610
NM_001330183	chr17	+	33570054	33600673	SLFN5	30619	33567554	33572554
NM_001168247	chr1	-	41481268	41487427	SLFNL1	6159	41484927	41489927
NR_037868	chr1	+	41480261	41509562	SLFNL1-AS1	29301	41477761	41482761
NM_031210	chr14	+	78174413	78183941	SLIRP	9528	78171913	78176913
NM_003061	chr10	-	98757794	98945683	SLIT1	187889	98943183	98948183
NM_004787	chr4	+	20253527	20622184	SLIT2	368657	20251027	20256027
NR_037876	chr4	+	20393811	20396479	SLIT2-IT1	2668	20391311	20396311
NM_003062	chr5	-	168088737	168728133	SLIT3	639396	168725633	168730633
NM_052910	chr13	-	84451339	84456528	SLITRK1	5189	84454028	84459028
NM_032539	chrX	+	144899346	144907360	SLITRK2	8014	144896846	144901846
NM_001318811	chr3	-	164904507	164914897	SLITRK3	10390	164912397	164917397
NM_001184749	chrX	-	142710594	142723926	SLITRK4	13332	142721426	142726426
NM_015567	chr13	+	88324869	88331870	SLITRK5	7001	88322369	88327369
NM_032229	chr13	-	86366921	86373483	SLITRK6	6562	86370983	86375983
NM_014720	chr10	+	105726942	105788991	SLK	62049	105724442	105729442
NM_001304420	chr3	+	57742982	57915741	SLMAP	172759	57740482	57745482
NR_037930	chr20	-	57603732	57617901	SLMO2-ATP5E	14169	57615401	57620401
NM_003063	chr11	-	107578100	107582787	SLN	4687	107580287	107585287
NR_135043	chr15	-	59171243	59225875	SLTM	54632	59223375	59228375
NM_006425	chr5	-	159828647	159846168	SLU7	17521	159843668	159848668
NM_001014999	chr16	+	29465821	29469545	SLX1A	3724	29463321	29468321
NR_037608	chr16	+	30205753	30215650	SLX1A-SULT1A3	9897	30203253	30208253
NM_024044	chr16	+	29465821	29469545	SLX1B	3724	29463321	29468321
NR_037609	chr16	+	30205753	30215650	SLX1B-SULT1A4	9897	30203253	30208253
NM_032444	chr16	-	3631183	3661607	SLX4	30424	3659107	3664107
NM_001009608	chr20	+	10415950	10608682	SLX4IP	192732	10413450	10418450
NR_029426	chr5	-	69434688	69586004	SMA4	151316	69583504	69588504
NR_034021	chr5	-	69776869	69881549	SMA5	104680	69879049	69884049
NM_005900	chr4	+	146402950	146480325	SMAD1	77375	146400450	146405450
NR_126371	chr4	-	146435729	146438346	SMAD1-AS1	2617	146435846	146440846
NR_108077	chr4	-	146418200	146424132	SMAD1-AS2	5932	146421632	146426632
NM_001135937	chr18	-	45359465	45457517	SMAD2	98052	45455017	45460017
NM_005902	chr15	+	67358194	67487533	SMAD3	129339	67355694	67360694
NM_005359	chr18	+	48556582	48611411	SMAD4	54829	48554082	48559082
NM_005903	chr5	+	135468533	135518422	SMAD5	49889	135466033	135471033
NR_026763	chr5	-	135465202	135470579	SMAD5-AS1	5377	135468079	135473079
NR_027654	chr15	+	66994673	67074337	SMAD6	79664	66992173	66997173
NM_001190821	chr18	-	46446222	46477081	SMAD7	30859	46474581	46479581
NM_005905	chr13	-	37418967	37494409	SMAD9	75442	37491909	37496909
NM_001031628	chr12	-	51639132	51664202	SMAGP	25070	51661702	51666702
NM_021940	chr6	+	71377473	71571716	SMAP1	194243	71374973	71379973
NM_022733	chr1	+	40839377	40888998	SMAP2	49621	40836877	40841877
NM_001282874	chrX	-	128580477	128657482	SMARCA1	77005	128654982	128659982
NM_139045	chr9	+	2015218	2193623	SMARCA2	178405	2012718	2017718
NM_003072	chr19	+	11071597	11172958	SMARCA4	101361	11069097	11074097
NM_003601	chr4	+	144434615	144478642	SMARCA5	44027	144432115	144437115
NM_001128430	chr4	+	95128758	95212443	SMARCAD1	83685	95126258	95131258
NM_014140	chr2	+	217277136	217347774	SMARCAL1	70638	217274636	217279636
NM_001317946	chr22	+	24129117	24176705	SMARCB1	47588	24126617	24131617
NM_003074	chr3	-	47627377	47823405	SMARCC1	196028	47820905	47825905
NM_003075	chr12	-	56556142	56583358	SMARCC2	27216	56580858	56585858
NM_139071	chr12	+	50478982	50494494	SMARCD1	15512	50476482	50481482
NM_001098426	chr17	-	61909440	61920351	SMARCD2	10911	61917851	61922851
NM_003078	chr7	-	150936058	150974231	SMARCD3	38173	150971731	150976731
NM_003079	chr17	-	38783975	38804103	SMARCE1	20128	38801603	38806603
NM_001281463	chrX	-	53401069	53449677	SMC1A	48608	53447177	53452177
NM_148674	chr22	-	45739944	45809500	SMC1B	69556	45807e3	45812e3
NM_001265602	chr9	+	106856540	106903700	SMC2	47160	106854040	106859040
NR_121580	chr9	-	106842304	106854755	SMC2-AS1	12451	106852255	106857255
NM_005445	chr10	+	112327448	112364392	SMC3	36944	112324948	112329948
NM_001288753	chr3	+	160117091	160152749	SMC4	35658	160114591	160119591
NM_015110	chr9	+	72873877	72969789	SMC5	95912	72871377	72876377
NR_039990	chr9	-	72830974	72873790	SMC5-AS1	42816	72871290	72876290
NM_024624	chr2	-	17845078	17935096	SMC6	90018	17932596	17937596
NM_015295	chr18	+	2655885	2805015	SMCHD1	149130	2653385	2658385
NM_001320473	chr3	-	196233747	196242237	SMCO1	8490	196239737	196244737
NM_001145010	chr12	+	27619742	27655118	SMCO2	35376	27617242	27622242
NM_001013698	chr12	-	14957583	14967116	SMCO3	9533	14964616	14969616
NM_020179	chr11	-	93211638	93276546	SMCO4	64908	93274046	93279046
NM_030663	chr1	+	152850797	152857523	SMCP	6726	152848297	152853297
NR_131243	chr17	-	17577340	17581002	SMCR2	3662	17578502	17583502
NR_024007	chr17	-	17679999	17682843	SMCR5	2844	17680343	17685343
NM_144775	chr17	+	18218593	18231370	SMCR8	12777	18216093	18221093
NM_033318	chr22	+	42475694	42480288	SMDT1	4594	42473194	42478194
NM_015092	chr16	-	18816174	18937726	SMG1	121552	18935226	18940226
NR_027154	chr16	+	22448328	22503541	SMG1P1	55213	22445828	22450828
NR_135317	chr16	-	29556331	29625038	SMG1P2	68707	29622538	29627538
NR_027155	chr16	-	21458003	21513602	SMG1P3	55599	21511102	21516102
NR_002453	chr16	-	30296338	30346695	SMG1P5	50357	30344195	30349195
NR_135312	chr16	-	29436731	29458347	SMG1P6	21616	29455847	29460847
NR_033959	chr16	-	70253483	70259936	SMG1P7	6453	70257436	70262436
NM_001323617	chr1	-	156219014	156261289	SMG5	42275	156258789	156263789
NM_017575	chr17	-	1963132	2207069	SMG6	243937	2204569	2209569
NM_201568	chr1	+	183441505	183523328	SMG7	81823	183439005	183444005
NR_040063	chr1	-	183430010	183441117	SMG7-AS1	11107	183438617	183443617
NM_018149	chr17	+	57287370	57292611	SMG8	5241	57284870	57289870
NM_019108	chr19	-	44232148	44259188	SMG9	27040	44256688	44261688
NR_131202	chr8	-	123426565	123580883	SMILR	154318	123578383	123583383
NM_001288583	chr1	+	3689324	3692546	SMIM1	3222	3686824	3691824
NM_001271592	chr12	+	11323779	11328619	SMIM10L1	4840	11321279	11326279
NM_203306	chrX	+	134555857	134561999	SMIM10L2A	6142	134553357	134558357
NM_001348255	chrX	-	134229014	134232664	SMIM10L2B	3650	134230164	134235164
NR_103770	chrX	+	134254548	134257529	SMIM10L2B-AS1	2981	134252048	134257048
NM_058182	chr21	+	35747748	35761452	SMIM11A	13704	35745248	35750248
NM_001313692	chr21	+	35747778	35761452	SMIM11B	13674	35745278	35750278
NM_001320261	chr1	-	35315962	35325417	SMIM12	9455	35322917	35327917
NM_001135575	chr6	+	11094265	11138969	SMIM13	44704	11091765	11096765
NM_001317896	chr4	-	39548916	39640618	SMIM14	91702	39638118	39643118
NM_001048249	chr5	-	60453535	60458302	SMIM15	4767	60455802	60460802
NR_109908	chr5	+	60458142	60527907	SMIM15-AS1	69765	60455642	60460642
NM_001193628	chr19	+	57154526	57168614	SMIM17	14088	57152026	57157026
NM_001206847	chr8	+	30496116	30503469	SMIM18	7353	30493616	30498616
NM_001135676	chr8	+	42396297	42408140	SMIM19	11843	42393797	42398797
NM_024058	chr13	-	44717286	44735393	SMIM2	18107	44732893	44737893
NR_104065	chr13	+	44684684	44728211	SMIM2-AS1	43527	44682184	44687184
NR_046843	chr13	-	44720605	44732358	SMIM2-IT1	11753	44729858	44734858
NM_001145432	chr4	+	25915813	25931501	SMIM20	15688	25913313	25918313
NM_001037331	chr18	-	73121430	73139658	SMIM21	18228	73137158	73142158
NM_001253790	chr16	+	4838397	4846492	SMIM22	8095	4835897	4840897
NM_001289970	chr5	+	171212875	171218092	SMIM23	5217	171210375	171215375
NM_001136503	chr19	-	3474404	3480540	SMIM24	6136	3478040	3483040
NM_001278655	chr20	+	48884022	48896332	SMIM25	12310	48881522	48886522
NR_146061	chr9	+	32552231	32566858	SMIM27	14627	32549731	32554731
NM_178508	chr6	-	34214156	34216885	SMIM29	2729	34214385	34219385
NM_032947	chr5	+	150157507	150176298	SMIM3	18791	150155007	150160007
NM_001352885	chr4	+	165675282	165724947	SMIM31	49665	165672782	165677782
NM_001124767	chr3	+	52570620	52574586	SMIM4	3966	52568120	52573120
NM_001162995	chr17	+	73629513	73637486	SMIM5	7973	73627013	73632013
NM_024104	chr19	-	16756958	16770968	SMIM7	14010	16768468	16773468
NM_001287445	chr6	+	88032305	88052046	SMIM8	19741	88029805	88034805
NM_001162936	chrX	-	154051622	154062937	SMIM9	11315	154060437	154065437
NM_001195243	chr7	+	129142319	129152773	SMKR1	10454	129139819	129144819
NM_001195597	chr6	+	131148544	131158276	SMLR1	9732	131146044	131151044
NM_022874	chr5	+	70220767	70248838	SMN1	28071	70218267	70223267
NM_022875	chr5	+	70220767	70248842	SMN2	28075	70218267	70223267
NM_005871	chr10	-	112052797	112064707	SMNDC1	11910	112062207	112067207
NM_005631	chr7	+	128828712	128853385	SMO	24673	128826212	128831212
NM_022137	chr14	+	70346113	70499083	SMOC1	152970	70343613	70348613
NM_022138	chr6	+	168841830	169068674	SMOC2	226844	168839330	168844330
NM_175842	chr20	+	4129425	4168394	SMOX	38969	4126925	4131925
NR_134502	chr11	+	6411643	6416228	SMPD1	4585	6409143	6414143
NM_003080	chr6	+	109761930	109765122	SMPD2	3192	109759430	109764430
NM_018667	chr16	-	68392229	68482409	SMPD3	90180	68479909	68484909
NR_033230	chr2	-	130908964	130940323	SMPD4	31359	130937823	130942823
NM_006714	chr6	+	123110193	123130864	SMPDL3A	20671	123107693	123112693
NM_001304579	chr1	+	28261465	28285668	SMPDL3B	24203	28258965	28263965
NM_014332	chrX	-	21724089	21776278	SMPX	52189	21773778	21778778
NM_012390	chr4	+	71226492	71232823	SMR3A	6331	71223992	71228992
NM_006685	chr4	+	71248794	71255961	SMR3B	7167	71246294	71251294
NM_001258423	chrX	+	21958690	22012955	SMS	54265	21956190	21961190
NM_134270	chr22	+	31477281	31500610	SMTN	23329	31474781	31479781
NM_001105565	chr11	+	57310113	57317747	SMTNL1	7634	57307613	57312613
NM_198501	chr17	+	4487275	4511614	SMTNL2	24339	4484775	4489775
NM_018225	chr9	-	33041849	33076714	SMU1	34865	33074214	33079214
NM_001243788	chr12	-	54574141	54582778	SMUG1	8637	54580278	54585278
NM_001199847	chr7	-	98625057	98741743	SMURF1	116686	98739243	98744243
NM_022739	chr17	-	62540734	62658386	SMURF2	117652	62655886	62660886
NM_198274	chr2	+	88367298	88412902	SMYD1	45604	88364798	88369798
NM_020197	chr1	+	214454564	214510477	SMYD2	55913	214452064	214457064
NM_001167740	chr1	-	245912641	246670644	SMYD3	758003	246668144	246673144
NM_052928	chr17	-	1682828	1733175	SMYD4	50347	1730675	1735675
NM_006062	chr2	+	73441365	73454355	SMYD5	12990	73438865	73443865
NM_005985	chr20	+	48599512	48605420	SNAI1	5908	48597012	48602012
NM_003068	chr8	-	49830238	49833999	SNAI2	3761	49831499	49836499
NM_178310	chr16	-	88744089	88752882	SNAI3	8793	88750382	88755382
NR_024399	chr16	+	88729780	88753594	SNAI3-AS1	23814	88727280	88732280
NM_003825	chr15	+	42787503	42825259	SNAP23	37756	42785003	42790003
NM_130811	chr20	+	10199445	10288068	SNAP25	88623	10196945	10201945
NR_040710	chr20	-	10004459	10200154	SNAP25-AS1	195695	10197654	10202654
NM_004782	chr22	+	21213291	21245501	SNAP29	32210	21210791	21215791
NM_001323933	chr1	+	227915868	227968932	SNAP47	53064	227913368	227918368
NM_001242793	chr6	-	84262604	84419127	SNAP91	156523	84416627	84421627
NM_003082	chr14	+	62229074	62263146	SNAPC1	34072	62226574	62231574
NM_003083	chr19	+	7985193	7988136	SNAPC2	2943	7982693	7987693
NM_001039697	chr9	+	15422781	15461627	SNAPC3	38846	15420281	15425281
NM_003086	chr9	-	139270020	139292889	SNAPC4	22869	139290389	139295389
NM_006049	chr15	-	66782085	66790153	SNAPC5	8068	66787653	66792653
NM_012437	chr1	+	153631129	153634328	SNAPIN	3199	153628629	153633629
NM_001146055	chr4	-	90645249	90759447	SNCA	114198	90756947	90761947
NR_045481	chr4	+	90757551	90763142	SNCA-AS1	5591	90755051	90760051
NR_131762	chr5	+	121647385	121799914	SNCAIP	152529	121644885	121649885
NM_003085	chr5	-	176047084	176057562	SNCB	10478	176055062	176060062
NM_001330120	chr10	+	88715557	88723017	SNCG	7460	88713057	88718057
NM_014390	chr7	+	127292042	127732661	SND1	440619	127289542	127294542
NR_027330	chr7	+	127637561	127640130	SND1-IT1	2569	127635061	127640061
NM_001080437	chr2	+	241938254	242034976	SNED1	96722	241935754	241940754
NM_007241	chr17	-	47007458	47022204	SNF8	14746	47019704	47024704
NR_003098	chr11	-	62619459	62623360	SNHG1	3901	62620860	62625860
NR_003239	chr20	+	37075296	37079564	SNHG11	4268	37072796	37077796
NR_146382	chr1	-	28905049	28909495	SNHG12	4446	28906995	28911995
NR_146177	chr15	+	25068754	25664608	SNHG14	595854	25066254	25071254
NR_003697	chr7	-	45022626	45026259	SNHG15	3633	45023759	45028759
NR_038108	chr17	+	74553845	74561430	SNHG16	7585	74551345	74556345
NR_027241	chr20	-	37049238	37064018	SNHG17	14780	37061518	37066518
NR_045196	chr5	+	9546311	9550409	SNHG18	4098	9543811	9548811
NR_027058	chr17	+	75084724	75091068	SNHG20	6344	75082224	75087224
NR_110096	chr15	+	83419315	83425958	SNHG21	6643	83416815	83421815
NR_117096	chr18	+	47340392	47377429	SNHG22	37037	47337892	47342892
NR_146320	chr7	+	22893858	22901055	SNHG26	7197	22891358	22896358
NR_125884	chr4	+	132685992	132712637	SNHG27	26645	132683492	132688492
NR_147122	chr1	-	159804267	159824827	SNHG28	20560	159822327	159827327
NR_002909	chr1	+	28832454	28837404	SNHG3	4950	28829954	28834954
NR_036536	chr5	+	138609440	138618873	SNHG4	9433	138606940	138611940
NR_002599	chr8	-	67834164	67837777	SNHG6	3613	67835277	67840277
NR_024542	chr9	-	139619045	139622636	SNHG7	3591	139620136	139625136
NM_024700	chr1	-	38000049	38019945	SNIP1	19896	38017445	38022445
NM_003498	chr16	+	11762288	11773015	SNN	10727	11759788	11764788
NR_003307	chr15	+	25451408	25477615	SNORD115-15	26207	25448908	25453908
NR_003313	chr15	+	25451408	25477615	SNORD115-21	26207	25448908	25453908
NM_001318234	chr20	+	1246934	1289971	SNPH	43037	1244434	1249434
NM_001100594	chr3	+	43328003	43392634	SNRK	64631	43325503	43330503
NR_046757	chr3	-	43388410	43393454	SNRK-AS1	5044	43390954	43395954
NM_014014	chr2	-	96940073	96971307	SNRNP200	31234	96968807	96973807
NM_024571	chr16	+	103828	107669	SNRNP25	3841	101328	106328
NR_037862	chr2	+	70121074	70132368	SNRNP27	11294	70118574	70123574
NR_104103	chr12	+	123942650	123956909	SNRNP35	14259	123940150	123945150
NM_004814	chr1	-	31732414	31769644	SNRNP40	37230	31767144	31772144
NM_152551	chr6	+	7590431	7612200	SNRNP48	21769	7587931	7592931
NM_001301069	chr19	+	49588396	49611870	SNRNP70	23474	49585896	49590896
NM_004596	chr19	+	41256758	41271297	SNRPA	14539	41254258	41259258
NR_135506	chr15	-	101821714	101835487	SNRPA1	13773	101832987	101837987
NM_003091	chr20	-	2442280	2451499	SNRPB	9219	2448999	2453999
NM_003092	chr20	+	16710608	16722417	SNRPB2	11809	16708108	16713108
NM_003093	chr6	+	34724870	34741634	SNRPC	16764	34722370	34727370
NM_006938	chr18	+	19192229	19210206	SNRPD1	17977	19189729	19194729
NM_004597	chr19	-	46190711	46195574	SNRPD2	4863	46193074	46198074
NM_001278656	chr22	+	24951617	24970932	SNRPD3	19315	24949117	24954117
NM_003094	chr1	+	203830712	203840280	SNRPE	9568	203828212	203833212
NM_003095	chr12	+	96252708	96260238	SNRPF	7530	96250208	96255208
NM_001317171	chr2	-	70508493	70520903	SNRPG	12410	70518403	70523403
NM_022808	chr15	+	25068754	25223870	SNRPN	155116	25066254	25071254
NM_003098	chr20	-	31995762	32031698	SNTA1	35936	32029198	32034198
NM_021021	chr8	-	121547984	121824309	SNTB1	276325	121821809	121826809
NM_006750	chr16	+	69221049	69342955	SNTB2	121906	69218549	69223549
NM_001287813	chr8	+	50822285	51709216	SNTG1	886931	50819785	50824785
NM_018968	chr2	+	946553	1371384	SNTG2	424831	944053	949053
NM_001348756	chr3	+	63638343	63650891	SNTN	12548	63635843	63640843
NM_005008	chr22	-	42069936	42084913	SNU13	14977	42082413	42087413
NM_001042588	chr15	-	75890423	75918719	SNUPN	28296	75916219	75921219
NM_005678	chr15	+	25200039	25223870	SNURF	23831	25197539	25202539
NM_001318844	chr14	-	78183943	78227497	SNW1	43554	78224997	78229997
NM_001242933	chr15	+	64388082	64436433	SNX1	48351	64385582	64390582
NM_013322	chr7	+	26331514	26413949	SNX10	82435	26329014	26334014
NM_001330320	chr17	+	46184894	46200963	SNX11	16069	46182394	46187394
NM_001256185	chrX	-	70279096	70293276	SNX12	14180	70290776	70295776
NM_015132	chr7	-	17830384	17980131	SNX13	149747	17977631	17982631
NM_001304479	chr6	-	86215214	86303874	SNX14	88660	86301374	86306374
NM_147777	chr11	+	64794879	64808044	SNX15	13165	64792379	64797379
NM_152837	chr8	-	82711817	82754521	SNX16	42704	82752021	82757021
NR_049785	chr2	+	27593362	27600400	SNX17	7038	27590862	27595862
NM_001145427	chr5	+	53813588	53842416	SNX18	28828	53811088	53816088
NM_014758	chr11	-	130745765	130786382	SNX19	40617	130783882	130788882
NM_003100	chr5	+	122110690	122170234	SNX2	59544	122108190	122113190
NM_153337	chr16	-	50700210	50715264	SNX20	15054	50712764	50717764
NM_152897	chr20	+	44462469	44471914	SNX21	9445	44459969	44464969
NR_073534	chr15	+	64443915	64449680	SNX22	5765	64441415	64446415
NM_014035	chr5	+	122181143	122344907	SNX24	163764	122178643	122183643
NM_001317781	chr4	+	186125390	186285125	SNX25	159735	186122890	186127890
NM_001330723	chr1	+	151584661	151671559	SNX27	86898	151582161	151587161
NM_032167	chr16	+	12070590	12668146	SNX29	597556	12068090	12073090
NR_045011	chr16	+	21360683	21397254	SNX29P1	36571	21358183	21363183
NR_002939	chr16	+	29313607	29376380	SNX29P2	62773	29311107	29316107
NM_001300929	chr6	-	108532420	108582464	SNX3	50044	108579964	108584964
NM_001012994	chr9	+	115513133	115637267	SNX30	124134	115510633	115515633
NM_152628	chr8	-	101585111	101661893	SNX31	76782	101659393	101664393
NM_152760	chr11	+	65601409	65621172	SNX32	19763	65598909	65603909
NM_153271	chr15	+	75941347	75950968	SNX33	9621	75938847	75943847
NR_073435	chr3	-	125165487	125239058	SNX4	73571	125236558	125241558
NM_001282454	chr20	-	17922239	17949634	SNX5	27395	17947134	17952134
NM_152233	chr14	-	35030298	35099389	SNX6	69091	35096889	35101889
NM_015976	chr1	+	99127235	99226056	SNX7	98821	99124735	99129735
NM_013321	chr7	-	2291404	2354110	SNX8	62706	2351610	2356610
NM_016224	chr6	+	158244202	158366109	SNX9	121907	158241702	158246702
NM_001252511	chr1	+	179262848	179327814	SOAT1	64966	179260348	179265348
NM_003578	chr12	+	53497273	53518323	SOAT2	21050	53494773	53499773
NM_018013	chr6	+	107811316	107982513	SOBP	171197	107808816	107813816
NM_003877	chr12	+	93963597	93970521	SOCS2	6924	93961097	93966097
NR_038263	chr12	-	93959403	93965174	SOCS2-AS1	5771	93962674	93967674
NM_003955	chr17	-	76352857	76356160	SOCS3	3303	76353660	76358660
NM_080867	chr14	+	55493843	55516206	SOCS4	22363	55491343	55496343
NM_014011	chr2	+	46926098	46989927	SOCS5	63829	46923598	46928598
NM_004232	chr18	+	67956136	67997434	SOCS6	41298	67953636	67958636
NM_014598	chr17	+	36508006	36561846	SOCS7	53840	36505506	36510506
NM_000454	chr21	+	33031934	33041243	SOD1	9309	33029434	33034434
NM_001322817	chr6	-	160100095	160183561	SOD2	83466	160181061	160186061
NM_003102	chr4	+	24797084	24802467	SOD3	5383	24794584	24799584
NM_080627	chr20	-	35405844	35492087	SOGA1	86243	35489587	35494587
NM_001012279	chr6	-	127759550	127840500	SOGA3	80950	127838e3	127843e3
NM_001012415	chr9	-	138585254	138591374	SOHLH1	6120	138588874	138593874
NM_017826	chr13	-	36742344	36788752	SOHLH2	46408	36786252	36791252
NM_138927	chr21	+	34915343	34949820	SON	34477	34912843	34917843
NM_015385	chr10	-	97071529	97321177	SORBS1	249648	97318677	97323677
NM_001270771	chr4	-	186506597	186877870	SORBS2	371273	186875370	186880370
NM_005775	chr8	+	22409250	22433008	SORBS3	23758	22406750	22411750
NM_001206572	chr10	-	108333420	108924466	SORCS1	591046	108921966	108926966
NM_020777	chr4	+	7194373	7744564	SORCS2	550191	7191873	7196873
NM_014978	chr10	+	106400858	107025000	SORCS3	624142	106398358	106403358
NR_034039	chr15	+	45315301	45367287	SORD	51986	45312801	45317801
NR_146394	chr15	-	45117944	45176892	SORD2P	58948	45174392	45179392
NM_003105	chr11	+	121322911	121504471	SORL1	181560	121320411	121325411
NM_002959	chr1	-	109852187	109940567	SORT1	88380	109938067	109943067
NM_005633	chr2	-	39208689	39347604	SOS1	138915	39345104	39350104
NM_006939	chr14	-	50583838	50698411	SOS2	114573	50695911	50700911
NM_025237	chr17	-	41831098	41836156	SOST	5058	41833656	41838656
NM_015464	chr7	-	16501105	16505474	SOSTDC1	4369	16502974	16507974
NM_175873	chr5	+	132149015	132152489	SOWAHA	3474	132146515	132151515
NM_001029870	chr4	-	77816081	77819002	SOWAHB	2921	77816502	77821502
NM_023016	chr2	+	110371910	110376564	SOWAHC	4654	110369410	110374410
NM_005986	chr13	+	112721912	112726020	SOX1	4108	112719412	112724412
NR_120392	chr13	+	112626623	112762329	SOX1-OT	135706	112624123	112629123
NM_006941	chr22	-	38368318	38380539	SOX10	12221	38378039	38383039
NM_003108	chr2	+	5832798	5841517	SOX11	8719	5830298	5835298
NM_006943	chr20	+	306214	310872	SOX12	4658	303714	308714
NM_005686	chr1	+	204042245	204096871	SOX13	54626	204039745	204044745
NM_022454	chr8	+	55370494	55373456	SOX17	2962	55367994	55372994
NM_003106	chr3	+	181429711	181432223	SOX2	2512	181427211	181432211
NR_075092	chr3	+	180774467	181460013	SOX2-OT	685546	180771967	180776967
NM_007084	chr13	-	95361878	95364797	SOX21	2919	95362297	95367297
NR_046514	chr13	+	95364969	95368199	SOX21-AS1	3230	95362469	95367469
NM_001308165	chr5	-	157052686	157098488	SOX30	45802	157095988	157100988
NM_003107	chr6	+	21593971	21598849	SOX4	4878	21591471	21596471
NM_152989	chr12	-	23682437	24715524	SOX5	1033087	24713024	24718024
NR_120472	chr12	+	24376204	24390899	SOX5-AS1	14695	24373704	24378704
NM_033326	chr11	-	15987994	16497935	SOX6	509941	16495435	16500435
NM_031439	chr8	-	10581277	10588084	SOX7	6807	10585584	10590584
NM_014587	chr16	+	1031807	1036979	SOX8	5172	1029307	1034307
NM_000346	chr17	+	70117160	70122560	SOX9	5400	70114660	70119660
NR_103738	chr17	-	70067182	70112157	SOX9-AS1	44975	70109657	70114657
NM_138473	chr12	+	53773978	53810226	SP1	36248	53771478	53776478
NM_001080391	chr2	+	231280870	231410317	SP100	129447	231278370	231283370
NM_080424	chr2	-	231033644	231084827	SP110	51183	231082327	231087327
NM_007237	chr2	+	231090444	231177930	SP140	87486	231087944	231092944
NM_001352892	chr2	+	231191885	231268447	SP140L	76562	231189385	231194385
NM_003110	chr17	+	45973515	46006323	SP2	32808	45971015	45976015
NR_103856	chr17	-	45975751	46018770	SP2-AS1	43019	46016270	46021270
NM_003111	chr2	-	174771186	174830430	SP3	59244	174827930	174832930
NM_001326543	chr7	+	21467651	21554440	SP4	86789	21465151	21470151
NM_001003845	chr2	+	171571856	171574498	SP5	2642	171569356	171574356
NM_199262	chr17	-	45922279	45933240	SP6	10961	45930740	45935740
NM_001300837	chr12	-	53720359	53738577	SP7	18218	53736077	53741077
NM_182700	chr7	-	20821893	20826508	SP8	4615	20824008	20829008
NM_017425	chr11	+	124543739	124564687	SPA17	20948	124541239	124546239
NM_030960	chr6	+	88757506	88776550	SPACA1	19044	88755006	88760006
NM_173847	chr17	+	31318881	31324895	SPACA3	6014	31316381	31321381
NM_205856	chrX	+	47863733	47869126	SPACA5	5393	47861233	47866233
NM_001316994	chr19	+	52192686	52208443	SPACA6	15757	52190186	52195186
NR_108100	chr19	-	52188615	52196709	SPACA6P-AS	8094	52194209	52199209
NM_145248	chr13	+	113030650	113089009	SPACA7	58359	113028150	113033150
NM_001316898	chr9	+	135753706	135765419	SPACA9	11713	135751206	135756206
NM_172218	chr8	+	101170262	101254132	SPAG1	83870	101167762	101172762
NM_001081552	chr8	+	7705401	7721319	SPAG11A	15918	7702901	7707901
NM_058202	chr8	-	7305275	7321192	SPAG11B	15917	7318692	7323692
NM_024532	chr2	+	214149102	215275225	SPAG16	1126123	214146602	214151602
NM_206996	chr1	-	118496217	118727892	SPAG17	231675	118725392	118730392
NM_001317931	chr20	+	34203805	34209016	SPAG4	5211	34201305	34206305
NM_006461	chr17	-	26904582	26926056	SPAG5	21474	26923556	26928556
NR_040012	chr17	+	26926150	26944395	SPAG5-AS1	18245	26923650	26928650
NM_012443	chr10	+	22634373	22706539	SPAG6	72166	22631873	22636873
NM_004890	chr17	-	4862520	4871132	SPAG7	8612	4868632	4873632
NM_172312	chr9	-	35807781	35812259	SPAG8	4478	35809759	35814759
NM_001130528	chr17	-	49039534	49198226	SPAG9	158692	49195726	49200726
NM_003117	chr7	+	123565285	123611461	SPAM1	46176	123562785	123567785
NR_037183	chrX	+	140590842	140738069	SPANXA2-OT1	147227	140588342	140593342
NM_001009614	chrX	+	144329106	144337728	SPANXN1	8622	144326606	144331606
NM_001009615	chrX	-	142795134	142803762	SPANXN2	8628	142801262	142806262
NM_001009609	chrX	-	142596563	142605303	SPANXN3	8740	142602803	142607803
NM_001009613	chrX	+	142113703	142122066	SPANXN4	8363	142111203	142116203
NM_003118	chr5	-	151040656	151066615	SPARC	25959	151064115	151069115
NM_001291976	chr4	-	88394481	88450655	SPARCL1	56174	88448155	88453155
NM_001142294	chr13	-	36875774	36944317	SPART	68543	36941817	36946817
NR_045180	chr13	+	36920567	36943872	SPART-AS1	23305	36918067	36923067
NM_199436	chr2	+	32288679	32382706	SPAST	94027	32286179	32291179
NM_001310156	chr1	+	84971983	85022178	SPATA1	50195	84969483	84974483
NM_181727	chr3	+	57094468	57109460	SPATA12	14992	57091968	57096968
NM_001286792	chr13	+	24553764	24881212	SPATA13	327448	24551264	24556264
NM_031955	chr3	-	172607146	172859058	SPATA16	251912	172856558	172861558
NM_138796	chr1	+	217804665	218041495	SPATA17	236830	217802165	217807165
NR_125784	chr1	-	217954539	217958462	SPATA17-AS1	3923	217955962	217960962
NM_145263	chr4	+	52917496	52963471	SPATA18	45975	52914996	52919996
NM_174927	chr11	-	133710516	133715433	SPATA19	4917	133712933	133717933
NM_006038	chr20	-	48519928	48532080	SPATA2	12152	48529580	48534580
NM_001258373	chr17	+	48624449	48633213	SPATA20	8764	48621949	48626949
NR_148413	chr1	-	16722175	16763919	SPATA21	41744	16761419	16766419
NM_001321337	chr17	-	3343305	3417146	SPATA22	73841	3414646	3419646
NM_194296	chr5	-	138732455	138739776	SPATA24	7321	138737276	138742276
NM_152339	chr16	-	89762764	89768121	SPATA2L	5357	89765621	89770621
NM_139073	chr2	+	231860838	231871999	SPATA3	11161	231858338	231863338
NR_033879	chr2	-	231849082	231860747	SPATA3-AS1	11665	231858247	231863247
NM_001085452	chr9	+	39355665	39361959	SPATA31A1	6294	39353165	39358165
NM_001083124	chr9	+	40700290	40706537	SPATA31A3	6247	40697790	40702790
NM_001113541	chr9	-	41321106	41327364	SPATA31A5	6258	41324864	41329864
NM_001145196	chr9	-	43624501	43630730	SPATA31A6	6229	43628230	43633230
NM_015667	chr9	-	41321109	41327364	SPATA31A7	6255	41324864	41329864
NM_001145124	chr9	+	90532876	90538572	SPATA31C1	5696	90530376	90535376
NM_001350978	chr9	-	90744219	90753396	SPATA31C2	9177	90750896	90755896
NM_001001670	chr9	+	84603686	84610171	SPATA31D1	6485	84601186	84606186
NM_207416	chr9	+	84558414	84565009	SPATA31D3	6595	84555914	84560914
NM_001145197	chr9	+	84543342	84549913	SPATA31D4	6571	84540842	84545842
NR_026851	chr9	+	84528351	84534842	SPATA31D5P	6491	84525851	84530851
NM_178828	chr9	+	90497771	90503814	SPATA31E1	6043	90495271	90500271
NM_152343	chr17	-	43331759	43339479	SPATA32	7720	43336979	43341979
NM_153025	chr16	+	89724151	89736866	SPATA33	12715	89721651	89726651
NM_144644	chr4	-	177105724	177116822	SPATA4	11098	177114322	177119322
NR_028139	chr15	-	100884661	100890923	SPATA41	6262	100888423	100893423
NM_001024601	chr1	-	213003484	213020991	SPATA45	17507	213018491	213023491
NM_182581	chr1	-	162343514	162346644	SPATA46	3130	162344144	162349144
NM_145207	chr4	+	123844224	124240604	SPATA5	396380	123841724	123846724
NR_136648	chr15	+	45694518	45713616	SPATA5L1	19098	45692018	45697018
NM_001286239	chr1	-	48761043	48937880	SPATA6	176837	48935380	48940380
NM_001039395	chr9	-	4598315	4666674	SPATA6L	68359	4664174	4669174
NM_001040428	chr14	+	88851987	88904804	SPATA7	52817	88849487	88854487
NR_102753	chr15	-	97315234	97326567	SPATA8-AS1	11333	97324067	97329067
NM_001349303	chr5	-	94994019	95067550	SPATA9	73531	95065050	95070050
NM_001134374	chr8	+	145086581	145102015	SPATC1	15434	145084081	145089081
NM_032261	chr21	-	47581061	47604373	SPATC1L	23312	47601873	47606873
NM_145026	chr6	+	44310396	44344904	SPATS1	34508	44307896	44312896
NR_120663	chr12	+	49760687	49921209	SPATS2	160522	49758187	49763187
NM_001282735	chr2	+	201170603	201346986	SPATS2L	176383	201168103	201173103
NM_001317031	chr19	-	11256169	11266488	SPC24	10319	11263988	11268988
NM_020675	chr2	-	169727400	169746944	SPC25	19544	169744444	169749444
NM_014752	chr11	+	74660291	74690076	SPCS2	29785	74657791	74662791
NM_021928	chr4	+	177241089	177253396	SPCS3	12307	177238589	177243589
NM_012391	chr6	-	34505578	34524110	SPDEF	18532	34521610	34526610
NM_001329643	chr5	+	169010637	169031781	SPDL1	21144	169008137	169013137
NM_182756	chr2	+	29033699	29073475	SPDYA	39776	29031199	29036199
NM_001008778	chr11	+	64937706	64940688	SPDYC	2982	64935206	64940206
NM_175064	chr7	+	44040488	44049723	SPDYE1	9235	44037988	44042988
NR_146079	chr7	+	74867122	74918014	SPDYE10P	50892	74864622	74869622
NM_001351349	chr7	+	74938328	74945320	SPDYE11	6992	74935828	74940828
NR_146073	chr7	+	74938128	74946406	SPDYE13P	8278	74935628	74940628
NR_146072	chr7	+	74938128	74946406	SPDYE14P	8278	74935628	74940628
NR_146074	chr7	+	74938128	74946406	SPDYE15P	8278	74935628	74940628
NM_001351597	chr7	-	76163010	76169703	SPDYE16	6693	76167203	76172203
NM_001351351	chr7	+	74937794	74945223	SPDYE17	7429	74935294	74940294
NM_001351348	chr7	-	76682049	76690198	SPDYE18	8149	76687698	76692698
NM_001031618	chr7	+	102191678	102202757	SPDYE2	11079	102189178	102194178
NM_001166339	chr7	+	102191678	102202757	SPDYE2B	11079	102189178	102194178
NM_001004351	chr7	+	99905324	99919819	SPDYE3	14495	99902824	99907824
NM_001128076	chr17	-	8656423	8661877	SPDYE4	5454	8659377	8664377
NM_001306141	chr7	+	75122946	75133628	SPDYE5	10682	75120446	75125446
NM_001146210	chr7	-	101986191	101996889	SPDYE6	10698	101994389	101999389
NR_003666	chr7	-	72333320	72339656	SPDYE7P	6336	72337156	72342156
NR_003664	chr7	+	74936532	74946587	SPDYE8P	10055	74934032	74939032
NM_001243439	chr17	+	19912648	20218072	SPECC1	305424	19910148	19915148
NM_001254732	chr22	+	24666784	24813708	SPECC1L	146924	24664284	24669284
NR_103546	chr22	+	24666784	24838328	SPECC1L-ADORA2A	171544	24664284	24669284
NM_015417	chr20	-	3758150	3762102	SPEF1	3952	3759602	3764602
NM_024867	chr5	+	35617988	35814713	SPEF2	196725	35615488	35620488
NM_005876	chr2	+	220299699	220358354	SPEG	58655	220297199	220302199
NM_015001	chr1	+	16174358	16266950	SPEN	92592	16171858	16176858
NM_152719	chr13	+	46276438	46288694	SPERT	12256	46273938	46278938
NM_145658	chr15	+	69222838	69239150	SPESP1	16312	69220338	69225338
NM_001160227	chr15	-	44854893	44955876	SPG11	100983	44953376	44958376
NM_001127890	chr15	-	65255361	65282284	SPG21	26923	65279784	65284784
NM_003119	chr16	+	89574795	89624176	SPG7	49381	89572295	89577295
NM_021972	chr17	+	74380689	74383941	SPHK1	3252	74378189	74383189
NM_001204158	chr19	+	49122547	49133663	SPHK2	11116	49120047	49125047
NM_001142644	chr2	-	228844669	229046361	SPHKAP	201692	229043861	229048861
NM_003120	chr11	-	47376408	47400127	SPI1	23719	47397627	47402627
NM_001243998	chr19	+	50922194	50934309	SPIB	12115	50919694	50924694
NM_152323	chr12	+	101869198	101880775	SPIC	11577	101866698	101871698
NM_144718	chr3	-	113161564	113234034	SPICE1	72470	113231534	113236534
NM_001282919	chr8	+	48173469	48648563	SPIDR	475094	48170969	48175969
NM_006717	chr9	+	91003296	91093622	SPIN1	90326	91000796	91005796
NR_027139	chrX	-	57002802	57021988	SPIN3	19186	57019488	57024488
NM_001012968	chrX	-	62567106	62571218	SPIN4	4112	62568718	62573718
NM_003122	chr5	-	147204142	147218794	SPINK1	14652	147216294	147221294
NM_001040129	chr5	+	147648422	147665773	SPINK13	17351	147645922	147650922
NM_001001325	chr5	+	147548108	147555182	SPINK14	7074	147545608	147550608
NM_021114	chr4	-	57676025	57688035	SPINK2	12010	57685535	57690535
NM_014471	chr9	+	33240161	33248565	SPINK4	8404	33237661	33242661
NM_001127698	chr5	+	147443534	147516925	SPINK5	73391	147441034	147446034
NM_001195290	chr5	+	147582356	147594700	SPINK6	12344	147579856	147584856
NM_032566	chr5	+	147691989	147695481	SPINK7	3492	147689489	147694489
NM_001080525	chr3	-	48348335	48369831	SPINK8	21496	48367331	48372331
NM_001040433	chr5	+	147715121	147719412	SPINK9	4291	147712621	147717621
NM_003710	chr15	+	41136245	41149853	SPINT1	13608	41133745	41138745
NR_146468	chr15	-	41128190	41136722	SPINT1-AS1	8532	41134222	41139222
NM_001166103	chr19	+	38755097	38783254	SPINT2	28157	38752597	38757597
NM_006652	chr20	-	44141100	44144264	SPINT3	3164	44141764	44146764
NM_178455	chr20	+	44350973	44354469	SPINT4	3496	44348473	44353473
NM_020148	chr18	-	12446510	12657912	SPIRE1	211402	12655412	12660412
NM_032451	chr16	+	89894906	89937727	SPIRE2	42821	89892406	89897406
NM_001030288	chr16	+	29674270	29681823	SPN	7553	29671770	29676770
NM_001142450	chr16	+	28986095	28995869	SPNS1	9774	28983595	28988595
NM_001124758	chr17	+	4402137	4442332	SPNS2	40195	4399637	4404637
NM_001320449	chr17	+	4337218	4391499	SPNS3	54281	4334718	4339718
NM_012444	chr20	+	55904830	55919049	SPO11	14219	55902330	55907330
NM_001281988	chr1	-	32256022	32281652	SPOCD1	25630	32279152	32284152
NM_004598	chr5	-	136310986	136835018	SPOCK1	524032	136832518	136837518
NM_014767	chr10	-	73818791	73848790	SPOCK2	29999	73846290	73851290
NM_001204355	chr4	-	167654535	168155741	SPOCK3	501206	168153241	168158241
NM_006108	chr11	+	13984183	14289679	SPON1	305496	13981683	13986683
NM_001199021	chr4	-	1160720	1202750	SPON2	42030	1200250	1205250
NM_003563	chr17	-	47676245	47755525	SPOP	79280	47753025	47758025
NM_001001664	chr2	+	139259349	139330805	SPOPL	71456	139256849	139261849
NM_016390	chr9	-	131581929	131592100	SPOUT1	10171	131589600	131594600
NM_001251829	chr4	+	88896801	88904563	SPP1	7762	88894301	88899301
NM_006944	chr2	+	234959345	234985776	SPP2	26431	234956845	234961845
NM_032802	chr15	-	50999736	51057910	SPPL2A	58174	51055410	51060410
NM_152988	chr19	+	2328628	2355100	SPPL2B	26472	2326128	2331128
NM_139015	chr12	-	121200312	121342155	SPPL3	141843	121339655	121344655
NM_003124	chr2	+	73114511	73119289	SPR	4778	73112011	73117011
NM_152594	chr15	+	38545051	38649450	SPRED1	104399	38542551	38547551
NM_181784	chr2	-	65537984	65659656	SPRED2	121672	65657156	65662156
NM_001042522	chr19	+	38880839	38890523	SPRED3	9684	38878339	38883339
NM_001012508	chr10	-	135234169	135238121	SPRN	3952	135235621	135240621
NR_033789	chr10	-	135380437	135383462	SPRNP1	3025	135380962	135385962
NM_032018	chr1	+	231473681	231490773	SPRTN	17092	231471181	231476181
NM_199327	chr4	+	124317949	124324915	SPRY1	6966	124315449	124320449
NM_005842	chr13	-	80910110	80915250	SPRY2	5140	80912750	80917750
NM_001304990	chrX	+	154842225	155012119	SPRY3	169894	154839725	154844725
NM_030964	chr5	-	141689991	141704620	SPRY4	14629	141702120	141707120
NR_120664	chr5	+	141704857	141843619	SPRY4-AS1	138762	141702357	141707357
NM_032840	chr12	-	53458099	53473204	SPRYD3	15105	53470704	53475704
NR_023351	chr13	-	50486837	50510637	SPRYD7	23800	50508137	50513137
NM_025106	chr1	+	9352940	9429590	SPSB1	76650	9350440	9355440
NM_080861	chr16	-	1826712	1832581	SPSB3	5869	1830081	1835081
NM_080862	chr3	+	140770243	140867453	SPSB4	97210	140767743	140772743
NM_003126	chr1	-	158580495	158656506	SPTA1	76011	158654006	158659006
NM_001195532	chr9	+	131314836	131395944	SPTAN1	81108	131312336	131317336
NM_001024858	chr14	-	65213000	65289866	SPTB	76866	65287366	65292366
NM_003128	chr2	+	54683453	54898583	SPTBN1	215130	54680953	54685953
NM_006946	chr11	-	66452719	66488870	SPTBN2	36151	66486370	66491370
NM_020971	chr19	+	40973125	41082365	SPTBN4	109240	40970625	40975625
NM_016642	chr15	-	42140343	42186275	SPTBN5	45932	42183775	42188775
NM_006415	chr9	-	94793415	94877756	SPTLC1	84341	94875256	94880256
NM_004863	chr14	-	77972339	78083110	SPTLC2	110771	78080610	78085610
NM_001349945	chr20	+	12989601	13147411	SPTLC3	157810	12987101	12992101
NM_138288	chr14	-	34902143	34931468	SPTSSA	29325	34928968	34933968
NM_001320679	chr3	-	161062579	161090738	SPTSSB	28159	161088238	161093238
NM_194285	chr11	-	18627947	18656020	SPTY2D1	28073	18653520	18658520
NR_038360	chr11	+	18621350	18631802	SPTY2D1-AS1	10452	18618850	18623850
NM_030572	chr12	+	21679190	21685881	SPX	6691	21676690	21681690
NM_003129	chr8	+	126010719	126034525	SQLE	23806	126008219	126013219
NM_001271213	chr15	+	45923345	45983492	SQOR	60147	45920845	45925845
NM_001142298	chr5	+	179233387	179265077	SQSTM1	31690	179230887	179235887
NM_001035235	chr5	-	139929651	139937678	SRA1	8027	139935178	139940178
NM_018079	chr2	-	45615818	45838433	SRBD1	222615	45835933	45840933
NM_005417	chr20	+	35973087	36033835	SRC	60748	35970587	35975587
NM_006662	chr16	+	30710461	30751450	SRCAP	40989	30707961	30712961
NM_025248	chr17	-	36686258	36762183	SRCIN1	75925	36759683	36764683
NM_001324323	chr5	+	6633434	6669675	SRD5A1	36241	6630934	6635934
NM_000348	chr2	-	31749655	31806040	SRD5A2	56385	31803540	31808540
NM_024592	chr4	+	56212387	56239266	SRD5A3	26879	56209887	56214887
NR_037969	chr4	-	56232767	56251747	SRD5A3-AS1	18980	56249247	56254247
NM_004176	chr17	-	17714662	17740325	SREBF1	25663	17737825	17742825
NR_103834	chr22	+	42229082	42303312	SREBF2	74230	42226582	42231582
NM_001323527	chr5	+	65440045	65479444	SREK1	39399	65437545	65442545
NM_173829	chr5	-	64013977	64064496	SREK1IP1	50519	64061996	64066996
NM_003131	chr6	+	43139032	43149244	SRF	10212	43136532	43141532
NM_152546	chr5	+	121297655	121364295	SRFBP1	66640	121295155	121300155
NM_001346201	chr12	+	64238532	64541643	SRGAP1	303111	64236032	64241032
NM_015326	chr1	+	206516199	206637783	SRGAP2	121584	206513699	206518699
NR_104189	chr1	-	121102016	121139765	SRGAP2-AS1	37749	121137265	121142265
NM_001330684	chr1	+	121107151	121134685	SRGAP2B	27534	121104651	121109651
NM_001271872	chr1	+	121107151	121134735	SRGAP2C	27584	121104651	121109651
NR_120535	chr1	+	206557366	206581301	SRGAP2D	23935	206554866	206559866
NM_014850	chr3	-	9022275	9291369	SRGAP3	269094	9288869	9293869
NR_103443	chr3	+	9258578	9261192	SRGAP3-AS3	2614	9256078	9261078
NR_146969	chr3	+	9291439	9299191	SRGAP3-AS4	7752	9288939	9293939
NM_001321053	chr10	+	70847201	70864567	SRGN	17366	70844701	70849701
NM_198901	chr7	-	87834431	87856308	SRI	21877	87853808	87858808
NM_001323667	chr16	-	4239374	4292081	SRL	52707	4289581	4294581
NM_003132	chr1	-	11114648	11120091	SRM	5443	11117591	11122591
NM_080823	chr20	-	62171276	62178857	SRMS	7581	62176357	62181357
NM_003134	chr15	-	40327890	40331403	SRP14	3513	40328903	40333903
NR_040059	chr15	+	40331511	40359710	SRP14-AS1	28199	40329011	40334011
NM_001204199	chr5	+	112196884	112228776	SRP19	31892	112194384	112199384
NM_001146282	chr14	+	35452103	35498773	SRP54	46670	35449603	35454603
NM_014230	chr17	-	74034855	74068607	SRP68	33752	74066107	74071107
NM_001267722	chr4	+	57333761	57369847	SRP72	36086	57331261	57336261
NM_001130440	chr1	+	225965514	225978168	SRP9	12654	225963014	225968014
NR_034069	chr6	-	35800810	35888957	SRPK1	88147	35886457	35891457
NM_001350740	chr7	-	104756820	105029837	SRPK2	273017	105027337	105032337
NM_014370	chrX	+	153046455	153051187	SRPK3	4732	153043955	153048955
NM_001177842	chr11	-	126132813	126138877	SRPRA	6064	126136377	126141377
NM_021203	chr3	+	133502876	133540336	SRPRB	37460	133500376	133505376
NM_001170752	chrX	-	38008587	38080177	SRPX	71590	38077677	38082677
NM_014467	chrX	+	99899162	99926296	SRPX2	27134	99896662	99901662
NM_021947	chr17	+	2207236	2228558	SRR	21322	2204736	2209736
NM_001013694	chr22	+	26879849	26887904	SRRD	8055	26877349	26882349
NM_001303448	chr1	+	24969593	24999772	SRRM1	30179	24967093	24972093
NM_016333	chr16	+	2802329	2821413	SRRM2	19084	2799829	2804829
NR_027275	chr16	-	2787076	2802601	SRRM2-AS1	15525	2800101	2805101
NM_001110199	chr7	+	75831210	75916609	SRRM3	85399	75828710	75833710
NM_194286	chr12	+	119419299	119600856	SRRM4	181557	119416799	119421799
NM_015908	chr7	+	100472700	100486285	SRRT	13585	100470200	100475200
NM_006924	chr17	-	56078279	56084707	SRSF1	6428	56082207	56087207
NR_034035	chr1	-	24290836	24306953	SRSF10	16117	24304453	24309453
NM_001350609	chr1	+	70671364	70718732	SRSF11	47368	70668864	70673864
NM_080743	chr6	-	89805677	89827800	SRSF12	22123	89825300	89830300
NM_003016	chr17	-	74730196	74733493	SRSF2	3297	74730993	74735993
NM_003017	chr6	+	36562089	36572244	SRSF3	10155	36559589	36564589
NM_005626	chr1	-	29474249	29508637	SRSF4	34388	29506137	29511137
NM_006925	chr14	+	70233803	70238722	SRSF5	4919	70231303	70236303
NM_006275	chr20	+	42086503	42092244	SRSF6	5741	42084003	42089003
NM_001031684	chr2	-	38970740	38978636	SRSF7	7896	38976136	38981136
NM_032102	chr11	+	94800040	94804387	SRSF8	4347	94797540	94802540
NM_003769	chr12	-	120899470	120907558	SRSF9	8088	120905058	120910058
NM_080725	chr20	-	627267	634014	SRXN1	6747	631514	636514
NM_001308201	chr18	-	23596216	23671181	SS18	74965	23668681	23673681
NM_198935	chr20	+	60718775	60757566	SS18L1	38791	60716275	60721275
NM_016305	chr3	+	42623331	42636490	SS18L2	13159	42620831	42625831
NM_003142	chr2	+	170655321	170668571	SSB	13250	170652821	170657821
NM_001256513	chr7	+	141438120	141450288	SSBP1	12168	141435620	141440620
NM_001256732	chr5	-	80708625	81047072	SSBP2	338447	81044572	81049572
NM_018070	chr1	-	54691103	54872068	SSBP3	180965	54869568	54874568
NR_103541	chr1	+	54702115	54704736	SSBP3-AS1	2621	54699615	54704615
NM_032627	chr19	+	18530145	18545372	SSBP4	15227	18527645	18532645
NM_080744	chr7	-	76018645	76039012	SSC4D	20367	76036512	76041512
NM_001144950	chr19	+	55999869	56030466	SSC5D	30597	55997369	56002369
NM_001130445	chr2	+	182756442	182795464	SSFA2	39022	182753942	182758942
NM_018984	chr12	-	109176465	109251359	SSH1	74894	109248859	109253859
NM_001282129	chr17	-	27952956	28257246	SSH2	304290	28254746	28259746
NM_017857	chr11	+	67070918	67080078	SSH3	9160	67068418	67073418
NM_145268	chr7	+	129847703	129856684	SSMEM1	8981	129845203	129850203
NM_001135823	chr12	+	26348268	26387708	SSPN	39440	26345768	26350768
NM_198455	chr7	+	149473130	149531053	SSPO	57923	149470630	149475630
NR_120448	chr6	-	7281375	7313547	SSR1	32172	7311047	7316047
NM_003145	chr1	-	155978838	155990758	SSR2	11920	155988258	155993258
NM_001308197	chr3	-	156257341	156272989	SSR3	15648	156270489	156275489
NM_001204527	chrX	+	153059629	153063967	SSR4	4338	153057129	153062129
NM_003146	chr11	-	57093458	57103351	SSRP1	9893	57100851	57105851
NM_001049	chr14	+	38677203	38682268	SSTR1	5065	38674703	38679703
NM_001050	chr17	+	71161159	71168062	SSTR2	6903	71158659	71163659
NM_001051	chr22	-	37600276	37608416	SSTR3	8140	37605916	37610916
NM_001172560	chr16	+	1122755	1131454	SSTR5	8699	1120255	1125255
NR_027242	chr16	-	1114081	1128731	SSTR5-AS1	14650	1126231	1131231
NM_014188	chr1	-	1477052	1510262	SSU72	33210	1507762	1512762
NM_001256749	chr3	-	8661085	8693764	SSUH2	32679	8691264	8696264
NM_001278691	chrX	+	48114751	48126879	SSX1	12128	48112251	48117251
NM_001278697	chrX	+	52780279	52790617	SSX2	10338	52777779	52782779
NM_001164417	chrX	+	52780280	52790617	SSX2B	10337	52777780	52782780
NM_014021	chr1	-	85109389	85156240	SSX2IP	46851	85153740	85158740
NM_021014	chrX	-	48205862	48216188	SSX3	10326	48213688	48218688
NM_005636	chrX	-	48261523	48271344	SSX4	9821	48268844	48273844
NM_001040612	chrX	-	48261523	48271355	SSX4B	9832	48268855	48273855
NM_021015	chrX	-	48045655	48056199	SSX5	10544	48053699	48058699
NR_028366	chrX	+	47967366	47980068	SSX6	12702	47964866	47969866
NM_173358	chrX	-	52673110	52683950	SSX7	10840	52681450	52686450
NR_027250	chrX	+	52651984	52662998	SSX8	11014	52649484	52654484
NR_073393	chrX	-	48160984	48165614	SSX9	4630	48163114	48168114
NM_001278589	chr22	-	41220538	41253012	ST13	32474	41250512	41255512
NM_021978	chr11	+	130029681	130080257	ST14	50576	130027181	130032181
NM_014682	chr8	-	53023391	53322439	ST18	299048	53319939	53324939
NR_037652	chr15	-	80191181	80216096	ST20	24915	80213596	80218596
NM_001199760	chr15	-	80135888	80215448	ST20-MTHFS	79560	80212948	80217948
NM_003033	chr8	-	134467090	134584183	ST3GAL1	117093	134581683	134586683
NM_006927	chr16	-	70413337	70472991	ST3GAL2	59654	70470491	70475491
NR_073017	chr1	+	44173167	44396837	ST3GAL3	223670	44170667	44175667
NM_001348396	chr11	+	126225539	126284536	ST3GAL4	58997	126223039	126228039
NM_003896	chr2	-	86066270	86116157	ST3GAL5	49887	86113657	86118657
NR_110569	chr2	+	86116402	86119375	ST3GAL5-AS1	2973	86113902	86118902
NM_001323352	chr3	+	98451079	98514689	ST3GAL6	63610	98448579	98453579
NR_046683	chr3	-	98433176	98451495	ST3GAL6-AS1	18319	98448995	98453995
NM_005418	chr11	-	8714898	8932498	ST5	217600	8929998	8934998
NM_173217	chr3	+	186648314	186796341	ST6GAL1	148027	186645814	186650814
NM_032528	chr2	-	107418055	107503563	ST6GAL2	85508	107501063	107506063
NM_001289107	chr17	-	74620837	74639920	ST6GALNAC1	19083	74637420	74642420
NM_006456	chr17	-	74561460	74582145	ST6GALNAC2	20685	74579645	74584645
NM_001349109	chr1	+	76540368	77103001	ST6GALNAC3	562633	76537868	76542868
NM_175039	chr9	-	130670164	130679305	ST6GALNAC4	9141	130676805	130681805
NM_030965	chr1	+	77333092	77533223	ST6GALNAC5	200131	77330592	77335592
NM_001287002	chr9	-	130647599	130667627	ST6GALNAC6	20028	130665127	130670127
NM_018412	chr7	+	116593380	116870075	ST7	276695	116590880	116595880
NR_109981	chr7	-	116752345	116785646	ST7-AS2	33301	116783146	116788146
NR_002332	chr7	+	116822734	116849991	ST7-OT3	27257	116820234	116825234
NR_002329	chr7	+	116593952	116599867	ST7-OT4	5915	116591452	116596452
NM_138728	chr1	-	113066140	113162040	ST7L	95900	113159540	113164540
NM_001304450	chr12	-	22346324	22487648	ST8SIA1	141324	22485148	22490148
NM_001330416	chr15	+	92937116	93011958	ST8SIA2	74842	92934616	92939616
NM_015879	chr18	+	55019720	55036161	ST8SIA3	16441	55017220	55022220
NM_005668	chr5	-	100142638	100238989	ST8SIA4	96351	100236489	100241489
NM_013305	chr18	-	44259080	44337132	ST8SIA5	78052	44334632	44339632
NM_001345961	chr10	-	17357412	17496386	ST8SIA6	138974	17493886	17498886
NR_034129	chr10	+	17428934	17450285	ST8SIA6-AS1	21351	17426434	17431434
NM_015136	chr3	+	52529355	52558511	STAB1	29156	52526855	52531855
NM_017564	chr12	+	103981068	104160502	STAB2	179434	103978568	103983568
NM_003149	chr3	+	36421978	36589498	STAC	167520	36419478	36424478
NM_001351360	chr17	-	37366788	37382125	STAC2	15337	37379625	37384625
NM_001286256	chr12	-	57637237	57644976	STAC3	7739	57642476	57647476
NM_005862	chr3	-	136055998	136471245	STAG1	415247	136468745	136473745
NM_001042749	chrX	+	123094409	123236505	STAG2	142096	123091909	123096909
NM_001282716	chr7	+	99775346	99812010	STAG3	36664	99772846	99777846
NR_040583	chr7	+	74988446	74997085	STAG3L1	8639	74985946	74990946
NR_040584	chr7	-	74298091	74306731	STAG3L2	8640	74304231	74309231
NR_040582	chr7	-	72467817	72476466	STAG3L3	8649	72473966	72478966
NR_040585	chr7	+	66767624	66786513	STAG3L4	18889	66765124	66770124
NR_103720	chr7	+	99933701	99938951	STAG3L5P	5250	99931201	99936201
NR_036569	chr7	+	99933687	99965454	STAG3L5P-PVRIG2P-PILRB	31767	99931187	99936187
NM_001324288	chr10	+	17686123	17758821	STAM	72698	17683623	17688623
NR_110370	chr10	-	17683282	17685917	STAM-AS1	2635	17683417	17688417
NM_005843	chr2	-	152973314	153032506	STAM2	59192	153030006	153035006
NM_201647	chr2	+	74056042	74094295	STAMBP	38253	74053542	74058542
NM_020799	chr10	+	90639943	90683259	STAMBPL1	43316	90637443	90642443
NM_012108	chr4	+	68424414	68473059	STAP1	48645	68421914	68426914
NM_017720	chr19	-	4324039	4338847	STAP2	14808	4336347	4341347
NM_000349	chr8	-	38000217	38008600	STAR	8383	38006100	38011100
NM_006645	chr11	-	72465773	72504750	STARD10	38977	72502250	72507250
NM_001243476	chr13	-	33677271	34250972	STARD13	573701	34248472	34253472
NR_046693	chr13	+	33851690	33855471	STARD13-AS	3781	33849190	33854190
NM_006804	chr17	+	37793332	37820454	STARD3	27122	37790832	37795832
NM_032016	chr7	+	38217807	38270272	STARD3NL	52465	38215307	38220307
NM_001308060	chr5	-	110831731	110848295	STARD4	16564	110845795	110850795
NR_040093	chr5	+	110847923	111075423	STARD4-AS1	227500	110845423	110850423
NM_181900	chr15	-	81605006	81616524	STARD5	11518	81614024	81619024
NM_139171	chr18	-	51851061	51880943	STARD6	29882	51878443	51883443
NM_020151	chr2	-	96850602	96874573	STARD7	23971	96872073	96877073
NR_046322	chr2	+	96874153	96908362	STARD7-AS1	34209	96871653	96876653
NM_001142503	chrX	+	67867510	67945684	STARD8	78174	67865010	67870010
NM_020759	chr15	+	42867856	43013196	STARD9	145340	42865356	42870356
NM_007315	chr2	-	191833761	191878976	STAT1	45215	191876476	191881476
NM_005419	chr12	-	56735381	56754037	STAT2	18656	56751537	56756537
NM_139276	chr17	-	40465342	40540513	STAT3	75171	40538013	40543013
NM_001243835	chr2	-	191894301	192016322	STAT4	122021	192013822	192018822
NM_003152	chr17	+	40439564	40463960	STAT5A	24396	40437064	40442064
NM_012448	chr17	-	40351194	40428424	STAT5B	77230	40425924	40430924
NM_001178080	chr12	-	57489186	57505196	STAT6	16010	57502696	57507696
NM_001009181	chr4	+	70861647	70868173	STATH	6526	70859147	70864147
NM_001319135	chr20	-	47729875	47835832	STAU1	105957	47833332	47838332
NM_001164382	chr8	-	74332603	74659162	STAU2	326559	74656662	74661662
NR_038406	chr8	+	74332308	74353753	STAU2-AS1	21445	74329808	74334808
NM_003943	chr4	+	77227178	77232283	STBD1	5105	77224678	77229678
NM_003155	chr8	-	23699433	23712320	STC1	12887	23709820	23714820
NM_003714	chr5	-	172741725	172756506	STC2	14781	172754006	172759006
NM_012449	chr7	+	89783688	89794141	STEAP1	10453	89781188	89786188
NM_207342	chr7	-	22459062	22539901	STEAP1B	80839	22537401	22542401
NM_001244944	chr7	+	89840999	89866992	STEAP2	25993	89838499	89843499
NR_110029	chr7	-	89511666	89840949	STEAP2-AS1	329283	89838449	89843449
NM_018234	chr2	+	119981383	120023227	STEAP3	41844	119978883	119983883
NR_046721	chr2	-	120001997	120006647	STEAP3-AS1	4650	120004147	120009147
NM_001205316	chr7	-	87905743	87936228	STEAP4	30485	87933728	87938728
NM_003035	chr1	-	47715810	47779819	STIL	64009	47777319	47782319
NM_001277962	chr11	+	3876932	4114440	STIM1	237508	3874432	3879432
NM_020860	chr4	+	26862312	27027003	STIM2	164691	26859812	26864812
NM_001282652	chr11	+	63952743	63972020	STIP1	19277	63950243	63955243
NM_005990	chr5	-	171469073	171615346	STK10	146273	171612846	171617846
NM_000455	chr19	+	1205797	1228434	STK11	22637	1203297	1208297
NM_052902	chr2	+	220462572	220481173	STK11IP	18601	220460072	220465072
NM_001330215	chr2	+	220110176	220115059	STK16	4883	220107676	220112676
NM_004760	chr7	+	43622691	43666978	STK17A	44287	43620191	43625191
NM_004226	chr2	-	196998306	197036336	STK17B	38030	197033836	197038836
NR_026717	chr6_mcf_hap5	+	3318795	3329068	STK19	10273	3316295	3321295
NM_001286649	chr13	-	99102452	99229405	STK24	126953	99226905	99231905
NM_001282305	chr2	-	242434121	242448987	STK25	14866	242446487	242451487
NM_016542	chrX	+	131157244	131209971	STK26	52727	131154744	131159744
NM_001256312	chr8	-	99466858	99954799	STK3	487941	99952299	99957299
NR_048542	chr7	+	23749785	23872130	STK31	122345	23747285	23752285
NM_001287740	chr5	+	146614578	146767418	STK32A	152840	146612078	146617078
NR_147190	chr5	-	146556597	146614422	STK32A-AS1	57825	146611922	146616922
NM_001306082	chr4	+	5053243	5502728	STK32B	449485	5050743	5055743
NM_001318878	chr10	-	134020985	134145379	STK32C	124394	134142879	134147879
NM_001289058	chr11	-	8413412	8615836	STK33	202424	8613336	8618336
NM_080836	chr20	+	2082527	2129198	STK35	46671	2080027	2085027
NM_015690	chr2	+	219536748	219567440	STK36	30692	219534248	219539248
NM_001305102	chr6	-	36461659	36515293	STK38	53634	36512793	36517793
NM_015000	chr12	+	27397077	27478890	STK38L	81813	27394577	27399577
NM_013233	chr2	-	168810529	169104105	STK39	293576	169101605	169106605
NM_001352385	chr20	+	43595110	43708618	STK4	113508	43592610	43597610
NR_038341	chr20	-	43592439	43595099	STK4-AS1	2660	43592599	43597599
NM_001282546	chr1	-	36805219	36851528	STK40	46309	36849028	36854028
NR_103997	chr9	+	136243283	136271220	STKLD1	27937	136240783	136245783
NM_001145454	chr1	-	26210676	26232993	STMN1	22317	26230493	26235493
NM_007029	chr8	+	80523048	80578410	STMN2	55362	80520548	80525548
NR_075070	chr20	-	62271057	62284963	STMN3	13906	62282463	62287463
NM_001283054	chr8	-	27092839	27115956	STMN4	23117	27113456	27118456
NM_001190766	chr6	+	17102488	17131603	STMND1	29115	17099988	17104988
NM_024928	chr10	-	105637317	105678045	STN1	40728	105675545	105680545
NM_001270526	chr9	-	124101265	124132582	STOM	31317	124130082	124135082
NM_001324226	chr15	-	74275558	74286963	STOML1	11405	74284463	74289463
NM_001287031	chr9	-	35099772	35103192	STOML2	3420	35100692	35105692
NM_001144033	chr13	-	39540061	39564996	STOML3	24935	39562496	39567496
NM_006873	chr2	+	48757307	48825654	STON1	68347	48754807	48759807
NM_001198593	chr2	+	48757063	49003656	STON1-GTF2A1L	246593	48754563	48759563
NM_001256430	chr14	-	81726993	81893748	STON2	166755	81891248	81896248
NM_001130161	chr10	+	70587293	70655209	STOX1	67916	70584793	70589793
NR_132761	chr4	+	184719174	184944683	STOX2	225509	184716674	184721674
NM_001199012	chr1	-	24683488	24741587	STPG1	58099	24739087	24744087
NM_174952	chr4	-	98480024	99064391	STPG2	584367	99061891	99066891
NR_102713	chr4	+	98288076	98411315	STPG2-AS1	123239	98285576	98290576
NR_038389	chr9	-	140144670	140147949	STPG3-AS1	3279	140145449	140150449
NM_001163561	chr2	-	47314129	47382517	STPG4	68388	47380017	47385017
NM_001199040	chr15	-	74471807	74502046	STRA6	30239	74499546	74504546
NM_182489	chr7	+	134916730	134943244	STRA8	26514	134914230	134919230
NM_001165970	chr17	-	61780191	61819330	STRADA	39139	61816830	61821830
NM_018571	chr2	+	202316391	202345574	STRADB	29183	202313891	202318891
NM_007178	chr12	+	16035287	16056410	STRAP	21123	16032787	16037787
NM_001171137	chr9	-	125883907	126030855	STRBP	146948	126028355	126033355
NM_153700	chr15	-	43891760	43910998	STRC	19238	43908498	43913498
NR_146078	chr15	-	43991615	44010458	STRCP1	18843	44007958	44012958
NM_001270768	chr1	+	110574198	110597263	STRIP1	23065	110571698	110576698
NM_020704	chr7	+	129074273	129128239	STRIP2	53966	129071773	129076773
NM_003162	chr2	-	37064840	37193615	STRN	128775	37191115	37196115
NM_014574	chr14	-	31363004	31495607	STRN3	132603	31493107	31498107
NM_013403	chr19	-	47222767	47249720	STRN4	26953	47247220	47252220
NM_001320750	chrX	+	7065292	7272684	STS	207392	7062792	7067792
NM_152713	chr11	+	125462689	125492654	STT3A	29965	125460189	125465189
NR_132372	chr11	-	125440185	125462463	STT3A-AS1	22278	125459963	125464963
NM_178862	chr3	+	31573992	31679114	STT3B	105122	31571492	31576492
NM_005861	chr16	+	730110	732768	STUB1	2658	727610	732610
NM_001003665	chr1	+	226736500	226796915	STUM	60415	226734e3	226739e3
NM_001271611	chr19	-	13254871	13261188	STX10	6317	13258688	13263688
NM_003764	chr6	+	144471653	144513076	STX11	41423	144469153	144474153
NM_177424	chr1	+	28099693	28150963	STX12	51270	28097193	28102193
NM_001204868	chr20	+	57226308	57254582	STX16	28274	57223808	57228808
NR_037945	chr20	+	57226308	57290900	STX16-NPEPL1	64592	57223808	57228808
NM_017919	chr9	+	102668914	102736818	STX17	67904	102666414	102671414
NR_038853	chr9	-	102648599	102668883	STX17-AS1	20284	102666383	102671383
NM_001346282	chr4	-	4420695	4544073	STX18	123378	4541573	4546573
NR_037888	chr4	+	4543857	4712664	STX18-AS1	168807	4541357	4546357
NR_126434	chr4	-	4477847	4483427	STX18-IT1	5580	4480927	4485927
NM_001001850	chr3	-	93733214	93747454	STX19	14240	93744954	93749954
NM_004603	chr7	-	73113534	73134017	STX1A	20483	73131517	73136517
NM_052874	chr16	-	31000576	31021959	STX1B	21383	31019459	31024459
NM_001351049	chr12	-	131274144	131323819	STX2	49675	131321319	131326319
NM_004177	chr11	+	59522531	59573355	STX3	50824	59520031	59525031
NM_001272096	chr16	+	31044415	31051488	STX4	7073	31041915	31046915
NM_001244666	chr11	-	62574331	62599563	STX5	25232	62597063	62602063
NM_001286210	chr1	-	180941849	180992257	STX6	50408	180989757	180994757
NM_001326579	chr6	-	132778662	132834611	STX7	55949	132832111	132837111
NM_004853	chr17	-	9153787	9479275	STX8	325488	9476775	9481775
NM_001032221	chr9	+	130374485	130454995	STXBP1	80510	130371985	130376985
NR_073560	chr19	+	7701986	7712760	STXBP2	10774	7699486	7704486
NM_007269	chr1	+	109289256	109352148	STXBP3	62892	109286756	109291756
NM_178509	chr17	+	53046125	53241449	STXBP4	195324	53043625	53048625
NM_139244	chr6	+	147525493	147711612	STXBP5	186119	147522993	147527993
NR_034115	chr6	-	147162524	147525750	STXBP5-AS1	363226	147523250	147528250
NM_014980	chr3	+	120627049	121143608	STXBP5L	516559	120624549	120629549
NM_001304476	chr14	-	25278860	25519503	STXBP6	240643	25517003	25522003
NM_018423	chr12	-	10771537	10826891	STYK1	55354	10824391	10829391
NM_145251	chr14	+	53196882	53241705	STYX	44823	53194382	53199382
NM_001317785	chr7	-	75625654	75677321	STYXL1	51667	75674821	75679821
NM_006713	chr5	+	32585604	32604185	SUB1	18581	32583104	32588104
NM_003850	chr13	-	48516790	48575462	SUCLA2	58672	48572962	48577962
NM_003849	chr2	-	84650646	84686586	SUCLG1	35940	84684086	84689086
NM_001177599	chr3	-	67410883	67705038	SUCLG2	294155	67702538	67707538
NR_109992	chr3	+	67705120	67998136	SUCLG2-AS1	293016	67702620	67707620
NM_033050	chr3	+	151591430	151602407	SUCNR1	10977	151588930	151593930
NM_016227	chr1	+	172501488	172580975	SUCO	79487	172498988	172503988
NM_022491	chr12	+	118814357	118855840	SUDS3	41483	118811857	118816857
NM_016169	chr10	+	104263718	104393214	SUFU	129496	104261218	104266218
NM_001193312	chr7	+	40174574	40900366	SUGCT	725792	40172074	40177074
NM_172231	chr19	-	19387321	19431321	SUGP1	44000	19428821	19433821
NM_001321697	chr19	-	19101695	19144861	SUGP2	43166	19142361	19147361
NM_001130912	chr13	+	53226825	53262489	SUGT1	35664	53224325	53229325
NR_003667	chr9	-	33504534	33511164	SUGT1P1	6630	33508664	33513664
NR_003365	chr13	-	41486024	41495910	SUGT1P3	9886	41493410	41498410
NM_015170	chr8	+	70378858	70573147	SULF1	194289	70376358	70381358
NM_198596	chr20	-	46286149	46415360	SULF2	129211	46412860	46417860
NM_177536	chr16	-	28616907	28634907	SULT1A1	18000	28632407	28637407
NM_001054	chr16	-	28603263	28608391	SULT1A2	5128	28605891	28610891
NM_177552	chr16	+	30210548	30215650	SULT1A3	5102	30208048	30213048
NM_001017390	chr16	+	30210548	30215650	SULT1A4	5102	30208048	30213048
NM_014465	chr4	-	70592685	70626430	SULT1B1	33745	70623930	70628930
NM_001056	chr2	+	108905094	108926371	SULT1C2	21277	108902594	108907594
NR_037191	chr2	+	108938693	108970254	SULT1C2P1	31561	108936193	108941193
NM_001008743	chr2	+	108856447	108881807	SULT1C3	25360	108853947	108858947
NM_006588	chr2	+	108994366	109005426	SULT1C4	11060	108991866	108996866
NM_005420	chr4	-	70706929	70725870	SULT1E1	18941	70723370	70728370
NM_003167	chr19	-	48373722	48389654	SULT2A1	15932	48387154	48392154
NM_177973	chr19	+	49055428	49102684	SULT2B1	47256	49052928	49057928
NM_014351	chr22	-	44220386	44258378	SULT4A1	37992	44255878	44260878
NM_001032377	chr2	-	37394962	37415690	SULT6B1	20728	37413190	37418190
NM_001164675	chr3	-	4402828	4508966	SUMF1	106138	4506466	4511466
NM_001042469	chr7	+	56131916	56148365	SUMF2	16449	56129416	56134416
NM_003352	chr2	-	203070902	203103322	SUMO1	32420	203100822	203105822
NM_006937	chr17	-	73163824	73179098	SUMO2	15274	73176598	73181598
NM_001286416	chr21	-	46225531	46238044	SUMO3	12513	46235544	46240544
NM_001171944	chr7	+	856251	914557	SUN1	58306	853751	858751
NM_001199579	chr22	-	39130718	39152024	SUN2	21306	39149524	39154524
NM_001030019	chr7	-	48026745	48068716	SUN3	41971	48066216	48071216
NM_080675	chr20	-	31571580	31592239	SUN5	20659	31589739	31594739
NM_000456	chr12	+	56391042	56399309	SUOX	8267	56388542	56393542
NM_007192	chr14	-	21819630	21852425	SUPT16H	32795	21849925	21854925
NM_001278480	chr13	-	37583450	37633850	SUPT20H	50400	37631350	37636350
NM_001136234	chrX	+	24380877	24383541	SUPT20HL1	2664	24378377	24383377
NR_146632	chr6	-	44776793	45345601	SUPT3H	568808	45343101	45348101
NR_073470	chr17	-	56422535	56429599	SUPT4H1	7064	56427099	56432099
NM_001111020	chr19	+	39936185	39967308	SUPT5H	31123	39933685	39938685
NM_001320755	chr17	+	26989215	27029702	SUPT6H	40487	26986715	26991715
NM_001282732	chr2	-	27873675	27886707	SUPT7L	13032	27884207	27889207
NM_001323588	chr10	+	70939959	70968854	SUPV3L1	28895	70937459	70942459
NM_001280787	chr9	-	136218659	136223361	SURF1	4702	136220861	136225861
NM_017503	chr9	+	136223420	136228041	SURF2	4621	136220920	136225920
NM_001280788	chr9	-	136228324	136244820	SURF4	16496	136242320	136247320
NM_001278942	chr9	-	136197542	136203047	SURF6	5505	136200547	136205547
NM_001282640	chr9	-	114803060	114937577	SUSD1	134517	114935077	114940077
NM_019601	chr22	+	24577443	24585074	SUSD2	7631	24574943	24579943
NM_001287008	chr9	+	95820969	95847418	SUSD3	26449	95818469	95823469
NM_017982	chr1	-	223394160	223537544	SUSD4	143384	223535044	223540044
NM_015551	chr3	-	33191536	33260707	SUSD5	69171	33258207	33263207
NM_014734	chr14	+	70078309	70181861	SUSD6	103552	70075809	70080809
NM_001282166	chrX	+	48553944	48567406	SUV39H1	13462	48551444	48556444
NM_001193426	chr10	+	14920781	14946304	SUV39H2	25523	14918281	14923281
NM_001321207	chr17	+	30264028	30328064	SUZ12	64036	30261528	30266528
NR_144394	chr17	+	29036625	29119848	SUZ12P1	83223	29034125	29039125
NM_001328675	chr1	-	149874871	149889434	SV2A	14563	149886934	149891934
NM_001323031	chr15	+	91642817	91845795	SV2B	202978	91640317	91645317
NM_001297716	chr5	+	75379238	75649764	SV2C	270526	75376738	75381738
NM_199342	chr1	-	43272722	43283059	SVBP	10337	43280559	43285559
NM_153366	chr9	-	113127528	113342160	SVEP1	214632	113339660	113344660
NM_001323599	chr10	-	29746276	30025930	SVIL	279654	30023430	30028430
NR_110927	chr10	+	29698462	29776785	SVIL-AS1	78323	29695962	29700962
NR_036438	chr10	+	30981202	31005942	SVILP1	24740	30978702	30983702
NM_001320341	chr11	-	22841808	22851408	SVIP	9600	22848908	22853908
NM_018711	chr12	-	109301904	109459045	SVOP	157141	109456545	109461545
NM_001139456	chr7	-	138279029	138363790	SVOPL	84761	138361290	138366290
NM_001297714	chr11	+	9685623	9774538	SWAP70	88915	9683123	9688123
NM_001318092	chr9	+	131037657	131051268	SWI5	13611	131035157	131040157
NM_001105518	chr1	+	185126191	185260913	SWT1	134722	185123691	185128691
NM_032796	chrX	+	16737706	16780807	SYAP1	43101	16735206	16740206
NM_001099743	chr8	-	110586404	110704020	SYBU	117616	110701520	110706520
NM_130784	chr10	-	135367403	135381779	SYCE1	14376	135379279	135384279
NM_001129979	chr16	+	77233293	77246901	SYCE1L	13608	77230793	77235793
NM_001105578	chr19	-	13009893	13030086	SYCE2	20193	13027586	13032586
NM_001123225	chr22	-	50989540	51001381	SYCE3	11841	50998881	51003881
NM_001282541	chr1	+	115397423	115537990	SYCP1	140567	115394923	115399923
NM_014258	chr20	-	58438611	58508718	SYCP2	70107	58506218	58511218
NM_001040274	chr6	+	10887063	10974541	SYCP2L	87478	10884563	10889563
NM_001177949	chr12	-	102122425	102133250	SYCP3	10825	102130750	102135750
NM_033025	chr19	+	15218174	15225799	SYDE1	7625	15215674	15220674
NM_032184	chr1	-	85623355	85666728	SYDE2	43373	85664228	85669228
NM_015484	chr1	-	25548766	25559013	SYF2	10247	25556513	25561513
NM_003177	chr9	+	93563961	93660842	SYK	96881	93561461	93566461
NM_004819	chr19	-	46318699	46366548	SYMPK	47849	46364048	46369048
NM_133499	chrX	-	47431299	47479256	SYN1	47957	47476756	47481756
NM_133625	chr3	+	12045833	12233532	SYN2	187699	12043333	12048333
NM_001135774	chr22	-	32908539	33454377	SYN3	545838	33451877	33456877
NM_001161708	chr1	-	33145506	33168361	SYNC	22855	33165861	33170861
NM_001159677	chr6	-	86317501	86353043	SYNCRIP	35542	86350543	86355543
NM_001323606	chr20	+	24449834	24647253	SYNDIG1	197419	24447334	24452334
NM_001105579	chr14	-	74872595	74892805	SYNDIG1L	20210	74890305	74895305
NM_182961	chr6	-	152442818	152958534	SYNE1	515716	152956034	152961034
NM_182914	chr14	+	64319682	64693167	SYNE2	373485	64317182	64322182
NM_152592	chr14	-	95873603	95942173	SYNE3	68570	95939673	95944673
NM_001297735	chr19	-	36494200	36499695	SYNE4	5495	36497195	36502195
NM_006772	chr6	+	33387846	33421466	SYNGAP1	33620	33385346	33390346
NM_004711	chr22	+	39745953	39781593	SYNGR1	35640	39743453	39748453
NM_004710	chr17	+	76164625	76169009	SYNGR2	4384	76162125	76167125
NM_004209	chr16	+	2039945	2044276	SYNGR3	4331	2037445	2042445
NM_012451	chr19	+	48867650	48879634	SYNGR4	11984	48865150	48870150
NM_203446	chr21	-	34001068	34100351	SYNJ1	99283	34097851	34102851
NM_003898	chr6	+	158402887	158520207	SYNJ2	117320	158400387	158405387
NM_018373	chr14	-	70833212	70883807	SYNJ2BP	50595	70881307	70886307
NM_001202547	chr14	-	70791797	70883807	SYNJ2BP-COX16	92010	70881307	70886307
NM_145728	chr15	+	99645285	99675800	SYNM	30515	99642785	99647785
NM_001166208	chr5	+	149980641	150031903	SYNPO	51262	149978141	149983141
NM_001286754	chr4	+	119771842	119982402	SYNPO2	210560	119769342	119774342
NM_001114133	chr10	-	75404638	75415863	SYNPO2L	11225	75413363	75418363
NM_001130003	chr3	+	63263913	63602597	SYNPR	338684	63261413	63266413
NR_046677	chr3	-	63409271	63535727	SYNPR-AS1	126456	63533227	63538227
NM_001163547	chr17	-	35874899	35969486	SYNRG	94587	35966986	35971986
NM_003179	chrX	-	49044264	49056661	SYP	12397	49054161	49059161
NR_046649	chrX	+	49055297	49058913	SYP-AS1	3616	49052797	49057797
NM_006754	chr7	-	105730813	105753093	SYPL1	22280	105750593	105755593
NM_001040709	chr1	+	110009099	110024764	SYPL2	15665	110006599	110011599
NM_001099791	chr20	+	43991739	44005442	SYS1	13703	43989239	43994239
NR_003189	chr20	+	43991808	44039250	SYS1-DBNDD2	47442	43989308	43994308
NM_001135805	chr12	+	79257772	79845788	SYT1	588016	79255272	79260272
NM_198992	chr12	-	33528347	33592754	SYT10	64407	33590254	33595254
NM_152280	chr1	+	155829259	155854990	SYT11	25731	155826759	155831759
NM_001177880	chr11	+	66790189	66818334	SYT12	28145	66787689	66792689
NM_020826	chr11	-	45261852	45307884	SYT13	46032	45305384	45310384
NM_153262	chr1	+	210111518	210337633	SYT14	226115	210109018	210114018
NR_027094	chr4	-	68926327	68929015	SYT14P1	2688	68926515	68931515
NM_181519	chr10	-	46955443	46970601	SYT15	15158	46968101	46973101
NM_031914	chr14	+	62462540	62568427	SYT16	105887	62460040	62465040
NM_001330509	chr16	+	19179155	19279656	SYT17	100501	19176655	19181655
NM_177402	chr1	-	202559724	202679551	SYT2	119827	202677051	202682051
NM_001160328	chr19	-	51125233	51143092	SYT3	17859	51140592	51145592
NM_020783	chr18	-	40847856	40857615	SYT4	9759	40855115	40860115
NM_003180	chr19	-	55684468	55691720	SYT5	7252	55689220	55694220
NM_001270805	chr1	-	114631913	114696472	SYT6	64559	114693972	114698972
NM_001300773	chr11	-	61281187	61348344	SYT7	67157	61345844	61350844
NM_001290332	chr11	+	1855539	1858751	SYT8	3212	1853039	1858039
NM_175733	chr11	+	7273180	7490276	SYT9	217096	7270680	7275680
NM_032872	chr1	+	27668482	27680423	SYTL1	11941	27665982	27670982
NM_032943	chr11	-	85405264	85522202	SYTL2	116938	85519702	85524702
NM_001242384	chr6	+	159071045	159185908	SYTL3	114863	159068545	159073545
NM_001129896	chrX	-	99929488	99987135	SYTL4	57647	99984635	99989635
NM_138780	chrX	+	37865834	37988073	SYTL5	122239	37863334	37868334
NM_172230	chr11	-	64894750	64902003	SYVN1	7253	64899503	64904503
NR_073500	chr1	+	16693524	16724643	SZRD1	31119	16691024	16696024
NM_015284	chr1	+	43855555	43919918	SZT2	64363	43853055	43858055
NM_001270484	chr6	-	166571145	166582157	T	11012	166579657	166584657
NM_001033080	chr6	-	132938288	132945414	TAAR2	7126	132942914	132947914
NM_153497	chr22	+	39795758	39833132	TAB1	37374	39793258	39798258
NM_001292035	chr6	+	149539059	149732749	TAB2	193690	149536559	149541559
NM_152787	chrX	-	30845558	30907511	TAB3	61953	30905011	30910011
NR_145449	chrX	+	30852739	30857190	TAB3-AS1	4451	30850239	30855239
NM_013997	chr7	+	97361270	97369784	TAC1	8514	97358770	97363770
NR_135164	chr12	-	57403780	57410344	TAC3	6564	57407844	57412844
NM_170685	chr17	-	47915670	47925379	TAC4	9709	47922879	47927879
NM_001330521	chr8	+	38585703	38710548	TACC1	124845	38583203	38588203
NM_001291877	chr10	+	123748688	124014060	TACC2	265372	123746188	123751188
NM_006342	chr4	+	1723216	1746905	TACC3	23689	1720716	1725716
NM_016360	chr17	+	61678230	61685725	TACO1	7495	61675730	61680730
NM_001058	chr2	-	75273589	75426645	TACR1	153056	75424145	75429145
NM_001057	chr10	-	71163957	71176674	TACR2	12717	71174174	71179174
NM_001059	chr4	-	104510624	104640973	TACR3	130349	104638473	104643473
NM_053053	chr1	-	166825748	166845654	TADA1	19906	166843154	166848154
NM_001166105	chr17	+	35766976	35837226	TADA2A	70250	35764476	35769476
NM_152293	chr4	+	7045155	7059677	TADA2B	14522	7042655	7047655
NM_006354	chr3	-	9821647	9834695	TADA3	13048	9832195	9837195
NR_104395	chrX	+	70586088	70750211	TAF1	164123	70583588	70588588
NM_001270488	chr6	-	34845554	34855848	TAF11	10294	34853348	34858348
NM_005644	chr1	-	28929608	28969604	TAF12	39996	28967104	28972104
NM_005645	chr1	-	109606997	109618624	TAF13	11627	109616124	109621124
NM_139215	chr17	+	34136458	34174246	TAF15	37788	34133958	34138958
NM_001201536	chr1	-	222731243	222763275	TAF1A	32032	222760775	222765775
NR_110613	chr1	+	222763261	222765975	TAF1A-AS1	2714	222760761	222765761
NM_001318976	chr2	+	9983570	10074546	TAF1B	90976	9981070	9986070
NM_001243159	chr16	-	84211452	84220676	TAF1C	9224	84218176	84223176
NR_146091	chr11	-	93463359	93474703	TAF1D	11344	93472203	93477203
NM_153809	chr9	-	32629451	32635667	TAF1L	6216	32633167	32638167
NM_003184	chr8	-	120743013	120845074	TAF2	102061	120842574	120847574
NM_031923	chr10	+	7860466	8057016	TAF3	196550	7857966	7862966
NM_003185	chr20	-	60549853	60640866	TAF4	91013	60638366	60643366
NR_121653	chr18	+	23806846	23971649	TAF4B	164803	23804346	23809346
NM_139052	chr10	+	105127709	105148822	TAF5	21113	105125209	105130209
NM_014409	chr1	-	229728865	229761794	TAF5L	32929	229759294	229764294
NM_001190415	chr7	-	99704692	99717481	TAF6	12789	99714981	99719981
NM_006473	chr11	+	62538774	62554813	TAF6L	16039	62536274	62541274
NM_024885	chrX	-	100523240	100548059	TAF7L	24819	100545559	100550559
NM_138572	chr6	+	42018250	42048644	TAF8	30394	42015750	42020750
NM_001015892	chr5	-	68660569	68665840	TAF9	5271	68663340	68668340
NM_015975	chrX	-	77385244	77395179	TAF9B	9935	77392679	77397679
NM_054114	chr6	-	159455500	159466184	TAGAP	10684	159463684	159468684
NM_003186	chr11	+	117070039	117075508	TAGLN	5469	117067539	117072539
NM_003564	chr1	-	159887896	159895332	TAGLN2	7436	159892832	159897832
NM_013259	chr3	+	111717585	111732735	TAGLN3	15150	111715085	111720085
NM_001290406	chr1	-	47681961	47698007	TAL1	16046	47695507	47700507
NR_145459	chr11	-	65266782	65274903	TALAM1	8121	65272403	65277403
NM_006755	chr11	+	747431	765024	TALDO1	17593	744931	749931
NR_104314	chr3	-	11831915	11888393	TAMM41	56478	11885893	11890893
NM_001145909	chr2	+	159825145	160089170	TANC1	264025	159822645	159827645
NM_025185	chr17	+	61086897	61505067	TANC2	418170	61084397	61089397
NM_001322163	chr22	+	20004522	20054687	TANGO2	50165	20002022	20007022
NM_024562	chr16	+	68877508	69119085	TANGO6	241577	68875008	68880008
NM_004180	chr2	+	161993465	162092682	TANK	99217	161990965	161995965
NM_020791	chr17	+	27717942	27878921	TAOK1	160979	27715442	27720442
NM_004783	chr16	+	29985187	30003582	TAOK2	18395	29982687	29987687
NM_016281	chr12	-	118587605	118810750	TAOK3	223145	118808250	118813250
NM_000593	chr6	-	32812985	32821748	TAP1	8763	32819248	32824248
NM_018833	chr6_qbl_hap6	-	4021716	4038655	TAP2	16939	4036155	4041155
NM_003190	chr6_qbl_hap6	-	4499711	4514410	TAPBP	14699	4511910	4516910
NR_147126	chr12	+	6560839	6571488	TAPBPL	10649	6558339	6563339
NM_153365	chr4	-	16162127	16228161	TAPT1	66034	16225661	16230661
NR_027697	chr4	+	16228285	16259810	TAPT1-AS1	31525	16225785	16230785
NM_005646	chr1	-	234527058	234614849	TARBP1	87791	234612349	234617349
NM_004178	chr12	+	53894704	53900215	TARBP2	5511	53892204	53897204
NM_007375	chr1	+	11072678	11085549	TARDBP	12871	11070178	11075178
NR_109982	chr6	-	133823389	134210144	TARID	386755	134207644	134212644
NM_001135686	chr19	-	54573200	54584634	TARM1	11434	54582134	54587134
NM_001003799	chr7	-	38299243	38313248	TARP	14005	38310748	38315748
NM_001258437	chr5	+	33440801	33468196	TARS	27395	33438301	33443301
NM_025150	chr1	+	150459839	150480085	TARS2	20246	150457339	150462339
NM_152334	chr15	-	102193954	102264645	TARSL2	70691	102262145	102267145
NM_138697	chr1	+	6615337	6639817	TAS1R1	24480	6612837	6617837
NM_152232	chr1	-	19166092	19186155	TAS1R2	20063	19183655	19188655
NM_152228	chr1	+	1266725	1270700	TAS1R3	3975	1264225	1269225
NR_136629	chr20	-	13370035	13619583	TASP1	249548	13617083	13622083
NM_000353	chr16	-	71600753	71610998	TAT	10245	71608498	71613498
NR_103852	chr16	+	71598918	71606341	TAT-AS1	7423	71596418	71601418
NM_032026	chr8	-	125500734	125551329	TATDN1	50595	125548829	125553829
NM_014760	chr3	+	10290176	10322906	TATDN2	32730	10287676	10292676
NM_001042552	chr1	+	212965169	212990167	TATDN3	24998	212962669	212967669
NM_001206901	chr7	+	27778991	27869386	TAX1BP1	90395	27776491	27781491
NM_001204698	chr17	-	3566186	3571973	TAX1BP3	5787	3569473	3574473
NM_001303465	chrX	+	153639853	153650063	TAZ	10210	153637353	153642353
NR_134531	chr10	-	72530993	72545175	TBATA	14182	72542675	72547675
NM_001253912	chr4	+	37892704	38140796	TBC1D1	248092	37890204	37895204
NM_001204240	chr22	-	30687978	30722955	TBC1D10A	34977	30720455	30725455
NM_015527	chr16	-	30368421	30381522	TBC1D10B	13101	30379022	30384022
NM_001256508	chr11	+	67171383	67177561	TBC1D10C	6178	67168883	67173883
NM_015188	chr10	+	96162185	96296089	TBC1D12	133904	96159685	96164685
NM_018201	chr9	+	131549485	131572711	TBC1D13	23226	131546985	131551985
NM_001113361	chr4	+	6911170	7034845	TBC1D14	123675	6908670	6913670
NR_027449	chr12	+	72233486	72320629	TBC1D15	87143	72230986	72235986
NM_019020	chr17	-	77906141	78009657	TBC1D16	103516	78007157	78012157
NM_024682	chr19	+	50380681	50392007	TBC1D17	11326	50378181	50383181
NM_018317	chr4	+	26585545	26757835	TBC1D19	172290	26583045	26588045
NR_051978	chr9	-	100961279	101018003	TBC1D2	56724	101015503	101020503
NR_111901	chr20	-	416120	443197	TBC1D20	27077	440697	445697
NM_153356	chr15	+	74165926	74181556	TBC1D21	15630	74163426	74168426
NM_001284303	chr22	+	47158513	47571342	TBC1D22A	412829	47156013	47161013
NR_130108	chr6	+	37225479	37300746	TBC1D22B	75267	37222979	37227979
NM_018309	chr3	+	99979660	100044096	TBC1D23	64436	99977160	99982160
NM_001199107	chr16	+	2525146	2555734	TBC1D24	30588	2522646	2527646
NM_001348262	chrX	+	48398006	48420997	TBC1D25	22991	48395506	48400506
NM_178571	chr17	+	15635590	15648098	TBC1D26	12508	15633090	15638090
NR_147084	chr17	-	16826089	16836490	TBC1D27	10401	16833990	16838990
NM_001039397	chr17	-	18538841	18547740	TBC1D28	8899	18545240	18550240
NM_015594	chr17	+	28886583	28890509	TBC1D29	3926	28884083	28889083
NM_015079	chr15	-	78287326	78369994	TBC1D2B	82668	78367494	78372494
NM_001123391	chr17	+	36284004	36295098	TBC1D3	11094	36281504	36286504
NM_001330187	chr12	+	65153276	65274798	TBC1D30	121522	65150776	65155776
NM_001330606	chr8	+	124084858	124164392	TBC1D31	79534	124082358	124087358
NM_152730	chr6	-	121400639	121655646	TBC1D32	255007	121653146	121658146
NM_001001417	chr17	-	34797171	34808092	TBC1D3B	10921	34805592	34810592
NM_001001418	chr17	+	36283976	36294915	TBC1D3C	10939	36281476	36286476
NM_001291465	chr17	+	36284016	36294915	TBC1D3D	10899	36281516	36286516
NM_001291466	chr17	+	36284018	36294915	TBC1D3E	10897	36281518	36286518
NM_032258	chr17	-	34746118	34808060	TBC1D3F	61942	34805560	34810560
NM_001291462	chr17	+	36284016	36294915	TBC1D3G	10899	36281516	36286516
NM_001123392	chr17	+	36284002	36294971	TBC1D3H	10969	36281502	36286502
NM_001291463	chr17	+	36284016	36294915	TBC1D3I	10899	36281516	36286516
NM_001291464	chr17	+	36284016	36294915	TBC1D3K	10899	36281516	36286516
NM_001291459	chr17	+	36284002	36294915	TBC1D3L	10913	36281502	36286502
NR_002924	chr17	-	58039723	58096413	TBC1D3P1-DHX40P1	56690	58093913	58098913
NR_027486	chr17	-	60342066	60353016	TBC1D3P2	10950	60350516	60355516
NR_033892	chr17	+	25745030	25758649	TBC1D3P5	13619	25742530	25747530
NM_014832	chr13	-	75858799	76056304	TBC1D4	197505	76053804	76058804
NM_001349073	chr3	-	17198653	17784231	TBC1D5	585578	17781731	17786731
NM_001143966	chr6	-	13305183	13328815	TBC1D7	23632	13326315	13331315
NM_001318809	chr6	-	13266773	13328815	TBC1D7-LOC100130357	62042	13326315	13331315
NM_001330348	chr2	-	101623689	101767909	TBC1D8	144220	101765409	101770409
NR_135594	chr2	+	101768121	101771874	TBC1D8-AS1	3753	101765621	101770621
NM_017752	chrX	+	106045918	106119377	TBC1D8B	73459	106043418	106048418
NM_015130	chr4	-	141541935	141677471	TBC1D9	135536	141674971	141679971
NM_198868	chr5	-	179289070	179334856	TBC1D9B	45786	179332356	179337356
NM_001297738	chr5	-	76986993	77072185	TBCA	85192	77069685	77074685
NM_001281	chr19	+	36605887	36616849	TBCB	10962	36603387	36608387
NM_001286749	chr3	-	186263855	186288332	TBCCD1	24477	186285832	186290832
NM_005993	chr17	+	80709939	80901062	TBCD	191123	80707439	80712439
NM_003193	chr1	+	235530674	235612283	TBCE	81609	235528174	235533174
NM_001130047	chr11	+	120894802	120960354	TBCEL	65552	120892302	120897302
NM_001163436	chr4	-	106965473	107237861	TBCK	272388	107235361	107240361
NM_013254	chr12	+	64845839	64895899	TBK1	50060	64843339	64848339
NM_014726	chr17	+	45772629	45789429	TBKBP1	16800	45770129	45775129
NM_001139467	chrX	+	9431334	9687780	TBL1X	256446	9428834	9433834
NM_001321194	chr3	-	176737142	176915114	TBL1XR1	177972	176912614	176917614
NM_033284	chrY	+	6778726	6959724	TBL1Y	180998	6776226	6781226
NM_012453	chr7	-	72983276	72993013	TBL2	9737	72990513	72995513
NM_006453	chr16	+	2022063	2028751	TBL3	6688	2019563	2024563
NM_003194	chr6	+	170863420	170881958	TBP	18538	170860920	170865920
NM_001253676	chr6	+	134273307	134308638	TBPL1	35331	134270807	134275807
NM_199047	chr14	-	55880929	55907263	TBPL2	26334	55904763	55909763
NM_006593	chr2	+	162272604	162282378	TBR1	9774	162270104	162275104
NR_016021	chr11	+	124492741	124505822	TBRG1	13081	124490241	124495241
NM_001261834	chr7	-	45139698	45151346	TBRG4	11648	45148846	45153846
NM_005992	chr22	+	19744225	19771112	TBX1	26887	19741725	19746725
NM_005995	chr11	-	67398773	67407031	TBX10	8258	67404531	67409531
NM_152380	chr1	-	119425665	119532179	TBX15	106514	119529679	119534679
NM_001080508	chr6	-	85442215	85473954	TBX18	31739	85471454	85476454
NR_125875	chr6	+	85399175	85419252	TBX18-AS1	20077	85396675	85401675
NM_005149	chr1	+	168250277	168283664	TBX19	33387	168247777	168252777
NM_005994	chr17	+	59477256	59486827	TBX2	9571	59474756	59479756
NR_125749	chr17	-	59470816	59476967	TBX2-AS1	6151	59474467	59479467
NM_001077653	chr7	-	35242041	35293711	TBX20	51670	35291211	35296211
NM_013351	chr17	+	45810609	45823485	TBX21	12876	45808109	45813109
NM_001109878	chrX	+	79270254	79287268	TBX22	17014	79267754	79272754
NM_016569	chr12	-	115108058	115121969	TBX3	13911	115119469	115124469
NM_001321120	chr17	+	59529778	59562471	TBX4	32693	59527278	59532278
NM_000192	chr12	-	114791734	114846247	TBX5	54513	114843747	114848747
NR_038440	chr12	+	114845999	114850637	TBX5-AS1	4638	114843499	114848499
NM_004608	chr16	-	30097114	30103205	TBX6	6091	30100705	30105705
NM_001060	chr19	-	3594503	3606831	TBXA2R	12328	3604331	3609331
NM_001166254	chr7	+	139478046	139720125	TBXAS1	242079	139475546	139480546
NM_001128596	chr14	-	92246095	92333880	TC2N	87785	92331380	92336380
NM_001206938	chr7	-	143548460	143599278	TCAF1	50818	143596778	143601778
NM_001130025	chr7	+	143318044	143422176	TCAF2	104132	143315544	143320544
NR_110549	chr7	+	143507082	143512482	TCAF2P1	5400	143504582	143509582
NM_001282913	chr3	+	44379610	44450940	TCAIM	71330	44377110	44382110
NR_002947	chr17	+	61934375	61941739	TCAM1P	7364	61931875	61936875
NR_109902	chr8	-	54879113	54935016	TCEA1	55903	54932516	54937516
NM_198723	chr20	+	62688324	62703700	TCEA2	15376	62685824	62690824
NM_003196	chr1	-	23707401	23751272	TCEA3	43871	23748772	23753772
NM_001300901	chrX	+	102831158	102842664	TCEAL4	11506	102828658	102833658
NM_001012979	chrX	-	102528617	102531797	TCEAL5	3180	102529297	102534297
NM_001297564	chrX	+	13671224	13683527	TCEANC	12303	13668724	13673724
NR_130900	chr1	+	54519244	54578192	TCEANC2	58948	54516744	54521744
NM_006706	chr5	+	145826872	145891069	TCERG1	64197	145824372	145829372
NM_174937	chr10	-	132890654	133109984	TCERG1L	219330	133107484	133112484
NM_001322157	chr15	+	57210832	57583459	TCF12	372627	57208332	57213332
NM_004609	chr20	-	584636	590910	TCF15	6274	588410	593410
NM_001318908	chr6_qbl_hap6	+	2422151	2427844	TCF19	5693	2419651	2424651
NM_005650	chr22	-	42556018	42679933	TCF20	123915	42677433	42682433
NM_198392	chr6	+	134210258	134216675	TCF21	6417	134207758	134212758
NM_175769	chr2	+	27371944	27375819	TCF23	3875	27369444	27374444
NM_001193502	chr8	-	67858735	67874825	TCF24	16090	67872325	67877325
NM_014972	chr16	+	89939993	89977792	TCF25	37799	89937493	89942493
NM_001351779	chr19	-	1609282	1652328	TCF3	43046	1649828	1654828
NM_001243226	chr18	-	52889561	53303224	TCF4	413663	53300724	53305724
NR_132985	chr18	+	53119763	53150171	TCF4-AS1	30408	53117263	53122263
NM_001346425	chr5	+	133450388	133483920	TCF7	33532	133447888	133452888
NM_031283	chr2	+	85360582	85537511	TCF7L1	176929	85358082	85363082
NM_001198525	chr10	+	114710008	114927436	TCF7L2	217428	114707508	114712508
NM_006602	chr20	-	61472365	61493115	TCFL5	20750	61490615	61495615
NM_007113	chr1	-	152078792	152087930	TCHH	9138	152085430	152090430
NM_001008536	chr1	-	152056619	152061540	TCHHL1	4921	152059040	152064040
NM_001143852	chr12	+	110338078	110355874	TCHP	17796	110335578	110340578
NM_001351059	chr11	+	67806461	67818366	TCIRG1	11905	67803961	67808961
NR_049726	chr14	-	96176303	96180533	TCL1A	4230	96178033	96183033
NM_004918	chr14	+	96152753	96158980	TCL1B	6227	96150253	96155253
NR_028288	chr14	+	96117514	96139789	TCL6	22275	96115014	96120014
NM_001062	chr11	-	59620280	59634041	TCN1	13761	59631541	59636541
NM_001184726	chr22	+	31003069	31023047	TCN2	19978	31000569	31005569
NM_001135243	chr5	+	149737201	149779871	TCOF1	42670	149734701	149739701
NM_030752	chr6	-	160199529	160210735	TCP1	11206	160208235	160213235
NM_004610	chr6	-	167786576	167797998	TCP10	11422	167795498	167800498
NM_144659	chr21	-	33947150	33957855	TCP10L	10705	33955355	33960355
NM_001145121	chr6	+	167584080	167596396	TCP10L2	12316	167581580	167586580
NM_001093728	chr6	-	35085848	35109187	TCP11	23339	35106687	35111687
NM_018393	chr11	+	33060962	33095109	TCP11L1	34147	33058462	33063462
NM_152772	chr12	+	106696568	106740792	TCP11L2	44224	106694068	106699068
NM_001277423	chrX	+	101470279	101481785	TCP11X2	11506	101467779	101472779
NM_022171	chr3	+	49449638	49453909	TCTA	4271	49447138	49452138
NM_182539	chr6	-	44247896	44265458	TCTE1	17562	44262958	44267958
NM_174910	chr6	-	170140210	170151679	TCTE3	11469	170149179	170154179
NM_152665	chr1	+	67218139	67244730	TCTEX1D1	26591	67215639	67220639
NM_001351628	chr3	-	196018089	196045165	TCTEX1D2	27076	196042665	196047665
NM_001319681	chr12	+	111051831	111086935	TCTN1	35104	111049331	111054331
NM_001143850	chr12	+	124155659	124192950	TCTN2	37291	124153159	124158159
NM_015631	chr10	-	97423152	97453900	TCTN3	30748	97451400	97456400
NM_003211	chr12	+	104359592	104382656	TDG	23064	104357092	104362092
NM_001174136	chr3	+	46616044	46623952	TDGF1	7908	46613544	46618544
NR_002718	chrX	+	109763539	109766249	TDGF1P3	2710	109761039	109766039
NR_001578	chr8	+	11197145	11225961	TDH	28816	11194645	11199645
NM_005651	chr4	+	156824844	156841558	TDO2	16714	156822344	156827344
NM_018319	chr14	+	90422245	90511108	TDP1	88863	90419745	90424745
NM_016614	chr6	-	24650204	24667115	TDP2	16911	24664615	24669615
NM_198795	chr10	+	115939028	115992063	TDRD1	53035	115936528	115941528
NM_182499	chr1	+	154474694	154520623	TDRD10	45929	154472194	154477194
NM_001110822	chr19	+	33210678	33281714	TDRD12	71036	33208178	33213178
NM_001306137	chr2	+	21346857	21367238	TDRD15	20381	21344357	21349357
NM_030794	chr13	+	60970590	61148013	TDRD3	177423	60968090	60973090
NM_001199089	chr1	+	179560747	179660407	TDRD5	99660	179558247	179563247
NR_144468	chr6	+	46648004	46672056	TDRD6	24052	46645504	46650504
NM_001302884	chr9	+	100174301	100258405	TDRD7	84104	100171801	100176801
NM_153046	chr14	+	104394816	104519004	TDRD9	124188	104392316	104397316
NM_006862	chr1	-	151744040	151763010	TDRKH	18970	151760510	151765510
NR_146292	chr1	+	151763224	151766878	TDRKH-AS1	3654	151760724	151765724
NM_175075	chr8	-	439789	495781	TDRP	55992	493281	498281
NM_021961	chr11	+	12695968	12966284	TEAD1	270316	12693468	12698468
NM_001256662	chr19	-	49843852	49865714	TEAD2	21862	49863214	49868214
NM_003214	chr6	-	35441373	35464861	TEAD3	23488	35462361	35467361
NM_003213	chr12	+	3068477	3149842	TEAD4	81365	3065977	3070977
NM_003215	chr4	-	48137799	48271814	TEC	134015	48269314	48274314
NM_015395	chr7	-	97844754	97881563	TECPR1	36809	97879063	97884063
NM_014844	chr14	+	102829248	102968818	TECPR2	139570	102826748	102831748
NM_001321170	chr19	+	14640371	14676792	TECR	36421	14637871	14642871
NM_001010874	chr4	-	65144176	65275178	TECRL	131002	65272678	65277678
NM_005422	chr11	+	120973374	121061515	TECTA	88141	120970874	120975874
NM_058222	chr10	+	114043413	114064792	TECTB	21379	114040913	114045913
NM_172000	chr1	-	182367251	182369751	TEDDM1	2500	182367251	182372251
NM_001145398	chr22	+	41763336	41795332	TEF	31996	41760836	41765836
NM_024683	chr17	-	29226000	29233286	TEFM	7286	29230786	29235786
NM_000459	chr9	+	27109138	27230176	TEK	121038	27106638	27111638
NM_053285	chr17	-	6703299	6735060	TEKT1	31761	6732560	6737560
NM_014466	chr1	+	36549675	36553876	TEKT2	4201	36547175	36552175
NM_031898	chr17	-	15207128	15244958	TEKT3	37830	15242458	15247458
NM_144705	chr2	+	95537177	95542574	TEKT4	5397	95534677	95539677
NR_038327	chr21	-	9907188	9968594	TEKT4P2	61406	9966094	9971094
NM_144674	chr16	-	10721360	10788802	TEKT5	67442	10786302	10791302
NM_016111	chr16	+	1543351	1560460	TELO2	17109	1540851	1545851
NR_147188	chr4	-	182741157	182751126	TEMN3-AS1	9969	182748626	182753626
NM_001113324	chr17	+	73975297	73996667	TEN1	21370	73972797	73977797
NR_037709	chr17	+	73975297	74002080	TEN1-CDK3	26783	73972797	73977797
NM_014253	chrX	-	123509755	124097666	TENM1	587911	124095166	124100166
NM_001122679	chr5	+	166711842	167691162	TENM2	979320	166709342	166714342
NM_001080477	chr4	+	183164583	183724177	TENM3	559594	183162083	183167083
NM_001098816	chr11	-	78364327	79151695	TENM4	787368	79149195	79154195
NM_007110	chr14	-	20833825	20881579	TEP1	47754	20879079	20884079
NM_199046	chr16	+	58010338	58022017	TEPP	11679	58007838	58012838
NM_144679	chr17	-	79202076	79212891	TEPSIN	10815	79210391	79215391
NM_001136505	chr16	-	66788878	66835523	TERB1	46645	66833023	66838023
NM_152448	chr15	+	45248899	45271421	TERB2	22522	45246399	45251399
NM_003218	chr8	+	73921096	73959987	TERF1	38891	73918596	73923596
NM_005652	chr16	-	69389463	69419891	TERF2	30428	69417391	69422391
NM_018975	chr16	+	75681634	75691341	TERF2IP	9707	75679134	75684134
NM_001193376	chr5	-	1253286	1295162	TERT	41876	1292662	1297662
NM_015641	chr7	+	115850546	115898837	TES	48291	115848046	115853046
NM_001168325	chr12	-	117476727	117537251	TESC	60524	117534751	117539751
NR_120464	chr12	+	117537271	117579294	TESC-AS1	42023	117534771	117539771
NM_006285	chr9	+	35605280	35610038	TESK1	4758	35602780	35607780
NM_007170	chr1	-	45809554	45956840	TESK2	147286	45954340	45959340
NM_004923	chr11	-	68474907	68518988	TESMIN	44081	68516488	68521488
NM_001136030	chr12	-	55342086	55378530	TESPA1	36444	55376030	55381030
NM_030625	chr10	+	70320116	70454239	TET1	134123	70317616	70322616
NM_001127208	chr4	+	106067841	106200960	TET2	133119	106065341	106070341
NR_126420	chr4	-	106092510	106274038	TET2-AS1	181528	106271538	106276538
NM_001287491	chr2	+	74213530	74335302	TET3	121772	74211030	74216030
NM_017746	chr9	-	103064356	103115259	TEX10	50903	103112759	103117759
NM_031451	chr19	+	43892762	43922767	TEX101	30005	43890262	43895262
NM_031276	chrX	-	69748789	70128567	TEX11	379778	70126067	70131067
NM_031275	chr11	+	112038094	112043279	TEX12	5185	112035594	112040594
NM_001195272	chrX	+	124453968	124456950	TEX13C	2982	124451468	124456468
NM_001201457	chr17	-	56634037	56769416	TEX14	135379	56766916	56771916
NM_001350162	chr8	-	30689059	30770528	TEX15	81469	30768028	30773028
NM_207459	chr17	+	80317122	80321652	TEX19	4530	80314622	80319622
NM_001288732	chr17	-	62224792	62340683	TEX2	115891	62338183	62343183
NM_001195082	chr14	+	105864919	105880196	TEX22	15277	105862419	105867419
NM_152325	chr13	+	31506833	31549153	TEX26	42320	31504333	31509333
NR_038287	chr13	-	31456971	31506745	TEX26-AS1	49774	31504245	31509245
NM_144582	chr2	-	71213067	71222001	TEX261	8934	71219501	71224501
NM_015926	chr3	+	51705190	51738339	TEX264	33149	51702690	51707690
NM_001205201	chrX	-	153498929	153523564	TEX28	24635	153521064	153526064
NM_001303133	chr13	+	111968531	111996594	TEX29	28063	111966031	111971031
NM_138779	chr13	-	103418237	103426171	TEX30	7934	103423671	103428671
NM_178552	chr22	-	37387159	37403877	TEX33	16718	37401377	37406377
NM_001170722	chr1	+	178482211	178492635	TEX35	10424	178479711	178484711
NM_001318133	chr10	-	127265090	127371713	TEX36	106623	127369213	127374213
NR_023362	chr10	+	127262939	127267014	TEX36-AS1	4075	127260439	127265439
NM_152670	chr2	+	88824168	88829103	TEX37	4935	88821668	88826668
NR_033870	chr2	+	145425533	145834291	TEX41	408758	145423033	145428033
NM_207408	chr5	+	125967405	125971974	TEX43	4569	125964905	125969905
NM_198534	chr19	+	7562444	7573336	TEX45	10892	7559944	7564944
NM_001242521	chr1	-	23337326	23342343	TEX46	5017	23339843	23344843
NR_133056	chr9	-	117428713	117444369	TEX48	15656	117441869	117446869
NM_001351125	chr12	+	49121217	49159571	TEX49	38354	49118717	49123717
NM_001322244	chr2	+	127656461	127659673	TEX51	3212	127653961	127658961
NM_198524	chr15	+	56657621	56738195	TEX9	80574	56655121	56660121
NM_001063	chr3	+	133464976	133497850	TF	32874	133462476	133467476
NM_003201	chr10	+	60144902	60158990	TFAM	14088	60142402	60147402
NM_001042425	chr6	-	10396915	10419797	TFAP2A	22882	10417297	10422297
NR_033910	chr6	+	10412550	10416402	TFAP2A-AS1	3852	10410050	10415050
NR_145448	chr6	+	10404734	10408160	TFAP2A-AS2	3426	10402234	10407234
NM_003221	chr6	+	50786438	50815326	TFAP2B	28888	50783938	50788938
NM_003222	chr20	+	55204357	55214338	TFAP2C	9981	55201857	55206857
NM_172238	chr6	+	50681256	50740746	TFAP2D	59490	50678756	50683756
NM_178548	chr1	+	36038970	36060927	TFAP2E	21957	36036470	36041470
NM_003223	chr16	-	4307186	4323001	TFAP4	15815	4320501	4325501
NR_146725	chr6	-	155551004	155635617	TFB1M	84613	155633117	155638117
NM_022366	chr1	-	246703862	246729565	TFB2M	25703	246727065	246732065
NM_001173452	chr12	-	51487538	51566926	TFCP2	79388	51564426	51569426
NM_014553	chr2	-	121974163	122042778	TFCP2L1	68615	122040278	122045278
NR_026580	chr13	+	114239002	114295788	TFDP1	56786	114236502	114241502
NM_001178139	chr3	-	141663269	141868386	TFDP2	205117	141865886	141870886
NM_001282142	chrX	-	48886237	48901043	TFE3	14806	48898543	48903543
NM_001167827	chr6	-	41651715	41703997	TFEB	52282	41701497	41706497
NM_012252	chr7	-	115575201	115670867	TFEC	95666	115668367	115673367
NM_003225	chr21	-	43782390	43786644	TFF1	4254	43784144	43789144
NM_005423	chr21	-	43766466	43771208	TFF2	4742	43768708	43773708
NM_003226	chr21	-	43731776	43735706	TFF3	3930	43733206	43738206
NM_001007565	chr3	+	100428133	100467811	TFG	39678	100425633	100430633
NM_001008697	chr22	-	26887205	26908472	TFIP11	21267	26905972	26910972
NM_001329239	chr2	-	188328956	188419232	TFPI	90276	188416732	188421732
NM_006528	chr7	-	93514708	93520303	TFPI2	5595	93517803	93522803
NM_013342	chr19	-	54610319	54619055	TFPT	8736	54616555	54621555
NM_003227	chr7	-	100218038	100239173	TFR2	21135	100236673	100241673
NM_001313965	chr3	-	195776154	195809032	TFRC	32878	195806532	195811532
NM_003235	chr8	+	133879204	134147143	TG	267939	133876704	133881704
NR_130732	chr13	-	95226307	95248529	TGDS	22222	95246029	95251029
NM_003236	chr2	-	70674411	70781147	TGFA	106736	70778647	70783647
NR_046798	chr2	-	70694516	70708772	TGFA-IT1	14256	70706272	70711272
NM_000660	chr19	-	41836227	41859788	TGFB1	23561	41857288	41862288
NM_001042454	chr16	+	31483475	31489281	TGFB1I1	5806	31480975	31485975
NM_003238	chr1	+	218518625	218617961	TGFB2	99336	218516125	218521125
NM_001329939	chr14	-	76424403	76449354	TGFB3	24951	76446854	76451854
NM_000358	chr5	+	135364583	135399507	TGFBI	34924	135362083	135367083
NM_001306210	chr9	+	101867370	101916473	TGFBR1	49103	101864870	101869870
NM_001024847	chr3	+	30647993	30735633	TGFBR2	87640	30645493	30650493
NM_001195684	chr1	-	92145899	92371559	TGFBR3	225660	92369059	92374059
NM_001195259	chr19	+	7981031	7983980	TGFBR3L	2949	7978531	7983531
NM_001328646	chr2	-	105865879	105946128	TGFBRAP1	80249	105943628	105948628
NM_174886	chr18	+	3411924	3458406	TGIF1	46482	3409424	3414424
NM_001199514	chr20	+	35201875	35222355	TGIF2	20480	35199375	35204375
NM_001199535	chr20	+	35202956	35240960	TGIF2-C20orf24	38004	35200456	35205456
NM_000359	chr14	-	24718319	24732416	TGM1	14097	24729916	24734916
NM_001323316	chr20	-	36755788	36794980	TGM2	39192	36792480	36797480
NM_003245	chr20	+	2276612	2321725	TGM3	45113	2274112	2279112
NM_003241	chr3	+	44916097	44956088	TGM4	39991	44913597	44918597
NM_201631	chr15	-	43524792	43559055	TGM5	34263	43556555	43561555
NM_198994	chr20	+	2361553	2413399	TGM6	51846	2359053	2364053
NM_052955	chr15	-	43568478	43594453	TGM7	25975	43591953	43596953
NM_006464	chr2	-	85545140	85555419	TGOLN2	10279	85552919	85557919
NM_001317902	chr8	+	56685790	56739004	TGS1	53214	56683290	56688290
NM_000360	chr11	-	2185158	2193035	TH	7877	2190535	2195535
NR_132125	chr5	-	131973739	131991846	TH2LCRR	18107	131989346	131994346
NR_073394	chr2	-	43457974	43823185	THADA	365211	43820685	43825685
NM_018105	chr8	-	42691816	42698474	THAP1	6658	42695974	42700974
NM_020147	chr15	-	71173680	71184772	THAP10	11092	71182272	71187272
NR_130898	chr11	-	76061000	76092009	THAP12	31009	76089509	76094509
NM_031435	chr12	+	72057676	72074428	THAP2	16752	72055176	72060176
NM_138350	chr1	+	6685209	6695646	THAP3	10437	6682709	6687709
NM_015963	chr2	-	242523819	242576725	THAP4	52906	242574225	242579225
NM_001287599	chr7	-	108202587	108210212	THAP5	7625	108207712	108212712
NR_133920	chr4	+	76439642	76472542	THAP6	32900	76437142	76442142
NR_027051	chr22	+	21356210	21364663	THAP7-AS1	8453	21353710	21358710
NM_001331103	chr19	-	36525886	36545664	THAP8	19778	36543164	36548164
NM_001317776	chr4	+	83821802	83841122	THAP9	19320	83819302	83824302
NR_034075	chr4	-	83814604	83822069	THAP9-AS1	7465	83819569	83824569
NM_000361	chr20	-	23026269	23030301	THBD	4032	23027801	23032801
NM_003246	chr15	+	39873279	39891121	THBS1	17842	39870779	39875779
NM_003247	chr6	-	169615874	169654209	THBS2	38335	169651709	169656709
NR_045553	chr1	-	155165378	155177772	THBS3	12394	155175272	155180272
NM_001306213	chr5	+	79287118	79379107	THBS4	91989	79284618	79289618
NR_126055	chr12	-	3592877	3601985	THCAT155	9108	3599485	3604485
NR_110880	chr17	-	45380811	45401267	THCAT158	20456	45398767	45403767
NM_016585	chr19	-	362056	376013	THEG	13957	373513	378513
NM_001278578	chr19	+	32079094	32084687	THEG5	5593	32076594	32081594
NM_001256475	chr4	+	57396774	57469489	THEGL	72715	57394274	57399274
NM_053055	chr1	-	151843342	151882361	THEM4	39019	151879861	151884861
NM_182578	chr1	-	151819576	151826173	THEM5	6597	151823673	151828673
NM_016647	chr8	+	143808620	143818350	THEM6	9730	143806120	143811120
NM_001164687	chr6	-	128029338	128239776	THEMIS	210438	128237276	128242276
NM_001105556	chr1	+	28199053	28213196	THEMIS2	14143	28196553	28201553
NM_001317825	chr5	+	157158396	157168455	THG1L	10059	157155896	157160896
NM_024838	chr10	+	25305507	25315593	THNSL1	10086	25303007	25308007
NM_001244676	chr2	+	88469813	88486156	THNSL2	16343	88467313	88472313
NM_005131	chr18	-	214519	268059	THOC1	53540	265559	270559
NM_001081550	chrX	-	122734411	122866904	THOC2	132493	122864404	122869404
NM_032361	chr5	-	175386533	175395318	THOC3	8785	175392818	175397818
NM_003678	chr22	-	29904155	29949736	THOC5	45581	29947236	29952236
NM_024339	chr16	+	3074019	3077756	THOC6	3737	3071519	3076519
NM_025075	chr3	-	63819545	63849599	THOC7	30054	63847099	63852099
NM_003249	chr19	+	2785457	2813602	THOP1	28145	2782957	2787957
NM_001290027	chr3	-	184089722	184097476	THPO	7754	184094976	184099976
NM_001190919	chr17	+	38218445	38250120	THRA	31675	38215945	38220945
NR_131239	chr17	+	46371708	46385191	THRA1/BTR	13483	46369208	46374208
NM_001321471	chr1	+	36690012	36770957	THRAP3	80945	36687512	36692512
NM_000461	chr3	-	24158644	24536313	THRB	377669	24533813	24538813
NR_046244	chr3	+	24535577	24541502	THRB-AS1	5925	24533077	24538077
NM_003251	chr11	+	77774906	77779403	THRSP	4497	77772406	77777406
NM_199263	chr13	-	52951302	52980629	THSD1	29327	52978129	52983129
NM_024817	chr15	+	71433787	72075722	THSD4	641935	71431287	71436287
NR_120348	chr15	-	71459150	71481398	THSD4-AS1	22248	71478898	71483898
NR_120346	chr15	-	71981039	71983878	THSD4-AS2	2839	71981378	71986378
NM_015204	chr7	-	11410061	11871824	THSD7A	461763	11869324	11874324
NM_001316349	chr2	+	137523131	138435282	THSD7B	912151	137520631	137525631
NR_046051	chr14	+	23980968	24028790	THTPA	47822	23978468	23983468
NM_001304550	chr16	-	20744985	20753286	THUMPD1	8301	20750786	20755786
NM_001321478	chr2	-	39963199	40006416	THUMPD2	43217	40003916	40008916
NM_015453	chr3	+	9404716	9428475	THUMPD3	23759	9402216	9407216
NR_132781	chr3	-	9426947	9438307	THUMPD3-AS1	11360	9435807	9440807
NM_001311162	chr11	-	119288650	119295695	THY1	7045	119293195	119298195
NM_014174	chr11	-	134118172	134123260	THYN1	5088	134120760	134125760
NM_022173	chr2	-	70436575	70475925	TIA1	39350	70473425	70478425
NR_136663	chr10	-	121332977	121356541	TIAL1	23564	121354041	121359041
NM_003253	chr21	-	32490735	32931290	TIAM1	440555	32928790	32933790
NM_012454	chr6	+	155411422	155578857	TIAM2	167435	155408922	155413922
NM_182919	chr19	-	4815935	4831754	TICAM1	15819	4829254	4834254
NM_021649	chr5	-	114914192	114938176	TICAM2	23984	114935676	114940676
NM_152259	chr15	+	90118817	90171253	TICRR	52436	90116317	90121317
NM_001253357	chr1	+	43766565	43788781	TIE1	22216	43764065	43769065
NM_052864	chr4	-	113196781	113207059	TIFA	10278	113204559	113209559
NM_001099221	chr5	-	134784557	134788089	TIFAB	3532	134785589	134790589
NM_020375	chr12	+	4430358	4469190	TIGAR	38832	4427858	4432858
NM_145702	chr2	-	233412679	233415300	TIGD1	2621	233412800	233417800
NM_145719	chr11	+	65122281	65125082	TIGD3	2801	65119781	65124781
NM_145720	chr4	-	153690505	153700916	TIGD4	10411	153698416	153703416
NM_030953	chr5	-	149372685	149380730	TIGD6	8045	149378230	149383230
NM_033208	chr16	-	3348807	3355439	TIGD7	6632	3352939	3357939
NM_173799	chr3	+	114012832	114029135	TIGIT	16303	114010332	114015332
NM_001146726	chr5	-	156346292	156390266	TIMD4	43974	156387766	156392766
NM_003920	chr12	-	56810156	56843249	TIMELESS	33093	56840749	56845749
NM_012192	chr11	+	6502676	6505911	TIMM10B	3235	6500176	6505176
NM_006335	chr1	+	201924618	201939789	TIMM17A	15171	201922118	201927118
NM_001167947	chrX	-	48750729	48755426	TIMM17B	4697	48752926	48757926
NM_014177	chr18	+	71815745	71826204	TIMM21	10459	71813245	71818245
NM_013337	chr17	+	900132	905423	TIMM22	5291	897632	902632
NM_006327	chr10	-	51592080	51623386	TIMM23	31306	51620886	51625886
NR_135475	chr10	+	51371378	51747981	TIMM23B	376603	51368878	51373878
NM_006351	chr19	-	7991602	8008708	TIMM44	17106	8006208	8011208
NM_001001563	chr19	+	39971051	39984424	TIMM50	13373	39968551	39973551
NM_004085	chrX	-	100600643	100603957	TIMM8A	3314	100601457	100606457
NR_130750	chr14	-	58875211	58894332	TIMM9	19121	58891832	58896832
NM_016589	chr3	+	119217367	119243125	TIMMDC1	25758	119214867	119219867
NM_003254	chrX	+	47441689	47446190	TIMP1	4501	47439189	47444189
NM_003255	chr17	-	76849058	76921472	TIMP2	72414	76918972	76923972
NM_000362	chr22	+	33196801	33259028	TIMP3	62227	33194301	33199301
NM_003256	chr3	-	12194567	12200851	TIMP4	6284	12198351	12203351
NM_014464	chr6	+	54173202	54254950	TINAG	81748	54170702	54175702
NM_022164	chr1	+	32042085	32053287	TINAGL1	11202	32039585	32044585
NR_027064	chr19	-	5558177	5568045	TINCR	9868	5565545	5570545
NM_012461	chr14	-	24708850	24711880	TINF2	3030	24709380	24714380
NM_015508	chr3	+	156392204	156424557	TIPARP	32353	156389704	156394704
NR_027954	chr3	-	156390959	156393502	TIPARP-AS1	2543	156391002	156396002
NM_001289986	chr15	-	66629007	66649054	TIPIN	20047	66646554	66651554
NM_152902	chr1	+	168148082	168171351	TIPRL	23269	168145582	168150582
NM_001318777	chr11	+	126152981	126164828	TIRAP	11847	126150481	126155481
NR_027313	chr2	-	131294142	131307471	TISP43	13329	131304971	131309971
NM_001146019	chr6	+	43445260	43474294	TJAP1	29034	43442760	43447760
NM_001301025	chr15	-	29991570	30261002	TJP1	269432	30258502	30263502
NM_001170414	chr9	+	71736179	71870124	TJP2	133945	71733679	71738679
NM_001267560	chr19	+	3708334	3750811	TJP3	42477	3705834	3710834
NM_003258	chr17	-	76170159	76183285	TK1	13126	76180785	76185785
NM_001172645	chr16	-	66541905	66584315	TK2	42410	66581815	66586815
NM_001351977	chr11	+	61100653	61120898	TKFC	20245	61098153	61103153
NM_001135055	chr3	-	53258722	53290130	TKT	31408	53287630	53292630
NM_001145933	chrX	+	153524026	153558713	TKTL1	34687	153521526	153526526
NM_032136	chr4	-	164392246	164395047	TKTL2	2801	164392547	164397547
NM_001160407	chr17	-	27051365	27053949	TLCD1	2584	27051449	27056449
NM_001164407	chr17	-	1606083	1613662	TLCD2	7579	1611162	1616162
NM_020947	chr16	-	84509965	84538288	TLDC1	28323	84535788	84540788
NM_001304783	chr20	+	35504523	35522634	TLDC2	18111	35502023	35507023
NM_005077	chr9	-	84198597	84304450	TLE1	105853	84301950	84306950
NM_001144761	chr19	-	2997635	3047633	TLE2	49998	3045133	3050133
NM_001282980	chr15	-	70340129	70390256	TLE3	50127	70387756	70392756
NR_104239	chr9	+	82186687	82341796	TLE4	155109	82184187	82189187
NM_024760	chr19	+	2977535	2995182	TLE6	17647	2975035	2980035
NM_001136554	chr2	-	171847332	172087824	TLK1	240492	172085324	172090324
NM_001330418	chr17	+	60556128	60692841	TLK2	136713	60553628	60558628
NM_012464	chr4	+	166794409	167025609	TLL1	231200	166791909	166796909
NM_012465	chr10	-	98124362	98273683	TLL2	149321	98271183	98276183
NM_006289	chr9	-	35697333	35732392	TLN1	35059	35729892	35734892
NM_015059	chr15	+	62939509	63136829	TLN2	197320	62937009	62942009
NM_022566	chr15	+	81293294	81296345	TLNRD1	3051	81290794	81295794
NM_003263	chr4	-	38797875	38806412	TLR1	8537	38803912	38808912
NM_001195107	chr4	-	38773859	38784611	TLR10	10752	38782111	38787111
NM_001318790	chr4	+	154605403	154627412	TLR2	22009	154602903	154607903
NM_003265	chr4	+	186990308	187006252	TLR3	15944	186987808	186992808
NM_138557	chr9	+	120466452	120479769	TLR4	13317	120463952	120468952
NM_003268	chr1	-	223282747	223316624	TLR5	33877	223314124	223319124
NM_006068	chr4	-	38825328	38858438	TLR6	33110	38855938	38860938
NM_016562	chrX	+	12885201	12908480	TLR7	23279	12882701	12887701
NM_138636	chrX	+	12924738	12941288	TLR8	16550	12922238	12927238
NR_030727	chrX	-	12920935	12961419	TLR8-AS1	40484	12958919	12963919
NM_017442	chr3	-	52255095	52260179	TLR9	5084	52257679	52262679
NM_001195517	chr10	+	102891060	102897546	TLX1	6486	102888560	102893560
NR_130723	chr10	-	102849077	102890903	TLX1NB	41826	102888403	102893403
NM_016170	chr2	+	74741595	74744275	TLX2	2680	74739095	74744095
NM_021025	chr5	+	170736287	170739138	TLX3	2851	170733787	170738787
NR_135160	chr1	-	62146718	62191095	TM2D1	44377	62188595	62193595
NM_078473	chr8	-	38846326	38854041	TM2D2	7715	38851541	38856541
NM_001308026	chr15	-	102173179	102192594	TM2D3	19415	102190094	102195094
NM_014220	chr3	-	149086804	149095568	TM4SF1	8764	149093068	149098068
NR_109809	chr3	+	149095564	149104370	TM4SF1-AS1	8806	149093064	149098064
NM_138786	chr3	-	149036284	149051548	TM4SF18	15264	149049048	149054048
NM_001204898	chr3	-	196050416	196065291	TM4SF19	14875	196062791	196067791
NR_046724	chr3	+	196045202	196052441	TM4SF19-AS1	7239	196042702	196047702
NR_037950	chr3	-	196042955	196065291	TM4SF19-TCTEX1D2	22336	196062791	196067791
NM_024795	chr2	-	228226753	228244022	TM4SF20	17269	228241522	228246522
NM_004617	chr3	+	149192367	149221181	TM4SF4	28814	149189867	149194867
NM_003963	chr17	+	4675186	4686506	TM4SF5	11320	4672686	4677686
NM_001330385	chr15	+	83776237	83806111	TM6SF1	29874	83773737	83778737
NM_001001524	chr19	-	19375173	19384074	TM6SF2	8901	19381574	19386574
NR_102367	chr11	+	64879325	64883707	TM7SF2	4382	64876825	64881825
NM_016551	chr12	-	27124505	27167339	TM7SF3	42834	27164839	27169839
NM_006405	chr14	-	24658348	24664942	TM9SF1	6594	24662442	24667442
NM_004800	chr13	+	100153627	100216302	TM9SF2	62675	100151127	100156127
NM_020123	chr10	-	98277866	98346809	TM9SF3	68943	98344309	98349309
NM_014742	chr20	+	30697308	30755061	TM9SF4	57753	30694808	30699808
NM_018352	chr4	+	164415672	164441691	TMA16	26019	164413172	164418172
NM_015933	chr3	+	48481647	48485616	TMA7	3969	48479147	48484147
NR_135643	chr2	-	219138914	219157300	TMBIM1	18386	219154800	219159800
NM_001282610	chr12	-	66530715	66563852	TMBIM4	33137	66561352	66566352
NM_003217	chr12	+	50135292	50158717	TMBIM6	23425	50132792	50137792
NR_145992	chr7	-	92041863	92066628	TMBIM7P	24765	92064128	92069128
NM_138691	chr9	+	75136716	75451267	TMC1	314551	75134216	75139216
NM_080751	chr20	+	2517252	2622430	TMC2	105178	2514752	2519752
NM_001080532	chr15	-	81623445	81666497	TMC3	43052	81663997	81668997
NR_120365	chr15	+	81616673	81735417	TMC3-AS1	118744	81614173	81619173
NM_001145303	chr19	-	54663832	54676944	TMC4	13112	54674444	54679444
NM_001308161	chr16	+	19421860	19510434	TMC5	88574	19419360	19424360
NM_007267	chr17	-	76108998	76128508	TMC6	19510	76126008	76131008
NR_136733	chr16	+	18995255	19075262	TMC7	80007	18992755	18997755
NM_152468	chr17	+	76126858	76139049	TMC8	12191	76124358	76129358
NM_001128224	chr3	-	129366634	129612419	TMCC1	245785	129609919	129614919
NR_037893	chr3	+	129612713	129627755	TMCC1-AS1	15042	129610213	129615213
NM_014858	chr1	+	205197037	205242471	TMCC2	45434	205194537	205199537
NM_020698	chr12	-	94960899	95044338	TMCC3	83439	95041838	95046838
NM_019026	chr1	-	165693527	165738159	TMCO1	44632	165735659	165740659
NM_001008740	chr1	+	40713572	40717365	TMCO2	3793	40711072	40716072
NM_017905	chr13	+	114145052	114204544	TMCO3	59492	114142552	114147552
NM_001349112	chr1	-	20008705	20126514	TMCO4	117809	20124014	20129014
NM_001330255	chr15	+	38226807	38259925	TMCO5A	33118	38224307	38229307
NR_046005	chr15	-	33528676	33539756	TMCO5B	11080	33537256	33542256
NM_001300980	chr5	+	140019011	140024993	TMCO6	5982	140016511	140021511
NM_006858	chr19	-	10942742	10946983	TMED1	4241	10944483	10949483
NM_006827	chr14	-	75598170	75643349	TMED10	45179	75640849	75645849
NR_002807	chr8	+	146220250	146224283	TMED10P1	4033	146217750	146222750
NR_033768	chr4	-	1108984	1116952	TMED11P	7968	1114452	1119452
NM_001321445	chr12	+	124069077	124082691	TMED2	13614	124066577	124071577
NM_001330376	chr15	+	79603403	79706228	TMED3	102825	79600903	79605903
NM_001303059	chr7	-	44617493	44621894	TMED4	4401	44619394	44624394
NM_016040	chr1	-	93615298	93646246	TMED5	30948	93643746	93648746
NM_144676	chr16	-	69377148	69385712	TMED6	8564	69383212	69388212
NM_181836	chr5	-	114948904	114961876	TMED7	12972	114959376	114964376
NM_001164469	chr5	-	114914192	114961876	TMED7-TICAM2	47684	114959376	114964376
NM_001346131	chr14	-	77801363	77843452	TMED8	42089	77840952	77845952
NM_017510	chr5	+	177019148	177024243	TMED9	5095	177016648	177021648
NM_003692	chr9	+	103235519	103339918	TMEFF1	104399	103233019	103238019
NM_016192	chr2	-	192813771	193059659	TMEFF2	245888	193057159	193062159
NM_001099640	chr17	-	53796987	53809482	TMEM100	12495	53806982	53811982
NM_001304813	chr17	-	42088555	42100519	TMEM101	11964	42098019	42103019
NM_001321264	chr17	+	72772621	72835922	TMEM104	63301	72770121	72775121
NM_178520	chr17	-	79285071	79304474	TMEM105	19403	79301974	79306974
NM_001291586	chr17	+	41363845	41372057	TMEM106A	8212	41361345	41366345
NM_018374	chr7	+	12250847	12276890	TMEM106B	26043	12248347	12253347
NM_001143843	chr12	+	48357329	48362661	TMEM106C	5332	48354829	48359829
NM_001351278	chr17	-	8075777	8079729	TMEM107	3952	8077229	8082229
NM_001136469	chr3	+	132757131	133116619	TMEM108	359488	132754631	132759631
NR_110812	chr3	-	132965291	132975965	TMEM108-AS1	10674	132973465	132978465
NM_024092	chr11	+	60681370	60690915	TMEM109	9545	60678870	60683870
NR_024547	chr17	-	21101262	21117908	TMEM11	16646	21115408	21120408
NM_198563	chr3	-	52870771	52931597	TMEM110	60826	52929097	52934097
NM_001198974	chr3	-	52867130	52931597	TMEM110-MUSTN1	64467	52929097	52934097
NR_110736	chr16	-	8576550	8602209	TMEM114	25659	8599709	8604709
NM_007024	chr3	-	50392179	50396939	TMEM115	4760	50394439	50399439
NM_001294314	chr12	-	112369086	112451023	TMEM116	81937	112448523	112453523
NM_032256	chr12	+	44229663	44783545	TMEM117	553882	44227163	44232163
NM_181724	chr12	-	108983621	108991894	TMEM119	8273	108989394	108994394
NM_031925	chr7	-	75616154	75623992	TMEM120A	7838	75621492	75626492
NM_001080825	chr12	+	122150657	122219974	TMEM120B	69317	122148157	122153157
NM_025268	chr14	+	105992939	105996539	TMEM121	3600	105990439	105995439
NM_001163079	chr22	-	17597188	17602257	TMEM121B	5069	17599757	17604757
NM_052932	chr11	-	102267055	102323775	TMEM123	56720	102321275	102326275
NM_144626	chr1	+	43735664	43739673	TMEM125	4009	43733164	43738164
NM_001244735	chr11	+	85358962	85367597	TMEM126A	8635	85356462	85361462
NM_018480	chr11	+	85339616	85347584	TMEM126B	7968	85337116	85342116
NM_017849	chr2	-	96915945	96931751	TMEM127	15806	96929251	96934251
NM_001297551	chr4	-	4237268	4249969	TMEM128	12701	4247469	4252469
NM_138385	chr4	-	1717678	1723084	TMEM129	5406	1720584	1725584
NM_152913	chr7	-	98444110	98467673	TMEM130	23563	98465173	98470173
NM_015348	chr2	-	98372800	98612354	TMEM131	239554	98609854	98614854
NM_015196	chr4	+	154387497	154557862	TMEM131L	170365	154384997	154389997
NM_178031	chr11	+	60691912	60704631	TMEM132A	12719	60689412	60694412
NM_052907	chr12	+	125811161	126146923	TMEM132B	335762	125808661	125813661
NM_001136103	chr12	+	128751947	129192460	TMEM132C	440513	128749447	128754447
NM_133448	chr12	-	129556270	130388212	TMEM132D	831942	130385712	130390712
NR_104172	chr12	+	129594234	129597843	TMEM132D-AS1	3609	129591734	129596734
NR_110058	chr12	+	129693145	129697205	TMEM132D-AS2	4060	129690645	129695645
NM_001304438	chr17	+	32907767	32966337	TMEM132E	58570	32905267	32910267
NR_073410	chr11	-	67231818	67236748	TMEM134	4930	67234248	67239248
NM_022918	chr11	+	86748885	87039876	TMEM135	290991	86746385	86751385
NM_001198672	chr11	+	120195837	120204388	TMEM136	8551	120193337	120198337
NM_001330281	chr11	+	61129472	61136975	TMEM138	7503	61126972	61131972
NR_104253	chr7	+	142981991	142985142	TMEM139	3151	142979491	142984491
NM_018295	chr7	+	134832765	134850967	TMEM140	18202	134830265	134835265
NM_001303538	chr19	-	48835612	48867494	TMEM143	31882	48864994	48869994
NM_018342	chr4	+	159131400	159176439	TMEM144	45039	159128900	159133900
NM_173633	chr19	+	42817476	42829214	TMEM145	11738	42814976	42819976
NR_038396	chr19	-	36031639	36036931	TMEM147-AS1	5292	36034431	36039431
NM_014051	chr6	+	52535883	52551385	TMEM14A	15502	52533383	52538383
NM_001286489	chr6	+	10747991	10760006	TMEM14B	12015	10745491	10750491
NM_016462	chr6	+	10723147	10731362	TMEM14C	8215	10720647	10725647
NR_033179	chr2	-	85825669	85829822	TMEM150A	4153	85827322	85832322
NM_001282011	chr19	-	55824168	55836708	TMEM150B	12540	55834208	55839208
NM_001080506	chr4	-	83405603	83483126	TMEM150C	77523	83480626	83485626
NM_153266	chr11	+	66059372	66064135	TMEM151A	4763	66056872	66061872
NM_001137560	chr6	+	44238479	44247182	TMEM151B	8703	44235979	44240979
NM_152680	chr4	-	153547265	153601317	TMEM154	54052	153598817	153603817
NM_001317842	chr4	-	122680087	122686555	TMEM155	6468	122684055	122689055
NM_001303228	chr4	-	38968365	39034041	TMEM156	65676	39031541	39036541
NM_001301775	chr16	+	21169697	21191937	TMEM159	22240	21167197	21172197
NM_017854	chr19	-	47549166	47551882	TMEM160	2716	47549382	47554382
NM_001256766	chr19	-	19230424	19249310	TMEM161A	18886	19246810	19251810
NM_001349407	chr5	-	87484132	87564696	TMEM161B	80564	87562196	87567196
NR_039993	chr5	+	87564698	87732491	TMEM161B-AS1	167793	87562198	87567198
NM_030923	chr2	-	135213329	135476571	TMEM163	263242	135474071	135479071
NM_017698	chrX	+	109245862	109421016	TMEM164	175154	109243362	109248362
NR_073070	chr4	+	56262079	56292342	TMEM165	30263	56259579	56264579
NM_174909	chr5	-	82348664	82373272	TMEM167A	24608	82370772	82375772
NR_136242	chr1	+	109633362	109639556	TMEM167B	6194	109630862	109635862
NM_001287497	chr7	-	112402436	112430478	TMEM168	28042	112427978	112432978
NM_001142311	chr2	+	216946588	216967506	TMEM169	20918	216944088	216949088
NM_198276	chr2	-	62727355	62733604	TMEM17	6249	62731104	62736104
NM_001304998	chr16	-	75477141	75498635	TMEM170A	21494	75496135	75501135
NM_001100829	chr6	+	11538459	11583757	TMEM170B	45298	11535959	11540959
NM_001161342	chr5	+	72416387	72427644	TMEM171	11257	72413887	72418887
NM_198282	chr5	-	138855112	138862375	TMEM173	7263	138859875	138864875
NM_001297426	chr4	+	926174	952443	TMEM175	26269	923674	928674
NM_018487	chr7	+	150497853	150502208	TMEM176A	4355	150495353	150500353
NM_014020	chr7	-	150488375	150498448	TMEM176B	10073	150495948	150500948
NR_148341	chr2	+	120436742	120481193	TMEM177	44451	120434242	120439242
NM_001167959	chr2	+	39892637	39945104	TMEM178A	52467	39890137	39895137
NM_001195278	chr7	+	140774031	141180179	TMEM178B	406148	140771531	140776531
NM_001286389	chr14	-	105057200	105071097	TMEM179	13897	105068597	105073597
NM_199337	chr11	+	62554873	62557872	TMEM179B	2999	62552373	62557373
NM_152834	chr2	-	663877	677468	TMEM18	13591	674968	679968
NM_020823	chr6	+	158957467	159056467	TMEM181	99000	158954967	158959967
NM_001321344	chr2	+	103353364	103434138	TMEM182	80774	103350864	103355864
NM_001322957	chr1	+	202976494	202993976	TMEM183A	17482	202973994	202978994
NM_001079809	chr1	+	202976535	202992668	TMEM183B	16133	202974035	202979035
NM_001097620	chr7	-	1581870	1596066	TMEM184A	14196	1593566	1598566
NM_001195072	chr22	-	38615297	38669040	TMEM184B	53743	38666540	38671540
NM_018241	chr4	+	148538538	148556672	TMEM184C	18134	148536038	148541038
NM_032508	chrX	-	148678215	148713568	TMEM185A	35353	148711068	148716068
NM_024121	chr2	-	120975046	120980984	TMEM185B	5938	120978484	120983484
NM_003492	chrX	+	153237990	153248646	TMEM187	10656	153235490	153240490
NR_027889	chr20	-	48740273	48770335	TMEM189	30062	48767835	48772835
NM_199203	chr20	-	48697660	48770335	TMEM189-UBE2V1	72675	48767835	48772835
NM_018279	chr12	+	72079877	72097839	TMEM19	17962	72077377	72082377
NR_026815	chr22	+	21055401	21058891	TMEM191A	3490	21052901	21057901
NM_001242313	chr22	+	20377668	20380440	TMEM191B	2772	20375168	20380168
NM_001207052	chr22	+	21821458	21824224	TMEM191C	2766	21818958	21823958
NM_001100389	chr4	-	165997229	166034024	TMEM192	36795	166031524	166036524
NM_152774	chr7	-	19758937	19812404	TMEM196	53467	19809904	19814904
NM_001303098	chr2	+	220408384	220415317	TMEM198	6933	220405884	220410884
NR_036477	chr12	+	56223391	56230030	TMEM198B	6639	56220891	56225891
NM_152464	chr17	+	26684603	26690705	TMEM199	6102	26682103	26687103
NM_013390	chr9	-	74298281	74383800	TMEM2	85519	74381300	74386300
NM_001258276	chr6	+	130687425	130764210	TMEM200A	76785	130684925	130689925
NM_001003682	chr1	-	29445936	29450421	TMEM200B	4485	29447921	29452921
NM_001080209	chr18	-	5889410	5895953	TMEM200C	6543	5893453	5898453
NM_001130924	chr1	+	9648931	9674935	TMEM201	26004	9646431	9651431
NM_001080462	chr15	+	72690653	72700708	TMEM202	10055	72688153	72693153
NR_135678	chr15	-	72700119	72766580	TMEM202-AS1	66461	72764080	72769080
NM_001256541	chr16	+	1578741	1605581	TMEM204	26840	1576241	1581241
NM_001321113	chr19	-	11453451	11456981	TMEM205	3530	11454481	11459481
NM_018252	chr1	-	212537815	212588267	TMEM206	50452	212585767	212590767
NM_207316	chr3	-	190146444	190167665	TMEM207	21221	190165165	190170165
NM_001301163	chr7	-	129804552	129845338	TMEM209	40786	129842838	129847838
NM_001001663	chr22	-	25331207	25335314	TMEM211	4107	25332814	25337814
NM_001164436	chr3	+	171561138	171577108	TMEM212	15970	171558638	171563638
NR_046852	chr3	-	171594141	171618530	TMEM212-AS1	24389	171616030	171621030
NM_001085429	chr7	+	138482738	138490769	TMEM213	8031	138480238	138485238
NM_017727	chr2	+	27255773	27264565	TMEM214	8792	27253273	27258273
NM_212558	chr9	+	32783496	32789199	TMEM215	5703	32780996	32785996
NM_001173990	chr11	+	61159831	61166335	TMEM216	6504	61157331	61162331
NM_001286401	chr6	-	37179953	37225931	TMEM217	45978	37223431	37228431
NR_047586	chr11	-	124964265	124981659	TMEM218	17394	124979159	124984159
NM_194280	chr16	+	29973350	29984373	TMEM219	11023	29970850	29975850
NM_001330140	chr17	-	10616611	10633646	TMEM220	17035	10631146	10636146
NR_073458	chr17	+	10633093	10718481	TMEM220-AS1	85388	10630593	10635593
NM_001190844	chr19	-	17546317	17559376	TMEM221	13059	17556876	17561876
NR_037576	chr1	+	27648635	27662891	TMEM222	14256	27646135	27651135
NM_001013743	chr11	-	123753632	123756349	TMEM225	2717	123753849	123758849
NM_001195543	chr7	+	99195688	99208668	TMEM225B	12980	99193188	99198188
NM_001136002	chr7	-	123670969	123673523	TMEM229A	2554	123671023	123676023
NM_001348546	chr14	-	67936982	68000567	TMEM229B	63585	67998067	68003067
NM_001330987	chr20	-	5049027	5093733	TMEM230	44706	5091233	5096233
NM_001077416	chr16	-	75572014	75590184	TMEM231	18170	75587684	75592684
NM_001039763	chr5	-	109755197	110062450	TMEM232	307253	110059950	110064950
NM_001136534	chr12	+	120031263	120079363	TMEM233	48100	120028763	120033763
NR_133635	chr1	-	32680077	32687972	TMEM234	7895	32685472	32690472
NM_001204210	chr17	+	76227390	76237068	TMEM235	9678	76224890	76229890
NM_001098844	chr10	+	18041226	18089854	TMEM236	48628	18038726	18043726
NM_001044385	chr2	-	202484906	202508252	TMEM237	23346	202505752	202510752
NM_001190764	chr19	-	55890611	55895627	TMEM238	5016	55893127	55898127
NM_001318207	chr20	+	2796947	2800930	TMEM239	3983	2794447	2799447
NM_001114748	chr1	-	1470157	1475740	TMEM240	5583	1473240	1478240
NM_001318834	chr18	-	20875978	21017933	TMEM241	141955	21015433	21020433
NM_018452	chr6	-	157710053	157745291	TMEM242	35238	157742791	157747791
NM_001329473	chr7	-	86825477	86849903	TMEM243	24426	86847403	86852403
NM_001010876	chr6	-	130152388	130182416	TMEM244	30028	130179916	130184916
NM_032012	chr9	-	111777414	111882225	TMEM245	104811	111879725	111884725
NM_032342	chr9	-	104235439	104249503	TMEM246	14064	104247003	104252003
NR_121576	chr9	+	104230720	104243788	TMEM246-AS1	13068	104228220	104233220
NM_001145051	chr2	+	46706703	46711564	TMEM247	4861	46704203	46709203
NM_017994	chr7	+	66386202	66423538	TMEM248	37336	66383702	66388702
NM_001144038	chr11	+	118401802	118417313	TMEM25	15511	118399302	118404302
NM_152833	chr9	-	139006426	139010731	TMEM250	4305	139008231	139013231
NM_153237	chr9	-	71151497	71155783	TMEM252	4286	71153283	71158283
NM_001146683	chr14	+	21567095	21571883	TMEM253	4788	21564595	21569595
NM_001270370	chr10	+	81838401	81852307	TMEM254	13906	81835901	81840901
NR_027430	chr10	-	81805988	81838949	TMEM254-AS1	32961	81836449	81841449
NM_017938	chrX	-	119392504	119445391	TMEM255A	52887	119442891	119447891
NM_001348663	chr13	+	114462215	114515216	TMEM255B	53001	114459715	114464715
NR_037719	chr17	-	7293046	7307450	TMEM256-PLSCR3	14404	7304950	7309950
NM_014206	chr11	-	61556601	61560085	TMEM258	3484	61557585	61562585
NM_033420	chr19	-	1009649	1021141	TMEM259	11492	1018641	1023641
NR_134507	chr10	-	63166399	63213208	TMEM26	46809	63210708	63215708
NR_120643	chr10	+	63212396	63253189	TMEM26-AS1	40793	63209896	63214896
NM_017799	chr14	+	57046510	57116232	TMEM260	69722	57044010	57049010
NM_001319666	chr12	+	107349499	107367815	TMEM263	18316	107346999	107351999
NM_001256829	chr16	+	30751511	30756517	TMEM265	5006	30749011	30754011
NM_152335	chr15	+	76352298	76497304	TMEM266	145006	76349798	76354798
NM_022483	chr5	-	43444353	43483992	TMEM267	39639	43481492	43486492
NM_001330760	chr9	+	117373599	117408704	TMEM268	35105	117371099	117376099
NM_001242750	chr1	+	43253660	43263901	TMEM269	10241	43251160	43256160
NM_020665	chrX	-	15645438	15683154	TMEM27	37716	15680654	15685654
NM_182504	chr7	+	73275488	73280223	TMEM270	4735	73272988	73277988
NM_001143958	chr6	-	75962637	75994632	TMEM30A	31995	75992132	75997132
NM_001017970	chr14	-	61744088	61748530	TMEM30B	4442	61746030	61751030
NR_028357	chr3	+	99904667	99913030	TMEM30CP	8363	99902167	99907167
NM_182541	chrX	+	102965836	102968960	TMEM31	3124	102963336	102968336
NM_018126	chr4	+	41937136	41962824	TMEM33	25688	41934636	41939636
NM_021637	chrX	+	100333835	100351355	TMEM35A	17520	100331335	100336335
NM_001195156	chr1	-	35447126	35450948	TMEM35B	3822	35448448	35453448
NM_183240	chr2	+	120189445	120196096	TMEM37	6651	120186945	120191945
NM_024074	chr19	+	16771937	16799816	TMEM38A	27879	16769437	16774437
NM_018112	chr9	+	108456805	108538892	TMEM38B	82087	108454305	108459305
NR_073506	chr3	-	119147806	119182529	TMEM39A	34723	119180029	119185029
NM_001319677	chr1	+	32537631	32568467	TMEM39B	30836	32535131	32540131
NM_001284406	chr3	-	12775028	12810956	TMEM40	35928	12808456	12813456
NM_080652	chr3	-	185207388	185216845	TMEM41A	9457	185214345	185219345
NR_028491	chr11	-	9302200	9336315	TMEM41B	34115	9333815	9338815
NM_144638	chr3	+	44903400	44907159	TMEM42	3759	44900900	44905900
NM_024334	chr3	+	14166439	14185180	TMEM43	18741	14163939	14168939
NM_001011655	chr3	-	194308401	194354150	TMEM44	45749	194351650	194356650
NR_047573	chr3	+	194304996	194311561	TMEM44-AS1	6565	194302496	194307496
NM_018004	chr3	+	100211462	100296296	TMEM45A	84834	100208962	100213962
NM_001331210	chr11	+	129685675	129729406	TMEM45B	43731	129683175	129688175
NM_031442	chrX	-	34645180	34675405	TMEM47	30225	34672905	34677905
NM_014254	chr12	+	64173582	64203338	TMEM5	29756	64171082	64176082
NR_126167	chr12	-	64202624	64215936	TMEM5-AS1	13312	64213436	64218436
NM_014313	chr1	+	25664788	25688852	TMEM50A	24064	25662288	25667288
NR_040016	chr21	-	34804792	34852316	TMEM50B	47524	34849816	34854816
NM_001136216	chr1	+	15479027	15546974	TMEM51	67947	15476527	15481527
NR_027136	chr1	-	15438310	15478960	TMEM51-AS1	40650	15476460	15481460
NM_001079815	chr12	+	10323197	10344403	TMEM52B	21206	10320697	10325697
NM_024587	chr1	-	45118918	45140280	TMEM53	21362	45137780	45142780
NM_033504	chr1	-	33360193	33367041	TMEM54	6848	33364541	33369541
NM_018710	chr8	-	92006501	92053203	TMEM55A	46702	92050703	92055703
NM_001100814	chr14	-	20926011	20929771	TMEM55B	3760	20927271	20932271
NM_001199679	chr1	+	95558072	95663161	TMEM56	105089	95555572	95560572
NM_001199691	chr1	+	95583478	95710509	TMEM56-RWDD3	127031	95580978	95585978
NM_001282564	chr1	+	25757348	25826698	TMEM57	69350	25754848	25759848
NM_001305049	chr1	-	54492353	54519246	TMEM59	26893	54516746	54521746
NM_012109	chr19	+	18723681	18731849	TMEM59L	8168	18721181	18726181
NM_032936	chr7	-	77423044	77427747	TMEM60	4703	77425247	77430247
NM_182532	chr1	+	55446336	55457966	TMEM61	11630	55443836	55448836
NM_001347004	chr15	+	43425312	43477341	TMEM62	52029	43422812	43427812
NM_014698	chr1	-	226033232	226070420	TMEM63A	37188	226067920	226072920
NM_001318792	chr6	+	44094650	44123256	TMEM63B	28606	44092150	44097150
NM_020431	chr14	+	77648101	77725838	TMEM63C	77737	77645601	77650601
NM_001146273	chr8	-	91634222	91658133	TMEM64	23911	91655633	91660633
NM_194291	chr8	-	125323158	125384940	TMEM65	61782	125382440	125387440
NR_024522	chr8	+	94767071	94831460	TMEM67	64389	94764571	94769571
NM_152417	chr8	-	56651302	56685966	TMEM68	34664	56683466	56688466
NM_016486	chr1	+	46153846	46160108	TMEM69	6262	46151346	46156346
NM_001040613	chr8	+	74888376	74895018	TMEM70	6642	74885876	74890876
NM_001145153	chr8	-	133722191	133772914	TMEM71	50723	133770414	133775414
NM_001345926	chr10	+	45406763	45432458	TMEM72	25695	45404263	45409263
NR_033842	chr10	-	45306471	45455137	TMEM72-AS1	148666	45452637	45457637
NR_136411	chr8	-	109619078	109799844	TMEM74	180766	109797344	109802344
NM_001304749	chr20	-	1161204	1166077	TMEM74B	4873	1163577	1168577
NR_026678	chr1	+	156252703	156262234	TMEM79	9531	156250203	156255203
NM_001276274	chr11	+	695590	705028	TMEM80	9438	693090	698090
NM_001013641	chr1	+	16068986	16074292	TMEM82	5306	16066486	16071486
NM_153347	chr11	+	18720281	18726332	TMEM86A	6051	18717781	18722781
NM_173804	chr19	-	55738001	55740632	TMEM86B	2631	55738132	55743132
NM_001286487	chr15	-	42502649	42565782	TMEM87A	63133	42563282	42568282
NM_032824	chr2	+	112812799	112876895	TMEM87B	64096	112810299	112815299
NM_021259	chr16	-	420775	431950	TMEM8A	11175	429450	434450
NM_001042589	chr9	+	35829221	35854844	TMEM8B	25623	35826721	35831721
NM_001288564	chr1	-	201103898	201140710	TMEM9	36812	201138210	201143210
NM_001098825	chr19	+	41869870	41889987	TMEM91	20117	41867370	41872370
NM_001168215	chr17	+	48348766	48358846	TMEM92	10080	48346266	48351266
NR_125805	chr17	-	48358941	48365216	TMEM92-AS1	6275	48362716	48367716
NM_014738	chr17	+	73452544	73496533	TMEM94	43989	73450044	73455044
NM_014573	chr17	+	26646120	26655711	TMEM97	9591	26643620	26648620
NM_001301746	chr17	+	31254927	31268667	TMEM98	13740	31252427	31257427
NM_001195387	chr17	+	38975343	38992526	TMEM99	17183	38972843	38977843
NM_001286095	chr11	-	8968747	8986558	TMEM9B	17811	8984058	8989058
NR_073431	chr11	+	8986221	8997830	TMEM9B-AS1	11609	8983721	8988721
NM_007114	chr3	-	69068977	69101484	TMF1	32507	69098984	69103984
NM_147196	chr3	+	46742822	46752413	TMIE	9591	46740322	46745322
NM_206832	chr17	-	28643365	28661077	TMIGD1	17712	28658577	28663577
NM_144615	chr19	-	4292224	4302428	TMIGD2	10204	4299928	4304928
NM_001081976	chr1	-	112025969	112106625	TMIGD3	80656	112104125	112109125
NM_018196	chrX	-	154718672	154842622	TMLHE	123950	154840122	154845122
NR_039991	chrX	+	154696200	154723771	TMLHE-AS1	27571	154693700	154698700
NM_001166116	chr9	+	100263461	100364025	TMOD1	100564	100260961	100265961
NM_014548	chr15	+	52043757	52108558	TMOD2	64801	52041257	52046257
NM_014547	chr15	+	52121824	52204331	TMOD3	82507	52119324	52124324
NM_013353	chr1	-	151142462	151148547	TMOD4	6085	151146047	151151047
NM_001307975	chr12	+	98909350	98944157	TMPO	34807	98906850	98911850
NR_027157	chr12	-	98906750	98910004	TMPO-AS1	3254	98907504	98912504
NM_001136238	chr3	-	33131907	33138293	TMPPE	6386	33135793	33140793
NM_182606	chr4	-	68776018	68829232	TMPRSS11A	53214	68826732	68831732
NM_182502	chr4	-	69092370	69111412	TMPRSS11B	19042	69108912	69113912
NR_104048	chr4	-	69049846	69083798	TMPRSS11BNL	33952	69081298	69086298
NM_004262	chr4	-	68686593	68749716	TMPRSS11D	63123	68747216	68752216
NM_014058	chr4	+	69313166	69363322	TMPRSS11E	50156	69310666	69315666
NM_207407	chr4	-	68918915	68995587	TMPRSS11F	76672	68993087	68998087
NR_033737	chr4	-	68857529	68863157	TMPRSS11GP	5628	68860657	68865657
NM_182559	chr12	+	51236700	51281663	TMPRSS12	44963	51234200	51239200
NM_001077263	chr11	-	117771355	117800168	TMPRSS13	28813	117797668	117802668
NM_002772	chr21	-	19641432	19775970	TMPRSS15	134538	19773470	19778470
NM_005656	chr21	-	42836477	42880085	TMPRSS2	43608	42877585	42882585
NR_046020	chr21	-	43791995	43816955	TMPRSS3	24960	43814455	43819455
NR_110734	chr11	+	117947726	117990556	TMPRSS4	42830	117945226	117950226
NR_038318	chr11	-	117886486	117957508	TMPRSS4-AS1	71022	117955008	117960008
NR_110047	chr11	-	113558267	113577095	TMPRSS5	18828	113574595	113579595
NM_001289000	chr22	-	37461475	37505603	TMPRSS6	44128	37503103	37508103
NM_001042575	chr3	+	111758464	111800116	TMPRSS7	41652	111755964	111760964
NM_182973	chr19	+	2389768	2426256	TMPRSS9	36488	2387268	2392268
NM_021992	chrX	-	101768609	101771699	TMSB15A	3090	101769199	101774199
NM_001350213	chrX	+	103173478	103229008	TMSB15B	55530	103170978	103175978
NM_175861	chr12	-	29653745	29937692	TMTC1	283947	29935192	29940192
NM_152588	chr12	+	83080933	83528647	TMTC2	447714	83078433	83083433
NM_181783	chr12	+	88536072	88593664	TMTC3	57592	88533572	88538572
NM_001079669	chr13	-	101255886	101327189	TMTC4	71303	101324689	101329689
NM_001330235	chr17	+	42264318	42269297	TMUB2	4979	42261818	42266818
NM_030755	chr14	+	51706885	51724372	TMX1	17487	51704385	51709385
NR_037645	chr11	+	57479994	57508445	TMX2	28451	57477494	57482494
NR_037646	chr11	+	57479994	57586652	TMX2-CTNND1	106658	57477494	57482494
NM_019022	chr18	-	66340924	66382410	TMX3	41486	66379910	66384910
NM_021156	chr20	-	7957999	8000476	TMX4	42477	7997976	8002976
NM_002160	chr9	-	117781853	117880536	TNC	98683	117878036	117883036
NM_000594	chr6_qbl_hap6	+	2836981	2839752	TNF	2771	2834481	2839481
NM_021137	chr17	+	26662547	26674035	TNFAIP1	11488	26660047	26665047
NM_006291	chr14	+	103592663	103603776	TNFAIP2	11113	103590163	103595163
NM_001270508	chr6	+	138188324	138204451	TNFAIP3	16127	138185824	138190824
NM_007115	chr2	+	152214105	152236562	TNFAIP6	22457	152211605	152216605
NM_001077654	chr5	+	118604386	118730299	TNFAIP8	125913	118601886	118606886
NM_152362	chr19	+	4639526	4655580	TNFAIP8L1	16054	4637026	4642026
NM_024575	chr1	+	151129104	151132225	TNFAIP8L2	3121	151126604	151131604
NR_144937	chr1	+	151129104	151142773	TNFAIP8L2-SCNM1	13669	151126604	151131604
NM_207381	chr15	-	51348798	51397473	TNFAIP8L3	48675	51394973	51399973
NM_003844	chr8	-	23048969	23082680	TNFRSF10A	33711	23080180	23085180
NR_027140	chr8	-	22877647	22926700	TNFRSF10B	49053	22924200	22929200
NM_003841	chr8	+	22960326	22974950	TNFRSF10C	14624	22957826	22962826
NM_003840	chr8	-	22993100	23021543	TNFRSF10D	28443	23019043	23024043
NM_003839	chr18	+	59992519	60054943	TNFRSF11A	62424	59990019	59995019
NM_002546	chr8	-	119935795	119964383	TNFRSF11B	28588	119961883	119966883
NM_012452	chr17	-	16842397	16875402	TNFRSF13B	33005	16872902	16877902
NM_003820	chr1	+	2487803	2497061	TNFRSF14	9258	2485303	2490303
NR_037844	chr1	-	2481358	2488450	TNFRSF14-AS1	7092	2485950	2490950
NM_001192	chr16	+	12058963	12061925	TNFRSF17	2962	12056463	12061463
NM_004195	chr1	-	1138887	1142089	TNFRSF18	3202	1139589	1144589
NM_148957	chr13	+	24144508	24250244	TNFRSF19	105736	24142008	24147008
NM_001065	chr12	-	6437922	6451283	TNFRSF1A	13361	6448783	6453783
NM_001066	chr1	+	12227059	12269277	TNFRSF1B	42218	12224559	12229559
NM_014452	chr6	-	47199262	47277683	TNFRSF21	78421	47275183	47280183
NM_148965	chr1	-	6521213	6526255	TNFRSF25	5042	6523755	6528755
NM_003327	chr1	-	1146705	1149548	TNFRSF4	2843	1147048	1152048
NM_001243	chr1	+	12123433	12204264	TNFRSF8	80831	12120933	12125933
NM_001561	chr1	-	7975930	8003225	TNFRSF9	27295	8000725	8005725
NR_033994	chr3	-	172223297	172241297	TNFSF10	18000	172238797	172243797
NM_033012	chr13	+	43136871	43182149	TNFSF11	45278	43134371	43139371
NR_037146	chr17	+	7452374	7461207	TNFSF12	8833	7449874	7454874
NM_172089	chr17	+	7452374	7464925	TNFSF12-TNFSF13	12551	7449874	7454874
NM_172088	chr17	+	7461608	7464925	TNFSF13	3317	7459108	7464108
NM_001145645	chr13	+	108921976	108960832	TNFSF13B	38856	108919476	108924476
NM_003807	chr19	-	6661263	6670599	TNFSF14	9336	6668099	6673099
NM_005118	chr9	-	117546914	117568408	TNFSF15	21494	117565908	117570908
NM_005092	chr1	-	173010359	173020103	TNFSF18	9744	173017603	173022603
NM_003326	chr1	-	173152869	173176452	TNFSF4	23583	173173952	173178952
NM_001252290	chr9	-	117655622	117692875	TNFSF8	37253	117690375	117695375
NM_003811	chr19	+	6531009	6535939	TNFSF9	4930	6528509	6533509
NM_015028	chr3	-	170776202	171178197	TNIK	401995	171175697	171180697
NM_001252390	chr5	-	150409503	150467221	TNIP1	57718	150464721	150469721
NM_024309	chr4	-	2743386	2758103	TNIP2	14717	2755603	2760603
NM_001244764	chr4	-	122052563	122148621	TNIP3	96058	122146121	122151121
NM_003985	chr17	+	7284292	7293092	TNK1	8800	7281792	7286792
NM_005781	chr3	-	195590235	195635880	TNK2	45645	195633380	195638380
NR_145450	chr3	+	195634946	195640135	TNK2-AS1	5189	195632446	195637446
NM_003747	chr8	+	9413444	9639856	TNKS	226412	9410944	9415944
NM_033396	chr11	-	57067102	57092413	TNKS1BP1	25311	57089913	57094913
NM_025235	chr10	+	93558150	93625232	TNKS2	67082	93555650	93560650
NR_108071	chr10	-	93542595	93558048	TNKS2-AS1	15453	93555548	93560548
NM_022144	chrX	+	99839789	99854882	TNMD	15093	99837289	99842289
NM_022093	chr1	+	175036993	175117202	TNN	80209	175034493	175039493
NM_003280	chr3	-	52485106	52488057	TNNC1	2951	52485557	52490557
NM_003279	chr20	-	44451854	44455953	TNNC2	4099	44453453	44458453
NM_003281	chr1	-	201372894	201390874	TNNI1	17980	201388374	201393374
NM_003282	chr11	+	1860232	1862910	TNNI2	2678	1857732	1862732
NM_000363	chr19	-	55663135	55669100	TNNI3	5965	55666600	55671600
NM_015978	chr1	+	74701070	75010116	TNNI3K	309046	74698570	74703570
NM_001126132	chr19	-	55644065	55660722	TNNT1	16657	55658222	55663222
NM_001276345	chr1	-	201328135	201346828	TNNT2	18693	201344328	201349328
NM_001297646	chr11	+	1940798	1959936	TNNT3	19138	1938298	1943298
NM_002270	chr5	+	72112417	72210215	TNPO1	97798	72109917	72114917
NM_001136195	chr19	-	12810007	12834810	TNPO2	24803	12832310	12837310
NR_034053	chr7	-	128594233	128695227	TNPO3	100994	128692727	128697727
NM_001328635	chr1	-	175291934	175712752	TNR	420818	175710252	175715252
NR_146582	chr2	-	236422383	236426565	TNRC17	4182	236424065	236429065
NM_001080495	chr7	-	5346422	5463177	TNRC18	116755	5460677	5465677
NM_001351850	chr16	+	24621529	24837547	TNRC6A	216018	24619029	24624029
NM_001024843	chr22	+	40440820	40731812	TNRC6B	290992	40438320	40443320
NM_001142640	chr17	+	76000317	76104916	TNRC6C	104599	75997817	76002817
NR_040071	chr17	-	76103482	76107880	TNRC6C-AS1	4398	76105380	76110380
NM_022648	chr2	-	218664511	218808796	TNS1	144285	218806296	218811296
NM_198316	chr12	+	53440809	53458162	TNS2	17353	53438309	53443309
NM_022748	chr7	-	47314751	47621742	TNS3	306991	47619242	47624242
NM_032865	chr17	-	38632079	38657854	TNS4	25775	38655354	38660354
NR_001284	chr6_cox_hap2	-	3479582	3484305	TNXA	4723	3481805	3486805
NM_019105	chr6_cox_hap2	-	3479582	3547813	TNXB	68231	3545313	3550313
NM_001243877	chr17	-	48939586	48945339	TOB1	5753	48942839	48947839
NM_016272	chr22	-	41829491	41843027	TOB2	13536	41840527	41845527
NR_002936	chr6	-	28183115	28186707	TOB2P1	3592	28184207	28189207
NM_025077	chr1	+	45805341	45809650	TOE1	4309	45802841	45807841
NM_015091	chr14	+	45431392	45543634	TOGARAM1	112242	45428892	45433892
NM_199280	chr2	+	29204163	29275096	TOGARAM2	70933	29201663	29206663
NM_019009	chr11	-	1295597	1330892	TOLLIP	35295	1328392	1333392
NM_001135729	chr22	+	35695267	35743987	TOM1	48720	35692767	35697767
NM_001321174	chr17	+	52978051	53039328	TOM1L1	61277	52975551	52980551
NM_001288786	chr17	-	17746821	17875784	TOM1L2	128963	17873284	17878284
NM_014765	chr1	-	235272657	235292256	TOMM20	19599	235289756	235294756
NM_207377	chr14	+	58862643	58875419	TOMM20L	12776	58860143	58865143
NM_020243	chr22	+	39077953	39080766	TOMM22	2813	39075453	39080453
NM_006809	chr20	-	43570770	43589114	TOMM34	18344	43586614	43591614
NM_006114	chr19	+	45394476	45406946	TOMM40	12470	45391976	45396976
NM_032174	chr1	+	161195728	161200536	TOMM40L	4808	161193228	161198228
NM_001134485	chr9	-	37588411	37592636	TOMM5	4225	37590136	37595136
NM_019059	chr7	-	22852250	22862471	TOMM7	10221	22859971	22864971
NM_014820	chr3	-	100082302	100120242	TOMM70	37940	100117742	100122742
NM_013432	chr8	-	145654162	145669812	TONSL	15650	145667312	145672312
NR_109770	chr8	+	145660550	145665276	TONSL-AS1	4726	145658050	145663050
NM_003286	chr20	+	39657457	39753126	TOP1	95669	39654957	39659957
NM_001258447	chr8	-	144391496	144442147	TOP1MT	50651	144439647	144444647
NM_001067	chr17	-	38544772	38574202	TOP2A	29430	38571702	38576702
NM_001330700	chr3	-	25639395	25705990	TOP2B	66595	25703490	25708490
NM_001320759	chr17	-	18174742	18218406	TOP3A	43664	18215906	18220906
NM_001349847	chr22	-	22311396	22337240	TOP3B	25844	22334740	22339740
NM_001145030	chr3	+	44283377	44373590	TOPAZ1	90213	44280877	44285877
NM_007027	chr3	-	133319448	133380737	TOPBP1	61289	133378237	133383237
NM_001195622	chr9	-	32540541	32552626	TOPORS	12085	32550126	32555126
NM_000113	chr9	-	132575220	132586441	TOR1A	11221	132583941	132588941
NM_001267578	chr1	+	179851176	179889212	TOR1AIP1	38036	179848676	179853676
NM_145034	chr1	-	179809101	179846941	TOR1AIP2	37840	179844441	179849441
NM_014506	chr9	+	132565421	132573568	TOR1B	8147	132562921	132567921
NM_001085347	chr9	-	130493802	130497628	TOR2A	3826	130495128	130500128
NM_022371	chr1	+	179051111	179065129	TOR3A	14018	179048611	179053611
NM_017723	chr9	+	140172279	140177093	TOR4A	4814	140169779	140174779
NM_014729	chr8	-	59717976	60031767	TOX	313791	60029267	60034267
NM_001098797	chr20	+	42543491	42698254	TOX2	154763	42540991	42545991
NM_001146188	chr16	-	52470327	52581714	TOX3	111387	52579214	52584214
NM_001303523	chr14	+	21945334	21967321	TOX4	21987	21942834	21947834
NM_001126114	chr17	-	7571719	7590868	TP53	19149	7588368	7593368
NM_001195195	chr11	-	128804626	128813294	TP53AIP1	8668	128810794	128815794
NM_005657	chr15	-	43699411	43802707	TP53BP1	103296	43800207	43805207
NM_001031685	chr1	-	223967594	224033674	TP53BP2	66080	224031174	224036174
NM_001318386	chr11	-	44953898	44972857	TP53I11	18959	44970357	44975357
NM_001346077	chr17	+	27895293	27900175	TP53I13	4882	27892793	27897793
NM_147184	chr2	-	24300302	24308085	TP53I3	7783	24305585	24310585
NM_033285	chr8	-	95938199	95961615	TP53INP1	23416	95959115	95964115
NM_001329429	chr20	+	33292111	33301243	TP53INP2	9132	33289611	33294611
NM_033550	chr20	-	45313003	45318276	TP53RK	5273	45315776	45320776
NR_015381	chr7	-	86954663	86974808	TP53TG1	20145	86972308	86977308
NR_110910	chr16	-	32684848	32687450	TP53TG3	2602	32684950	32689950
NM_001099687	chr16	-	32684848	32687450	TP53TG3B	2602	32684950	32689950
NR_110898	chr16	+	32264644	32267249	TP53TG3D	2605	32262144	32267144
NM_001330061	chr16	-	32684844	32687431	TP53TG3E	2587	32684931	32689931
NM_001330066	chr16	-	32684848	32687430	TP53TG3F	2582	32684930	32689930
NM_014477	chr20	-	44002519	44006957	TP53TG5	4438	44004457	44009457
NM_001329964	chr3	+	189314534	189615068	TP63	300534	189312034	189317034
NM_005427	chr1	+	3569128	3652765	TP73	83637	3566628	3571628
NR_033710	chr1	-	3652547	3663937	TP73-AS1	11390	3661437	3666437
NM_006670	chr6	+	83072922	83077133	TPBG	4211	83070422	83075422
NM_001195528	chr11	+	74951949	74954749	TPBGL	2800	74949449	74954449
NM_017901	chr12	+	113659242	113736389	TPCN1	77147	113656742	113661742
NM_139075	chr11	+	68816349	68858072	TPCN2	41723	68813849	68818849
NM_001287144	chr8	-	80947102	81083894	TPD52	136792	81081394	81086394
NM_001003396	chr6	+	125474874	125585552	TPD52L1	110678	125472374	125477374
NM_001243891	chr20	+	62496580	62522898	TPD52L2	26318	62494080	62499080
NM_001001874	chr9	+	6328348	6331900	TPD52L3	3552	6325848	6330848
NM_033513	chr19	+	507496	519654	TPGS1	12158	504996	509996
NM_001271956	chr18	-	34359987	34409179	TPGS2	49192	34406679	34411679
NM_004179	chr11	-	18042083	18062335	TPH1	20252	18059835	18064835
NM_173353	chr12	+	72332625	72426221	TPH2	93596	72330125	72335125
NM_001159287	chr12	+	6976583	6980110	TPI1	3527	6974083	6979083
NM_022445	chr7	-	144149033	144533146	TPK1	384113	144530646	144535646
NM_001018004	chr15	+	63334837	63364113	TPM1	29276	63332337	63337337
NM_001301226	chr9	-	35681989	35690053	TPM2	8064	35687553	35692553
NM_152263	chr1	-	154134288	154164611	TPM3	30323	154162111	154167111
NR_003148	chr19	+	53935226	53947925	TPM3P9	12699	53932726	53937726
NM_001145160	chr19	+	16178316	16213813	TPM4	35497	16175816	16180816
NM_000367	chr6	-	18128544	18155400	TPMT	26856	18152900	18157900
NM_001206744	chr2	+	1417232	1546499	TPO	129267	1414732	1419732
NM_000391	chr11	-	6633996	6640692	TPP1	6696	6638192	6643192
NM_003291	chr13	+	103249285	103332308	TPP2	83023	103246785	103251785
NM_007030	chr5	-	659976	693510	TPPP	33534	691010	696010
NM_015964	chr16	-	67423709	67427438	TPPP3	3729	67424938	67429938
NM_003292	chr1	-	186280785	186344457	TPR	63672	186341957	186346957
NM_001353003	chr3	-	127290074	127317108	TPRA1	27034	127314608	127319608
NM_198485	chr3	+	188889762	189041271	TPRG1	151509	188887262	188892262
NR_046873	chr3	-	188659503	188665428	TPRG1-AS1	5925	188662928	188667928
NM_182752	chr1	+	3541555	3546694	TPRG1L	5139	3539055	3544055
NM_016058	chr2	-	73956963	73964533	TPRKB	7570	73962033	73967033
NM_001128228	chr9	-	140086068	140095163	TPRN	9095	140092663	140097663
NR_002223	chr3	+	13978806	14107481	TPRXL	128675	13976306	13981306
NM_012467	chr16	-	1271650	1275254	TPSG1	3604	1272754	1277754
NM_003596	chr7	+	65670258	65825438	TPST1	155180	65667758	65672758
NM_003595	chr22	-	26921713	26986089	TPST2	64376	26983589	26988589
NM_003295	chr13	-	45907605	45915419	TPT1	7814	45912919	45917919
NR_024458	chr13	+	45915479	45965618	TPT1-AS1	50139	45912979	45917979
NM_199260	chr21	-	10906186	10990943	TPTE	84757	10988443	10993443
NR_073485	chr13	-	19997018	20135714	TPTE2	138696	20133214	20138214
NR_026730	chr13	-	25502892	25542607	TPTE2P1	39715	25540107	25545107
NR_002793	chr13	+	53063127	53161225	TPTE2P3	98098	53060627	53065627
NR_038259	chr13	-	41371120	41495886	TPTE2P5	124766	41493386	41498386
NR_002815	chr13	+	25154345	25171812	TPTE2P6	17467	25151845	25156845
NR_001591	chr22	+	17082800	17129720	TPTEP1	46920	17080300	17085300
NM_012112	chr20	+	30326903	30389603	TPX2	62700	30324403	30329403
NM_001282758	chr7	-	23544400	23571660	TRA2A	27260	23569160	23574160
NM_004593	chr3	-	185632357	185655924	TRA2B	23567	185653424	185658424
NM_001320485	chr22	+	50624340	50638028	TRABD	13688	50621840	50626840
NM_001277053	chr2	-	85048790	85108369	TRABD2A	59579	85105869	85110869
NM_001194986	chr1	-	48226199	48462562	TRABD2B	236363	48460062	48465062
NM_001323552	chr16	-	67188088	67193812	TRADD	5724	67191312	67196312
NM_001190945	chr9	-	123664670	123691451	TRAF1	26781	123688951	123693951
NM_021138	chr9	+	139780964	139821067	TRAF2	40103	139778464	139783464
NM_003300	chr14	+	103243815	103377837	TRAF3	134022	103241315	103246315
NM_001139490	chr2	+	239229184	239309541	TRAF3IP1	80357	239226684	239231684
NM_001164281	chr6	-	111876580	111927477	TRAF3IP2	50897	111924977	111929977
NR_034109	chr6	+	111804674	111923497	TRAF3IP2-AS1	118823	111802174	111807174
NM_025228	chr1	+	209929376	209955668	TRAF3IP3	26292	209926876	209931876
NM_004295	chr17	+	27071022	27077976	TRAF4	6954	27068522	27073522
NM_004619	chr1	+	211499956	211548286	TRAF5	48330	211497456	211502456
NM_145803	chr11	-	36505316	36531863	TRAF6	26547	36529363	36534363
NM_032271	chr16	+	2205798	2228130	TRAF7	22332	2203298	2208298
NM_006700	chr12	+	112563348	112591408	TRAFD1	28060	112560848	112565848
NM_005879	chr3	-	49866027	49893992	TRAIP	27965	49891492	49896492
NM_001349245	chr3	+	42128691	42267382	TRAK1	138691	42126191	42131191
NM_015049	chr2	-	202241929	202316319	TRAK2	74390	202313819	202318819
NM_014294	chr8	-	71485452	71520694	TRAM1	35242	71518194	71523194
NM_012288	chr6	-	52362199	52441862	TRAM2	79663	52439362	52444362
NR_103446	chr6	+	52441999	52448791	TRAM2-AS1	6792	52439499	52444499
NM_014831	chr3	-	36868307	36986548	TRANK1	118241	36984048	36989048
NM_001272049	chr16	-	3708037	3767598	TRAP1	59561	3765098	3770098
NM_003274	chr21	+	45432205	45526432	TRAPPC10	94227	45429705	45434705
NM_199053	chr4	+	184580419	184634747	TRAPPC11	54328	184577919	184582919
NM_001321102	chr2	+	3383445	3483342	TRAPPC12	99897	3380945	3385945
NM_001243737	chr5	+	64920557	64961954	TRAPPC13	41397	64918057	64923057
NM_001128835	chrX	-	13730360	13752754	TRAPPC2	22394	13750254	13755254
NR_134671	chr16	+	88922627	88929094	TRAPPC2L	6467	88920127	88925127
NM_001270895	chr1	-	36602169	36621654	TRAPPC3	19485	36619154	36624154
NM_001139444	chr6	-	116817650	116866773	TRAPPC3L	49123	116864273	116869273
NM_016146	chr11	+	118889178	118894384	TRAPPC4	5206	118886678	118891678
NM_001270893	chr19	-	45666185	45681501	TRAPPC6A	15316	45679001	45684001
NM_177452	chr14	-	39617014	39639634	TRAPPC6B	22620	39637134	39642134
NM_014939	chr18	-	29409135	29523091	TRAPPC8	113956	29520591	29525591
NM_031466	chr8	-	140739967	141468678	TRAPPC9	728711	141466178	141471178
NM_016388	chr3	+	108541544	108573852	TRAT1	32308	108539044	108544044
NM_004412	chr10	-	17179334	17244070	TRDMT1	64736	17241570	17246570
NM_006073	chr6	-	123537483	123958238	TRDN	420755	123955738	123960738
NM_001301065	chr11	-	118528941	118550381	TREH	21440	118547881	118552881
NR_136332	chr6	-	41235122	41254483	TREM1	19361	41251983	41256983
NM_001271821	chr6	-	41126243	41130924	TREM2	4681	41128424	41133424
NM_001271808	chr6	-	41116998	41122087	TREML1	5089	41119587	41124587
NM_024807	chr6	-	41157486	41168925	TREML2	11439	41166425	41171425
NR_027256	chr6	-	41176291	41185685	TREML3P	9394	41183185	41188185
NM_198153	chr6	+	41196061	41206120	TREML4	10059	41193561	41198561
NM_001297573	chr6	-	42192670	42419789	TRERF1	227119	42417289	42422289
NR_040085	chr7	+	38381177	38418238	TRG-AS1	37061	38378677	38383677
NM_007117	chr3	+	129693235	129696781	TRH	3546	129690735	129695735
NM_013381	chr12	+	72666528	73059422	TRHDE	392894	72664028	72669028
NR_026837	chr12	-	72647286	72667289	TRHDE-AS1	20003	72664789	72669789
NM_003301	chr8	+	110099652	110131812	TRHR	32160	110097152	110102152
NM_025195	chr8	+	126442562	126450647	TRIB1	8085	126440062	126445062
NR_027303	chr2	+	12856997	12882858	TRIB2	25861	12854497	12859497
NM_021158	chr20	+	361272	378203	TRIB3	16931	358772	363772
NM_014817	chr7	-	28992973	28998029	TRIL	5056	28995529	29000529
NM_006778	chr6_mcf_hap5	-	1501606	1510596	TRIM10	8990	1508096	1513096
NM_145214	chr1	-	228581376	228594517	TRIM11	13141	228592017	228597017
NM_052811	chr13	+	50571142	50592603	TRIM13	21461	50568642	50573642
NM_014788	chr9	-	100846634	100881635	TRIM14	35001	100879135	100884135
NM_033229	chr6	+	30130982	30140473	TRIM15	9491	30128482	30133482
NM_001348119	chr17	-	15531279	15587625	TRIM16	56346	15585125	15590125
NM_001353219	chr17	+	18601310	18639432	TRIM16L	38122	18598810	18603810
NM_016102	chr1	-	228595635	228604583	TRIM17	8948	228602083	228607083
NM_001351056	chr4	+	154073493	154260472	TRIM2	186979	154070993	154075993
NM_003141	chr11	-	4406126	4414926	TRIM21	8800	4412426	4417426
NM_006074	chr11	+	5710816	5732093	TRIM22	21277	5708316	5713316
NM_033227	chr5	-	64885506	64920187	TRIM23	34681	64917687	64922687
NM_003852	chr7	+	138145078	138270332	TRIM24	125254	138142578	138147578
NM_005082	chr17	-	54965269	54991409	TRIM25	26140	54988909	54993909
NM_001242783	chr6_qbl_hap6	-	1445146	1474192	TRIM26	29046	1471692	1476692
NM_006510	chr6_cox_hap2	-	393802	414796	TRIM27	20994	412296	417296
NM_005762	chr19	+	59055835	59062082	TRIM28	6247	59053335	59058335
NM_012101	chr11	-	119981993	120008863	TRIM29	26870	120006363	120011363
NM_001248006	chr11	-	6469842	6495689	TRIM3	25847	6493189	6498189
NM_007028	chr6_cox_hap2	-	1582795	1593011	TRIM31	10216	1590511	1595511
NR_126470	chr6_cox_hap2	+	1585138	1594629	TRIM31-AS1	9491	1582638	1587638
NM_012210	chr9	+	119449580	119463579	TRIM32	13999	119447080	119452080
NM_015906	chr1	-	114935398	115053781	TRIM33	118383	115051281	115056281
NM_001003827	chr11	+	5641173	5665625	TRIM34	24452	5638673	5643673
NM_001304495	chr8	-	27142402	27168836	TRIM35	26434	27166336	27171336
NM_001300752	chr5	-	114460458	114516243	TRIM36	55785	114513743	114518743
NM_001005207	chr17	-	57059999	57184325	TRIM37	124326	57181825	57186825
NM_006355	chr6	+	25962916	25987557	TRIM38	24641	25960416	25965416
NM_021253	chr6_qbl_hap6	+	1587514	1604407	TRIM39	16893	1585014	1590014
NM_001199119	chr6_mann_hap4	+	1645156	1662712	TRIM39-RPP21	17556	1642656	1647656
NM_033017	chr7	-	99488029	99517223	TRIM4	29194	99514723	99519723
NM_001286633	chr6_cox_hap2	+	1616018	1628649	TRIM40	12631	1613518	1618518
NM_201627	chr5	+	180650262	180662808	TRIM41	12546	180647762	180652762
NM_152616	chr3	+	140396865	140419992	TRIM42	23127	140394365	140399365
NM_138800	chr2	+	96257765	96265519	TRIM43	7754	96255265	96260265
NM_001164464	chr2	-	96142714	96150479	TRIM43B	7765	96147979	96152979
NM_017583	chr11	+	35684299	35832603	TRIM44	148304	35681799	35686799
NM_001145635	chr1	-	117653676	117664411	TRIM45	10735	117661911	117666911
NR_046327	chr1	+	155146262	155157447	TRIM46	11185	155143762	155148762
NM_033452	chr17	-	73870244	73874656	TRIM47	4412	73872156	73877156
NM_024114	chr11	+	55029657	55038595	TRIM48	8938	55027157	55032157
NM_020358	chr11	-	89530822	89541743	TRIM49	10921	89539243	89544243
NM_001206626	chr11	+	49053151	49059529	TRIM49B	6378	49050651	49055651
NM_001195234	chr11	+	89764273	89775193	TRIM49C	10920	89761773	89766773
NM_001206627	chr11	-	89644639	89650878	TRIM49D1	6239	89648378	89653378
NM_001105522	chr11	-	89644578	89653576	TRIM49D2	8998	89651076	89656076
NM_033034	chr11	-	5684424	5706339	TRIM5	21915	5703839	5708839
NM_178125	chr7	-	72726531	72742085	TRIM50	15554	72739585	72744585
NM_032681	chr11	+	55650772	55659284	TRIM51	8512	55648272	55653272
NR_146921	chr11	-	89714612	89724838	TRIM51EP	10226	89722338	89727338
NR_038174	chr11	-	55061178	55065708	TRIM51HP	4530	55063208	55068208
NM_032765	chr5	-	180682146	180688119	TRIM52	5973	180685619	180690619
NR_102762	chr5	+	180688212	180699308	TRIM52-AS1	11096	180685712	180690712
NR_028346	chr11	+	89575164	89584136	TRIM53AP	8972	89572664	89577664
NM_032546	chr2	+	27505296	27530307	TRIM54	25011	27502796	27507796
NM_033058	chr8	+	67039277	67087718	TRIM55	48441	67036777	67041777
NM_030961	chr7	+	100728719	100735019	TRIM56	6300	100726219	100731219
NM_015431	chr1	+	248020500	248043438	TRIM58	22938	248018e3	248023e3
NM_173084	chr3	-	160153290	160167626	TRIM59	14336	160165126	160170126
NR_148403	chr3	-	159974773	160203535	TRIM59-IFT80	228762	160201035	160206035
NM_058166	chr11	+	5617330	5634188	TRIM6	16858	5614830	5619830
NM_001003819	chr11	+	5617864	5665625	TRIM6-TRIM34	47761	5615364	5620364
NM_152620	chr4	+	165953150	165962896	TRIM60	9746	165950650	165955650
NM_001012414	chr4	-	165875597	165898818	TRIM61	23221	165896318	165901318
NM_018207	chr1	-	33611002	33647671	TRIM62	36669	33645171	33650171
NM_032588	chr1	-	26377795	26394125	TRIM63	16330	26391625	26396625
NM_001136486	chr11	+	89701671	89707240	TRIM64	5569	89699171	89704171
NM_001164397	chr11	-	89603605	89609185	TRIM64B	5580	89606685	89611685
NM_001206631	chr11	-	49075265	49080664	TRIM64C	5399	49078164	49083164
NM_173547	chr17	-	73885040	73893084	TRIM65	8044	73890584	73895584
NM_014818	chr11	-	8633583	8680383	TRIM66	46800	8677883	8682883
NM_001300889	chr1	+	231298673	231357314	TRIM67	58641	231296173	231301173
NM_018073	chr11	-	4619901	4629489	TRIM68	9588	4626989	4631989
NM_001301144	chr15	+	45028559	45060027	TRIM69	31468	45026059	45031059
NM_203293	chr5	-	180620923	180632293	TRIM7	11370	180629793	180634793
NM_001039111	chr3	+	32859509	32939318	TRIM71	79809	32857009	32862009
NM_001008274	chr16	+	31225341	31236510	TRIM72	11169	31222841	31227841
NM_198924	chr7	+	75024902	75034896	TRIM73	9994	75022402	75027402
NM_198853	chr7	-	72430015	72439997	TRIM74	9982	72437497	72442497
NM_001271942	chr11	+	89443466	89451040	TRIM77	7574	89440966	89445966
NM_030912	chr10	+	104404251	104418076	TRIM8	13825	104401751	104406751
NM_015163	chr14	-	51441980	51562422	TRIM9	120442	51559922	51564922
NM_178556	chr4	+	189060594	189068894	TRIML1	8300	189058094	189063094
NM_001303419	chr4	-	189012425	189026741	TRIML2	14316	189024241	189029241
NM_007118	chr5	+	14143810	14510313	TRIO	366503	14141310	14146310
NM_001039141	chr22	+	38092994	38172563	TRIOBP	79569	38090494	38095494
NM_004240	chr19	+	6739692	6751537	TRIP10	11845	6737192	6742192
NM_004239	chr14	-	92432334	92506403	TRIP11	74069	92503903	92508903
NM_001284215	chr2	-	230628552	230786725	TRIP12	158173	230784225	230789225
NM_004237	chr5	+	892968	918164	TRIP13	25196	890468	895468
NR_135855	chr15	+	64680002	64747502	TRIP4	67500	64677502	64682502
NM_003302	chr7	+	100464949	100471076	TRIP6	6127	100462449	100467449
NM_001171799	chr8	-	93895757	93978372	TRIQK	82615	93975872	93980872
NM_001329739	chr19	-	12841453	12845589	TRIR	4136	12843089	12848089
NM_017646	chr1	-	40306705	40349183	TRIT1	42478	40346683	40351683
NM_016481	chr9	-	100666770	100684852	TRMO	18082	100682352	100687352
NM_001136035	chr19	-	13215713	13227585	TRMT1	11872	13225085	13230085
NM_001134665	chr4	-	100467863	100485214	TRMT10A	17351	100482714	100487714
NM_144964	chr9	+	37753799	37778969	TRMT10B	25170	37751299	37756299
NM_017819	chr3	+	101280679	101285290	TRMT10C	4611	101278179	101283179
NR_146797	chr6	+	126307575	126400864	TRMT11	93289	126305075	126310075
NR_135078	chr1	+	100598705	100616054	TRMT13	17349	100596205	100601205
NM_001202423	chr1	-	185087217	185126230	TRMT1L	39013	185123730	185128730
NM_182984	chr22	-	20099388	20104818	TRMT2A	5430	20102318	20107318
NM_001167972	chrX	-	100264333	100307105	TRMT2B	42772	100304605	100309605
NM_001350233	chr4	+	8442523	8478282	TRMT44	35759	8440023	8445023
NM_001350253	chr14	-	61438166	61448408	TRMT5	10242	61445908	61450908
NM_015939	chr20	-	5918478	5931204	TRMT6	12726	5928704	5933704
NM_152307	chr14	+	103995508	104003410	TRMT61A	7902	103993008	103998008
NM_017910	chr2	-	29072687	29093175	TRMT61B	20488	29090675	29095675
NM_001282784	chr22	+	46731297	46753237	TRMU	21940	46728797	46733797
NR_003109	chr1	+	28879528	28905057	TRNAU1AP	25529	28877028	28882028
NM_001013642	chr1	+	27320194	27327377	TRNP1	7183	27317694	27322694
NM_001302946	chr3	+	3168599	3190706	TRNT1	22107	3166099	3171099
NM_177557	chrX	+	54946995	54957866	TRO	10871	54944495	54949495
NM_005480	chr12	+	49716970	49725514	TROAP	8544	49714470	49719470
NM_001042369	chr1	+	193029003	193060906	TROVE2	31903	193026503	193031503
NM_007332	chr8	-	72933485	72987819	TRPA1	54334	72985319	72990319
NM_001251845	chr3	+	142443265	142526729	TRPC1	83464	142440765	142445765
NR_002720	chr11	+	3647689	3658789	TRPC2	11100	3645189	3650189
NM_001130698	chr4	-	122800182	122872909	TRPC3	72727	122870409	122875409
NM_001135958	chr13	-	38210772	38443939	TRPC4	233167	38441439	38446439
NM_199368	chr20	-	33590206	33680618	TRPC4AP	90412	33678118	33683118
NM_012471	chrX	-	111017541	111326004	TRPC5	308463	111323504	111328504
NM_001195576	chrX	+	111119278	111147213	TRPC5OS	27935	111116778	111121778
NM_004621	chr11	-	101322294	101454659	TRPC6	132365	101452159	101457159
NM_001167576	chr5	-	135548998	135701164	TRPC7	152166	135698664	135703664
NR_133682	chr5	+	135562342	135651788	TRPC7-AS2	89446	135559842	135564842
NM_001252020	chr15	-	31293263	31453476	TRPM1	160213	31450976	31455976
NM_003307	chr21	+	45773483	45862964	TRPM2	89481	45770983	45775983
NR_109964	chr21	-	45834474	45845446	TRPM2-AS	10972	45842946	45847946
NM_001007471	chr9	-	73149965	73736514	TRPM3	586549	73734014	73739014
NM_001321283	chr19	+	49660997	49715098	TRPM4	54101	49658497	49663497
NM_014555	chr11	-	2425745	2444275	TRPM5	18530	2441775	2446775
NM_017662	chr9	-	77337410	77503010	TRPM6	165600	77500510	77505510
NM_001301212	chr15	-	50849355	50979012	TRPM7	129657	50976512	50981512
NM_024080	chr2	+	234826042	234928166	TRPM8	102124	234823542	234828542
NM_001282903	chr8	-	116420723	116681255	TRPS1	260532	116678755	116683755
NM_080704	chr17	-	3468739	3512705	TRPV1	43966	3510205	3515205
NM_016113	chr17	+	16318855	16340317	TRPV2	21462	16316355	16321355
NM_001258205	chr17	-	3413795	3461289	TRPV3	47494	3458789	3463789
NM_021625	chr12	-	110220891	110271212	TRPV4	50321	110268712	110273712
NM_019841	chr7	-	142605266	142630820	TRPV5	25554	142628320	142633320
NM_018646	chr7	-	142568955	142583490	TRPV6	14535	142580990	142585990
NM_003496	chr7	+	98476112	98610866	TRRAP	134754	98473612	98478612
NM_139169	chr10	+	116697951	116737439	TRUB1	39488	116695451	116700451
NM_015679	chr9	-	131071378	131085059	TRUB2	13681	131082559	131087559
NR_036483	chr7	-	141968100	141972068	TRY2P	3968	141969568	141974568
NM_144627	chr1	+	156307104	156316785	TSACC	9681	156304604	156309604
NM_000368	chr9	-	135766734	135820020	TSC1	53286	135817520	135822520
NM_001318827	chr16	+	2097895	2138721	TSC2	40826	2095395	2100395
NM_001243799	chr13	-	45006278	45150701	TSC22D1	144423	45148201	45153201
NR_038381	chr13	+	45150031	45154568	TSC22D1-AS1	4537	45147531	45152531
NM_014779	chr3	+	150126121	150177905	TSC22D2	51784	150123621	150128621
NM_001318468	chrX	-	106956451	107019218	TSC22D3	62767	107016718	107021718
NR_130119	chr7	-	100064141	100076902	TSC22D4	12761	100074402	100079402
NM_001300766	chr1	+	184020784	184043344	TSEN15	22560	184018284	184023284
NM_001321278	chr3	+	12525930	12581123	TSEN2	55193	12523430	12528430
NM_001282333	chr19	+	54694118	54698394	TSEN34	4276	54691618	54696618
NM_207346	chr17	+	73512608	73520820	TSEN54	8212	73510108	73515108
NM_001172697	chr12	+	58176527	58196639	TSFM	20112	58174027	58179027
NR_015362	chr6	+	94416800	94486199	TSG1	69399	94414300	94419300
NM_006292	chr11	-	18501857	18548503	TSG101	46646	18546003	18551003
NM_001349013	chr2	-	99613723	99771429	TSGA10	157706	99768929	99773929
NM_152762	chr11	+	65713114	65727434	TSGA10IP	14320	65710614	65715614
NM_001304968	chr7	-	130353485	130372268	TSGA13	18783	130369768	130374768
NM_000549	chr1	+	115572444	115576930	TSHB	4486	115569944	115574944
NM_000369	chr14	+	81421868	81612646	TSHR	190778	81419368	81424368
NM_005786	chr18	+	72922709	73001905	TSHZ1	79196	72920209	72925209
NM_173485	chr20	+	51588945	52111869	TSHZ2	522924	51586445	51591445
NR_138036	chr19	-	31640775	31840431	TSHZ3	199656	31837931	31842931
NR_003255	chrX	+	73012039	73049066	TSIX	37027	73009539	73014539
NM_021733	chr19	-	50243010	50266515	TSKS	23505	50264015	50269015
NM_001258210	chr11	+	76493356	76509198	TSKU	15842	76490856	76495856
NR_122122	chr7	+	27655592	27667111	TSL	11519	27653092	27658092
NR_045089	chr5	+	110405777	110413722	TSLP	7945	110403277	110408277
NM_004622	chr2	+	122513120	122525428	TSN	12308	122510620	122515620
NM_145003	chr8	-	143293440	143484610	TSNARE1	191170	143482110	143487110
NM_005999	chr1	+	231664398	231702269	TSNAX	37871	231661898	231666898
NR_028393	chr1	+	231664398	232177019	TSNAX-DISC1	512621	231661898	231666898
NM_001288990	chr16	+	67840667	67861971	TSNAXIP1	21304	67838167	67843167
NM_005727	chr1	+	46640748	46651634	TSPAN1	10886	46638248	46643248
NM_001290212	chr17	+	79604196	79615785	TSPAN10	11589	79601696	79606696
NM_001080509	chr12	+	31079837	31149537	TSPAN11	69700	31077337	31082337
NM_012338	chr7	-	120427373	120498177	TSPAN12	70804	120495677	120500677
NM_014399	chr7	+	16793350	16824161	TSPAN13	30811	16790850	16795850
NM_001128309	chr10	+	82214020	82282386	TSPAN14	68366	82211520	82216520
NM_001351263	chr10	+	71211222	71267425	TSPAN15	56203	71208722	71213722
NM_012466	chr19	+	11406814	11437672	TSPAN16	30858	11404314	11409314
NM_012171	chr5	+	176074387	176086059	TSPAN17	11672	176071887	176076887
NM_130783	chr11	+	44785975	44953977	TSPAN18	168002	44783475	44788475
NM_001100917	chr12	-	85408093	85430055	TSPAN19	21962	85427555	85432555
NM_001308316	chr1	-	115590632	115632121	TSPAN2	41489	115629621	115634621
NM_001168412	chr15	-	77336359	77363570	TSPAN3	27211	77361070	77366070
NM_005981	chr12	+	58138771	58142026	TSPAN31	3255	58136271	58141271
NM_139022	chr11	+	2323242	2339430	TSPAN32	16188	2320742	2325742
NM_178562	chr7	+	128784711	128809535	TSPAN33	24824	128782211	128787211
NM_003271	chr11	+	842823	867116	TSPAN4	24293	840323	845323
NM_005723	chr4	-	99391517	99579812	TSPAN5	188295	99577312	99582312
NM_001278743	chrX	-	99882104	99892101	TSPAN6	9997	99889601	99894601
NM_004615	chrX	+	38420730	38548172	TSPAN7	127442	38418230	38423230
NM_004616	chr12	-	71518876	71551779	TSPAN8	32903	71549279	71554279
NM_006675	chr12	+	3186520	3395730	TSPAN9	209210	3184020	3189020
NM_001272037	chr21	-	45917774	46131495	TSPEAR	213721	46128995	46133995
NR_103707	chr21	+	45925926	45936458	TSPEAR-AS1	10532	45923426	45928426
NM_000714	chr22	+	43547519	43559248	TSPO	11729	43545019	43550019
NM_004758	chr17	-	56378587	56406152	TSPOAP1	27565	56403652	56408652
NR_038410	chr17	+	56402810	56431088	TSPOAP1-AS1	28278	56400310	56405310
NM_001320964	chrY	+	9175072	9177887	TSPY1	2815	9172572	9177572
NM_001320962	chrY	+	9175072	9177887	TSPY10	2815	9172572	9177572
NM_022573	chrY	+	6114263	6117053	TSPY2	2790	6111763	6116763
NM_001077697	chrY	+	9236029	9238826	TSPY3	2797	9233529	9238529
NM_001164471	chrY	+	9236075	9368285	TSPY4	132210	9233575	9238575
NM_001243721	chrY	+	9195451	9198202	TSPY8	2751	9192951	9197951
NM_003309	chr6	-	116596021	116601280	TSPYL1	5259	116598780	116603780
NM_022117	chrX	+	53111541	53117728	TSPYL2	6187	53109041	53114041
NM_021648	chr6	-	116571130	116575261	TSPYL4	4131	116572761	116577761
NM_033512	chr8	-	98285713	98290176	TSPYL5	4463	98287676	98292676
NM_001003937	chr2	-	54480314	54483409	TSPYL6	3095	54480909	54485909
NM_018128	chr17	-	2225981	2240678	TSR1	14697	2238178	2243178
NM_058163	chrX	+	54466807	54474460	TSR2	7653	54464307	54469307
NM_001001410	chr16	-	1399240	1401873	TSR3	2633	1399373	1404373
NR_024248	chr11	+	3402190	3430378	TSSC2	28188	3399690	3404690
NM_005706	chr11	+	2421717	2425108	TSSC4	3391	2419217	2424217
NM_001308067	chr14	+	24674856	24677454	TSSK4	2598	24672356	24677356
NM_001270483	chr22	-	37406899	37416224	TST	9325	37413724	37418724
NM_003313	chr8	-	144694787	144699732	TSTA3	4945	144697232	144702232
NM_139246	chr9	-	100362361	100395962	TSTD2	33601	100393462	100398462
NM_001195131	chr6	+	99968869	99981059	TSTD3	12190	99966369	99971369
NM_032538	chr6	+	43211417	43255997	TTBK1	44580	43208917	43213917
NM_173500	chr15	-	43036541	43213007	TTBK2	176466	43210507	43215507
NM_001282500	chr5	+	159436106	159492552	TTC1	56446	159433606	159438606
NR_147891	chr11	+	113185250	113244018	TTC12	58768	113182750	113187750
NM_024525	chr1	-	231041986	231114618	TTC13	72632	231112118	231117118
NM_001288582	chr3	+	180319917	180336135	TTC14	16218	180317417	180322417
NM_001317037	chr9	+	130478342	130493879	TTC16	15537	130475842	130480842
NM_018259	chr11	+	43380434	43516483	TTC17	136049	43377934	43382934
NM_001271420	chr17	+	15902693	15932723	TTC19	30030	15900193	15905193
NM_145755	chr3	+	39149151	39180394	TTC21A	31243	39146651	39151651
NM_024753	chr2	-	166729871	166810348	TTC21B	80477	166807848	166812848
NR_038984	chr2	+	166790366	166804831	TTC21B-AS1	14465	166787866	166792866
NM_001114108	chr1	-	55246751	55266941	TTC22	20190	55264441	55269441
NM_001288616	chr15	-	99676527	99791431	TTC23	114904	99788931	99793931
NM_001317949	chr5	+	34839728	34900606	TTC23L	60878	34837228	34842228
NM_001105669	chr1	+	156551156	156557518	TTC24	6362	156548656	156553656
NR_110662	chr17	+	40086846	40118535	TTC25	31689	40084346	40089346
NM_001287513	chr7	+	138818489	138876732	TTC26	58243	138815989	138820989
NM_017735	chr2	+	32853086	33046118	TTC27	193032	32850586	32855586
NM_001145418	chr22	-	28374001	29075853	TTC28	701852	29073353	29078353
NR_026963	chr22	+	28315363	28398667	TTC28-AS1	83304	28312863	28317863
NM_031956	chr4	-	147627789	147867038	TTC29	239249	147864538	147869538
NM_001330681	chr21	+	38445483	38575419	TTC3	129936	38442983	38447983
NR_046651	chr21	-	38559912	38566227	TTC3-AS1	6315	38563727	38568727
NM_152275	chr2	-	178479025	178483694	TTC30A	4669	178481194	178486194
NM_152517	chr2	-	178414880	178417524	TTC30B	2644	178415024	178420024
NM_022492	chr2	+	74710199	74721691	TTC31	11492	74707699	74712699
NM_001008237	chr2	-	20096391	20101747	TTC32	5356	20099247	20104247
NM_012382	chr5	-	40711677	40756072	TTC33	44395	40753572	40758572
NM_001242672	chr1	-	2572806	2706230	TTC34	133424	2703730	2708730
NM_001346097	chr11	+	118398147	118401912	TTC36	3765	118395647	118400647
NM_014639	chr5	-	94799598	94890709	TTC37	91111	94888209	94893209
NM_017931	chr22	+	46663860	46689905	TTC38	26045	46661360	46666360
NM_001144832	chr1	-	51752929	51810788	TTC39A	57859	51808288	51813288
NM_152574	chr9	-	15170841	15307358	TTC39B	136517	15304858	15309858
NM_153211	chr18	+	21572736	21715574	TTC39C	142838	21570236	21575236
NR_110796	chr18	-	21574178	21595424	TTC39C-AS1	21246	21592924	21597924
NR_030737	chrX	-	74960372	74962914	TTC3P1	2542	74960414	74965414
NM_004623	chr1	+	55181494	55208328	TTC4	26834	55178994	55183994
NR_027249	chr12	-	104237526	104323989	TTC41P	86463	104321489	104326489
NM_138376	chr14	-	20757300	20774153	TTC5	16853	20771653	20776653
NM_001310135	chr14	+	38064403	38311830	TTC6	247427	38061903	38066903
NM_001288953	chr2	+	47143267	47303275	TTC7A	160008	47140767	47145767
NM_001320421	chr14	-	91006931	91282761	TTC7B	275830	91280261	91285261
NM_144596	chr14	+	89290496	89344340	TTC8	53844	89287996	89292996
NM_015351	chr14	+	71108503	71142077	TTC9	33574	71106003	71111003
NM_001318812	chr11	+	62495544	62506108	TTC9C	10564	62493044	62498044
NR_134525	chr9	-	135250934	135282238	TTF1	31304	135279738	135284738
NM_003594	chr1	+	117602948	117645491	TTF2	42543	117600448	117605448
NM_014657	chr20	-	36611408	36661870	TTI1	50462	36659370	36664370
NM_001330505	chr8	-	33355982	33370710	TTI2	14728	33368210	33373210
NM_003318	chr6	+	80714321	80752244	TTK	37923	80711821	80716821
NM_153712	chr2	+	113239742	113290222	TTL	50480	113237242	113242242
NR_027779	chr22	-	43435522	43485434	TTLL1	49912	43482934	43487934
NM_001130045	chr1	+	1109285	1133313	TTLL10	24028	1106785	1111785
NM_001139442	chr9	-	124584203	124855885	TTLL11	271682	124853385	124858385
NM_015140	chr22	-	43562627	43583137	TTLL12	20510	43580637	43585637
NR_104604	chr15	+	90792763	90802320	TTLL13P	9557	90790263	90795263
NM_031949	chr6	+	167738573	167756177	TTLL2	17604	167736073	167741073
NR_037162	chr3	+	9851643	9878040	TTLL3	26397	9849143	9854143
NM_014640	chr2	+	219575567	219620138	TTLL4	44571	219573067	219578067
NM_015072	chr14	+	76127550	76421425	TTLL5	293875	76125050	76130050
NM_001130918	chr17	-	46839592	46894469	TTLL6	54877	46891969	46896969
NM_001350214	chr1	-	84330714	84464870	TTLL7	134156	84462370	84467370
NM_001350317	chr22	-	50457003	50496656	TTLL8	39653	50494156	50499156
NR_134519	chr20	+	30458504	30532762	TTLL9	74258	30456004	30461004
NM_133437	chr2	-	179390716	179672150	TTN	281434	179669650	179674650
NR_038271	chr2	+	179387917	179484944	TTN-AS1	97027	179385417	179390417
NM_000370	chr8	-	63972047	63998612	TTPA	26565	63996112	64001112
NM_024331	chr20	+	43104525	43123244	TTPAL	18719	43102025	43107025
NM_000371	chr18	+	29171729	29178986	TTR	7257	29169229	29174229
NR_001538	chrY	+	6258441	6279605	TTTY1	21164	6255941	6260941
NR_001542	chrY	-	22627553	22681114	TTTY10	53561	22678614	22683614
NR_001548	chrY	-	8651358	8685423	TTTY11	34065	8682923	8687923
NR_001551	chrY	+	7672964	7678723	TTTY12	5759	7670464	7675464
NR_001537	chrY	-	23745485	23756552	TTTY13	11067	23754052	23759052
NR_125733	chrY	-	21034386	21239433	TTTY14	205047	21236933	21241933
NR_001545	chrY	+	14774297	14804153	TTTY15	29856	14771797	14776797
NR_003589	chrY	+	6258441	6279605	TTTY1B	21164	6255941	6260941
NR_001536	chrY	-	6274284	6296485	TTTY2	22201	6293985	6298985
NR_001546	chrY	-	9167488	9172441	TTTY20	4953	9169941	9174941
NR_001535	chrY	+	6311474	6315118	TTTY21	3644	6308974	6313974
NR_003588	chrY	+	6311474	6315118	TTTY21B	3644	6308974	6313974
NR_001539	chrY	+	9638761	9650854	TTTY22	12093	9636261	9641261
NR_003590	chrY	-	6274284	6296485	TTTY2B	22201	6293985	6298985
NR_001524	chrY	+	27874636	27879535	TTTY3	4899	27872136	27877136
NR_002176	chrY	+	27874636	27879535	TTTY3B	4899	27872136	27877136
NR_001525	chrY	+	25082601	25119431	TTTY4	36830	25080101	25085101
NR_002178	chrY	+	25082601	25119431	TTTY4B	36830	25080101	25085101
NR_002177	chrY	+	25082601	25119431	TTTY4C	36830	25080101	25085101
NR_001534	chrY	+	6317508	6325947	TTTY7	8439	6315008	6320008
NR_003592	chrY	+	6317508	6325947	TTTY7B	8439	6315008	6320008
NR_001533	chrY	-	6339071	6341671	TTTY8	2600	6339171	6344171
NR_003591	chrY	-	6339071	6341671	TTTY8B	2600	6339171	6344171
NR_001530	chrY	-	20743091	20752407	TTTY9A	9316	20749907	20754907
NR_002159	chrY	-	20743091	20752407	TTTY9B	9316	20749907	20754907
NM_001201461	chr19	+	54926604	54947899	TTYH1	21295	54924104	54929104
NM_032646	chr17	+	72209695	72258157	TTYH2	48462	72207195	72212195
NM_025250	chr7	+	2671602	2704436	TTYH3	32834	2669102	2674102
NM_003320	chr11	+	8060179	8127654	TUB	67475	8057679	8062679
NR_120538	chr11	+	8081584	8090920	TUB-AS1	9336	8079084	8084084
NM_001270400	chr12	-	49578577	49583107	TUBA1A	4530	49580607	49585607
NM_006082	chr12	-	49521566	49525304	TUBA1B	3738	49522804	49527804
NM_001303114	chr12	+	49621708	49667121	TUBA1C	45413	49619208	49624208
NM_006001	chr13	-	19747909	19755992	TUBA3C	8083	19753492	19758492
NM_080386	chr2	+	132233579	132240507	TUBA3D	6928	132231079	132236079
NM_207312	chr2	-	130949317	130956034	TUBA3E	6717	130953534	130958534
NR_003608	chr22	-	21362495	21368576	TUBA3FP	6081	21366076	21371076
NM_001278552	chr2	-	220114432	220119330	TUBA4A	4898	220116830	220121830
NR_003063	chr2	+	220117964	220136910	TUBA4B	18946	220115464	220120464
NM_001193414	chr22	+	18593452	18614498	TUBA8	21046	18590952	18595952
NM_001171864	chr10	-	5435060	5446793	TUBAL3	11733	5444293	5449293
NM_178014	chr6_qbl_hap6	+	1980908	1986135	TUBB	5227	1978408	1983408
NM_030773	chr20	+	57594308	57601709	TUBB1	7401	57591808	57596808
NM_001310315	chr6	-	3153900	3157783	TUBB2A	3883	3155283	3160283
NM_178012	chr6	-	3224494	3227968	TUBB2B	3474	3225468	3230468
NM_001197181	chr16	+	89988416	90002505	TUBB3	14089	89985916	89990916
NM_001289127	chr19	-	6494329	6502859	TUBB4A	8530	6500359	6505359
NM_001303525	chr18	+	12308057	12329824	TUBB6	21767	12305557	12310557
NR_027156	chr9	+	141044564	141071885	TUBBP5	27321	141042064	141047064
NM_016261	chr17	-	57936840	57970306	TUBD1	33466	57967806	57972806
NM_016262	chr6	-	112391859	112408751	TUBE1	16892	112406251	112411251
NM_001070	chr17	+	40761357	40767256	TUBG1	5899	40758857	40763857
NM_016437	chr17	+	40811265	40819024	TUBG2	7759	40808765	40813765
NR_046330	chr10	-	135092133	135125841	TUBGCP2	33708	135123341	135128341
NM_006322	chr13	-	113139318	113242499	TUBGCP3	103181	113239999	113244999
NM_001286414	chr15	+	43663256	43699296	TUBGCP4	36040	43660756	43665756
NM_052903	chr15	+	22833394	22873891	TUBGCP5	40497	22830894	22835894
NM_020461	chr22	-	50656117	50683400	TUBGCP6	27283	50680900	50685900
NM_003321	chr16	-	28853731	28857729	TUFM	3998	28855229	28860229
NM_001126337	chr1	+	151512780	151556059	TUFT1	43279	151510280	151515280
NR_110493	chr22	+	31365196	31375380	TUG1	10184	31362696	31367696
NM_003322	chr6	-	35465650	35480715	TULP1	15065	35478215	35483215
NM_003323	chr19	-	49384221	49401996	TULP2	17775	49399496	49404496
NM_003324	chr12	+	3000032	3050306	TULP3	50274	2997532	3002532
NM_020245	chr6	+	158733691	158932856	TULP4	199165	158731191	158736191
NR_132399	chr14	+	96342728	96391908	TUNAR	49180	96340228	96345228
NM_007275	chr3	-	50362339	50365669	TUSC2	3330	50363169	50368169
NM_006765	chr8	+	15397595	15624158	TUSC3	226563	15395095	15400095
NM_172367	chr17	+	1182956	1204281	TUSC5	21325	1180456	1185456
NR_015391	chr3	+	116428634	116435887	TUSC7	7253	116426134	116431134
NR_104174	chr13	-	44974385	44980120	TUSC8	5735	44977620	44982620
NM_022830	chr11	-	62342516	62359109	TUT1	16593	62356609	62361609
NR_134901	chr16	-	10854775	10912651	TVP23A	57876	10910151	10915151
NM_016078	chr17	+	18684307	18710026	TVP23B	25719	18681807	18686807
NM_145301	chr17	-	15405577	15466945	TVP23C	61368	15464445	15469445
NM_001204478	chr17	-	15339331	15466945	TVP23C-CDRT4	127614	15464445	15469445
NR_073472	chr12	-	44187525	44200178	TWF1	12653	44197678	44202678
NM_007284	chr3	-	52262625	52273183	TWF2	10558	52270683	52275683
NM_001271893	chr2	+	239756672	239832244	TWIST2	75572	239754172	239759172
NM_001002926	chr7	-	19735084	19748660	TWISTNB	13576	19746160	19751160
NM_001163812	chr10	+	102747292	102754158	TWNK	6866	102744792	102749792
NM_020648	chr18	+	9334764	9402418	TWSG1	67654	9332264	9337264
NM_003328	chr4	-	48068409	48136273	TXK	67864	48133773	48138773
NM_175852	chr1	+	32645344	32663886	TXLNA	18542	32642844	32647844
NM_153235	chr6	-	139561198	139613208	TXLNB	52010	139610708	139615708
NM_018360	chrX	+	16804554	16862642	TXLNG	58088	16802054	16807054
NR_045128	chrY	+	21729243	21769056	TXLNGY	39813	21726743	21731743
NM_003329	chr9	-	113006091	113018920	TXN	12829	113016420	113021420
NM_012473	chr22	-	36863092	36877687	TXN2	14595	36875187	36880187
NM_001324022	chr16	-	11772935	11836734	TXNDC11	63799	11834234	11839234
NM_015913	chr1	-	52485803	52521843	TXNDC12	36040	52519343	52524343
NM_024715	chr5	+	134209459	134237323	TXNDC15	27864	134206959	134211959
NM_020784	chr14	-	52897307	53019301	TXNDC16	121994	53016801	53021801
NM_032731	chr17	+	6544221	6547861	TXNDC17	3640	6541721	6546721
NM_030810	chr6	-	7881746	7911047	TXNDC5	29301	7908547	7913547
NM_001003936	chr9	-	113065866	113100164	TXNDC8	34298	113097664	113102664
NM_005783	chr2	-	99935486	99952860	TXNDC9	17374	99950360	99955360
NM_006472	chr1	+	145438437	145442644	TXNIP	4207	145435937	145440937
NM_004786	chr18	-	54270052	54305920	TXNL1	35868	54303420	54308420
NM_001305564	chr18	-	77732866	77793935	TXNL4A	61069	77791435	77796435
NM_001142318	chr16	-	72118755	72128215	TXNL4B	9460	72125715	72130715
NM_001093771	chr12	+	104609556	104744085	TXNRD1	134529	104607056	104612056
NM_006440	chr22	-	19863040	19929515	TXNRD2	66475	19927015	19932015
NM_052883	chr3	-	126325894	126373967	TXNRD3	48073	126371467	126376467
NM_001039783	chr3	-	126290621	126327398	TXNRD3NB	36777	126324898	126329898
NM_003331	chr19	-	10461203	10491248	TYK2	30045	10488748	10493748
NM_001113755	chr22	-	50964180	50968514	TYMP	4334	50966014	50971014
NM_001071	chr18	+	657603	673499	TYMS	15896	655103	660103
NM_001012716	chr18	-	649619	658340	TYMSOS	8721	655840	660840
NM_000372	chr11	+	88911039	89028927	TYR	117888	88908539	88913539
NM_006293	chr15	+	41851219	41871536	TYRO3	20317	41848719	41853719
NM_003332	chr19	-	36395302	36399211	TYROBP	3909	36396711	36401711
NM_000550	chr9	+	12693385	12710266	TYRP1	16881	12690885	12695885
NR_073592	chr10	-	71897736	71906496	TYSND1	8760	71903996	71908996
NM_018264	chr7	+	66461791	66704507	TYW1	242716	66459291	66464291
NM_001145440	chr7	-	72039491	72298813	TYW1B	259322	72296313	72301313
NM_001162916	chr1	+	75198835	75232360	TYW3	33525	75196335	75201335
NR_004862	chr2	-	200793633	200820459	TYW5	26826	200817959	200822959
NM_006758	chr21	-	44513065	44527688	U2AF1	14623	44525188	44530188
NM_144987	chr19	-	36233427	36236343	U2AF1L4	2916	36233843	36238843
NM_001320648	chr21	-	44513065	44527716	U2AF1L5	14651	44525216	44530216
NM_001012478	chr19	+	56165415	56186082	U2AF2	20667	56162915	56167915
NM_001320222	chr3	+	142720371	142779567	U2SURP	59196	142717871	142722871
NM_018003	chr15	-	70946892	71055932	UACA	109040	71053432	71058432
NM_001324117	chr1	+	162531229	162569633	UAP1	38404	162528729	162533729
NM_207309	chr9	+	139971952	139978990	UAP1L1	7038	139969452	139974452
NM_153280	chrX	+	47050198	47074527	UBA1	24329	47047698	47052698
NM_005499	chr19	+	34919267	34960798	UBA2	41531	34916767	34921767
NM_003968	chr3	-	69103880	69129524	UBA3	25644	69127024	69132024
NM_198329	chr3	+	132373289	132396951	UBA5	23662	132370789	132375789
NM_001321017	chr19	+	18682539	18688270	UBA52	5731	18680039	18685039
NM_018227	chr4	-	68481478	68566889	UBA6	85411	68564389	68569389
NR_015439	chr4	+	68566995	68588222	UBA6-AS1	21227	68564495	68569495
NM_003335	chr3	-	49842637	49851391	UBA7	8754	49848891	49853891
NM_016172	chr9	-	138824814	138853226	UBAC1	28412	138850726	138855726
NM_001144072	chr13	+	99852678	100038753	UBAC2	186075	99850178	99855178
NR_036531	chr13	-	99848627	99853011	UBAC2-AS1	4384	99850511	99855511
NM_145253	chr16	-	4658883	4664927	UBALD1	6044	4662427	4667427
NM_182565	chr17	+	74261285	74267379	UBALD2	6094	74258785	74263785
NM_001171204	chr9	+	34179002	34252521	UBAP1	73519	34176502	34181502
NM_001163692	chr15	-	65385341	65398697	UBAP1L	13356	65396197	65401197
NM_001282529	chr9	-	33921690	34048947	UBAP2	127257	34046447	34051447
NM_001287816	chr1	+	154193324	154243986	UBAP2L	50662	154190824	154195824
NM_001001895	chr21	+	43823970	43867790	UBASH3A	43820	43821470	43826470
NM_032873	chr11	+	122526397	122685187	UBASH3B	158790	122523897	122528897
NM_021009	chr12	-	125396190	125399587	UBC	3397	125397087	125402087
NM_006398	chr6_apd_hap1	-	826900	831215	UBD	4315	828715	833715
NM_003336	chrX	+	118708429	118718392	UBE2A	9963	118705929	118710929
NM_003337	chr5	+	133706866	133727799	UBE2B	20933	133704366	133709366
NM_181800	chr20	+	44441214	44445596	UBE2C	4382	44438714	44443714
NM_001204880	chr10	+	60094738	60130513	UBE2D1	35775	60092238	60097238
NM_181838	chr5	+	138940750	139008018	UBE2D2	67268	138938250	138943250
NM_181890	chr4	-	103715539	103790050	UBE2D3	74511	103787550	103792550
NM_015983	chr7	+	43966034	43995735	UBE2D4	29701	43963534	43968534
NM_182666	chr3	+	23847383	23933131	UBE2E1	85748	23844883	23849883
NR_046652	chr3	-	23845514	23848396	UBE2E1-AS1	2882	23845896	23850896
NM_152653	chr3	+	23244783	23632296	UBE2E2	387513	23242283	23247283
NR_136176	chr3	-	23236560	23244484	UBE2E2-AS1	7924	23241984	23246984
NM_001278555	chr2	+	181845111	181928154	UBE2E3	83043	181842611	181847611
NR_103498	chr2	+	238875586	238951423	UBE2F	75837	238873086	238878086
NR_037904	chr2	+	238875586	239008054	UBE2F-SCLY	132468	238873086	238878086
NM_003342	chr17	-	4172511	4269969	UBE2G1	97458	4267469	4272469
NM_001202489	chr21	-	46188494	46221751	UBE2G2	33257	46219251	46224251
NM_003344	chr7	-	129470572	129592800	UBE2H	122228	129590300	129595300
NM_194261	chr16	+	1359153	1377019	UBE2I	17866	1356653	1361653
NM_016021	chr6	-	90036343	90062619	UBE2J1	26276	90060119	90065119
NM_194458	chr1	-	1189291	1209234	UBE2J2	19943	1206734	1211734
NM_005339	chr4	+	39699663	39784410	UBE2K	84747	39697163	39702163
NM_001256355	chr22	+	21903735	21978323	UBE2L3	74588	21901235	21906235
NM_198183	chr11	-	57319127	57335803	UBE2L6	16676	57333303	57338303
NM_003969	chr19	-	59067078	59070343	UBE2M	3265	59067843	59072843
NM_003348	chr12	-	93802087	93836026	UBE2N	33939	93833526	93838526
NM_022066	chr17	-	74385612	74449288	UBE2O	63676	74446788	74451788
NM_017582	chr1	-	154521050	154531120	UBE2Q1	10070	154528620	154533620
NM_173469	chr15	+	76135626	76193388	UBE2Q2	57762	76133126	76138126
NM_001243531	chr15	+	84841241	84850985	UBE2Q2L	9744	84838741	84843741
NR_003661	chr15	-	85070426	85114026	UBE2Q2P1	43600	85111526	85116526
NR_004847	chr15	+	83023840	83084341	UBE2Q2P2	60501	83021340	83026340
NM_001145161	chr5	+	6448735	6496834	UBE2QL1	48099	6446235	6451235
NM_017811	chr9	+	33817181	33920401	UBE2R2	103220	33814681	33819681
NM_014501	chr19	-	55912649	55919325	UBE2S	6676	55916825	55921825
NM_001310326	chr1	-	202300784	202311094	UBE2T	10310	202308594	202313594
NM_152489	chr1	+	64669300	64711957	UBE2U	42657	64666800	64671800
NM_001282575	chr20	-	48697660	48732496	UBE2V1	34836	48729996	48734996
NM_003350	chr8	+	48920994	48974454	UBE2V2	53460	48918494	48923494
NM_001271015	chr8	-	74692331	74791145	UBE2W	98814	74788645	74793645
NM_023079	chr17	+	46985730	47006422	UBE2Z	20692	46983230	46988230
NM_130839	chr15	-	25582395	25684175	UBE3A	101780	25681675	25686675
NM_130466	chr12	+	109915427	109974510	UBE3B	59083	109912927	109917927
NM_014671	chr7	+	156931654	157062066	UBE3C	130412	156929154	156934154
NM_001304437	chr6	-	83602116	83775560	UBE3D	173444	83773060	83778060
NM_001204077	chr11	+	118230295	118269926	UBE4A	39631	118227795	118232795
NM_006048	chr1	+	10093040	10241296	UBE4B	148256	10090540	10095540
NM_019116	chr16	+	23568861	23585710	UBFD1	16849	23566361	23571361
NM_001330350	chr1	+	11333254	11359628	UBIAD1	26374	11330754	11335754
NM_007106	chr13	-	30338544	30424820	UBL3	86276	30422320	30427320
NM_014235	chrX	-	153712055	153715009	UBL4A	2954	153712509	153717509
NM_001286739	chr15	-	74738317	74753529	UBL7	15212	74751029	74756029
NR_038448	chr15	+	74753605	74773633	UBL7-AS1	20028	74751105	74756105
NM_145049	chr5	+	158690074	158713048	UBLCP1	22974	158687574	158692574
NM_001079514	chr16	+	4897631	4932402	UBN1	34771	4895131	4900131
NM_173569	chr7	+	138916230	138992982	UBN2	76752	138913730	138918730
NM_001267584	chr20	-	3088218	3140556	UBOX5	52338	3138056	3143056
NR_038395	chr20	+	3087556	3131513	UBOX5-AS1	43957	3085056	3090056
NM_001128161	chr3	-	33429828	33481897	UBP1	52069	33479397	33484397
NM_013438	chr9	-	86274877	86323168	UBQLN1	48291	86320668	86325668
NM_013444	chrX	+	56590025	56593443	UBQLN2	3418	56587525	56592525
NM_017481	chr11	-	5528529	5531215	UBQLN3	2686	5528715	5533715
NM_020131	chr1	-	156005084	156023616	UBQLN4	18532	156021116	156026116
NM_174916	chr15	-	43235097	43398286	UBR1	163189	43395786	43400786
NM_015255	chr6	+	42531759	42661243	UBR2	129484	42529259	42534259
NM_172070	chr2	+	170684017	170940639	UBR3	256622	170681517	170686517
NM_020765	chr1	-	19400999	19536746	UBR4	135747	19534246	19539246
NM_015902	chr8	-	103264501	103424917	UBR5	160416	103422417	103427417
NR_125415	chr8	+	103251678	103264402	UBR5-AS1	12724	103249178	103254178
NR_038150	chr14	+	93673400	93695561	UBR7	22161	93670900	93675900
NM_024954	chr10	+	99258638	99330967	UBTD1	72329	99256138	99261138
NM_152277	chr5	-	171636649	171710795	UBTD2	74146	171708295	171713295
NR_045058	chr17	-	42282400	42298994	UBTF	16594	42296494	42301494
NM_001286078	chr11	-	62443969	62446589	UBXN1	2620	62444089	62449089
NM_152376	chr1	+	20512570	20522541	UBXN10	9971	20510070	20515070
NM_145345	chr1	-	26608772	26644756	UBXN11	35984	26642256	26647256
NM_181713	chr2	+	24163375	24223693	UBXN2A	60318	24160875	24165875
NM_001077619	chr8	+	59323822	59364060	UBXN2B	40238	59321322	59326322
NM_014607	chr2	+	136499188	136542633	UBXN4	43445	136496688	136501688
NM_025241	chr19	-	4445002	4457791	UBXN6	12789	4455291	4460291
NM_015562	chr3	-	196080368	196159345	UBXN7	78977	196156845	196161845
NM_005671	chr8	+	30601681	30624520	UBXN8	22839	30599181	30604181
NR_015379	chr19	+	15939756	15947131	UCA1	7375	15937256	15942256
NM_004181	chr4	+	41258897	41270446	UCHL1	11549	41256397	41261397
NR_102709	chr4	-	41222090	41258744	UCHL1-AS1	36654	41256244	41261244
NM_001270952	chr13	+	76123615	76180156	UCHL3	56541	76121115	76126115
NM_001350844	chr1	-	192981382	193029237	UCHL5	47855	193026737	193031737
NM_001135954	chr9	-	134399182	134406662	UCK1	7480	134404162	134409162
NM_012474	chr1	+	165796731	165880855	UCK2	84124	165794231	165799231
NR_126526	chr20	-	62571181	62587800	UCKL1	16619	62585300	62590300
NR_027287	chr20	+	62584736	62588338	UCKL1-AS1	3602	62582236	62587236
NM_001303118	chr10	-	13263765	13276328	UCMA	12563	13273828	13278828
NM_053049	chr10	+	5406971	5416655	UCN3	9684	5404471	5409471
NM_021833	chr4	-	141481049	141489959	UCP1	8910	141487459	141492459
NM_003355	chr11	-	73685715	73693889	UCP2	8174	73691389	73696389
NM_003356	chr11	-	73711325	73720282	UCP3	8957	73717782	73722782
NM_001261386	chr11	-	18552949	18610293	UEVLD	57344	18607793	18612793
NM_016406	chr1	+	161123533	161128646	UFC1	5113	161121033	161126033
NM_005659	chr22	-	19437463	19466738	UFD1	29275	19464238	19469238
NM_015323	chr6	+	96969701	97003151	UFL1	33450	96967201	96972201
NM_001286705	chr13	+	38923907	38937144	UFM1	13237	38921407	38926407
NR_028085	chr4	-	186320693	186347139	UFSP2	26446	186344639	186349639
NR_027378	chr8	+	63890419	63897460	UG0898H09	7041	63887919	63892919
NM_003358	chr9	+	114659045	114697654	UGCG	38609	114656545	114661545
NM_001184700	chr4	-	39500374	39529218	UGDH	28844	39526718	39531718
NR_047679	chr4	+	39529458	39596327	UGDH-AS1	66869	39526958	39531958
NM_020120	chr2	+	128848753	128953249	UGGT1	104496	128846253	128851253
NM_020121	chr13	-	96453835	96705736	UGGT2	251901	96703236	96708236
NM_001001521	chr2	+	64068097	64118696	UGP2	50599	64065597	64070597
NM_000463	chr2	+	234668918	234681945	UGT1A1	13027	234666418	234671418
NM_019075	chr2	+	234545122	234681951	UGT1A10	136829	234542622	234547622
NM_019093	chr2	+	234637772	234681945	UGT1A3	44173	234635272	234640272
NM_007120	chr2	+	234627437	234681945	UGT1A4	54508	234624937	234629937
NM_019078	chr2	+	234621637	234681945	UGT1A5	60308	234619137	234624137
NM_205862	chr2	+	234600320	234681945	UGT1A6	81625	234597820	234602820
NM_019077	chr2	+	234590583	234681945	UGT1A7	91362	234588083	234593083
NM_019076	chr2	+	234526290	234681945	UGT1A8	155655	234523790	234528790
NM_021027	chr2	+	234580543	234681951	UGT1A9	101408	234578043	234583043
NM_001252274	chr4	-	70454134	70518967	UGT2A1	64833	70516467	70521467
NM_001105677	chr4	-	70454134	70505360	UGT2A2	51226	70502860	70507860
NR_024010	chr4	-	69794176	69817509	UGT2A3	23333	69815009	69820009
NM_001075	chr4	+	69681710	69697735	UGT2B10	16025	69679210	69684210
NM_001073	chr4	-	70065907	70080449	UGT2B11	14542	70077949	70082949
NM_001076	chr4	-	69512314	69536494	UGT2B15	24180	69533994	69538994
NM_001077	chr4	-	69402902	69434245	UGT2B17	31343	69431745	69436745
NM_001207004	chr4	+	70146216	70160768	UGT2B28	14552	70143716	70148716
NM_001297616	chr4	-	70345882	70391732	UGT2B4	45850	70389232	70394232
NM_001349568	chr4	+	69916981	69978705	UGT2B7	61724	69914481	69919481
NM_001171873	chr5	-	35960857	36001130	UGT3A1	40273	35998630	36003630
NM_001168316	chr5	-	36035118	36067023	UGT3A2	31905	36064523	36069523
NM_001322113	chr4	+	115519557	115599381	UGT8	79824	115517057	115522057
NM_001184763	chr1	+	162466963	162499419	UHMK1	32456	162464463	162469463
NM_001290050	chr19	+	4903091	4962165	UHRF1	59074	4900591	4905591
NM_017754	chr6	+	34759793	34845291	UHRF1BP1	85498	34757293	34762293
NM_015054	chr12	-	100430862	100536642	UHRF1BP1L	105780	100534142	100539142
NR_046386	chr9	+	6413150	6507051	UHRF2	93901	6410650	6415650
NM_001199298	chr5	-	176332005	176433795	UIMC1	101790	176431295	176436295
NM_001317089	chr6	+	150285109	150294849	ULBP1	9740	150282609	150287609
NM_025217	chr6	+	150263073	150270368	ULBP2	7295	150260573	150265573
NM_024518	chr6	-	150382181	150390283	ULBP3	8102	150387783	150392783
NM_003565	chr12	+	132379278	132407707	ULK1	28429	132376778	132381778
NM_014683	chr17	-	19674142	19771239	ULK2	97097	19768739	19773739
NR_104308	chr15	-	75128456	75135552	ULK3	7096	75133052	75138052
NR_136342	chr3	-	41288089	42003932	ULK4	715843	42001432	42006432
NR_026858	chr15	-	32698811	32727250	ULK4P1	28439	32724750	32729750
NR_027470	chr15	-	32698811	32727250	ULK4P2	28439	32724750	32729750
NR_026859	chr15	-	32698800	32727065	ULK4P3	28265	32724565	32729565
NM_001302349	chr7	+	7680266	7918851	UMAD1	238585	7677766	7682766
NM_003361	chr16	-	20344372	20364200	UMOD	19828	20361700	20366700
NM_001199527	chr21	+	43483067	43563105	UMODL1	80038	43480567	43485567
NR_027243	chr21	-	43522243	43528644	UMODL1-AS1	6401	43526144	43531144
NR_033434	chr3	+	124449212	124468119	UMPS	18907	124446712	124451712
NM_001330166	chr17	-	26873724	26879681	UNC119	5957	26877181	26882181
NM_001080533	chr12	+	121148237	121161443	UNC119B	13206	121145737	121150737
NM_001080421	chr19	-	17712136	17799008	UNC13A	86872	17796508	17801508
NM_001330653	chr9	+	35161965	35405335	UNC13B	243370	35159465	35164465
NM_001329919	chr15	+	54270376	54920806	UNC13C	650430	54267876	54272876
NM_199242	chr17	-	73823307	73840798	UNC13D	17491	73838298	73843298
NM_001039675	chr15	+	91473409	91497323	UNC45A	23914	91470909	91475909
NM_001267052	chr17	+	33474835	33516364	UNC45B	41529	33472335	33477335
NM_014044	chr2	+	99225010	99234977	UNC50	9967	99222510	99227510
NM_133369	chr5	+	176237559	176307899	UNC5A	70340	176235059	176240059
NM_170744	chr10	+	72972291	73062635	UNC5B	90344	72969791	72974791
NM_003728	chr4	-	96083655	96470361	UNC5C	386706	96467861	96472861
NM_173561	chr6	-	40994639	41006938	UNC5CL	12299	41004438	41009438
NM_080872	chr8	+	35092974	35654068	UNC5D	561094	35090474	35095474
NM_020818	chr14	+	93799564	94174222	UNC79	374658	93797064	93802064
NM_032504	chr2	+	210636716	210864024	UNC80	227308	210634216	210639216
NM_001143947	chr6	+	167704802	167729502	UNC93A	24700	167702302	167707302
NM_030930	chr11	-	67758570	67771595	UNC93B1	13025	67769095	67774095
NM_001080461	chr7	+	1272653	1276613	UNCX	3960	1270153	1275153
NM_080911	chr12	+	109535398	109548798	UNG	13400	109532898	109537898
NM_001080419	chr17	+	73780919	73821886	UNK	40967	73778419	73783419
NM_001193388	chr16	-	1413205	1464721	UNKL	51516	1462221	1467221
NR_024280	chr9	+	92254697	92334674	UNQ6494	79977	92252197	92257197
NR_003927	chr1	-	84830640	84850484	UOX	19844	84847984	84852984
NM_016327	chr22	+	24891250	24922553	UPB1	31303	24888750	24893750
NM_001297549	chr19	+	18942743	18979041	UPF1	36298	18940243	18945243
NM_080599	chr10	-	11962020	12085169	UPF2	123149	12082669	12087669
NM_080687	chr13	+	115047058	115071291	UPF3A	24233	115044558	115049558
NM_023010	chrX	-	118967988	118986991	UPF3B	19003	118984491	118989491
NM_007000	chr19	+	36157417	36169387	UPK1A	11970	36154917	36159917
NR_046420	chr19	-	36158849	36164193	UPK1A-AS1	5344	36161693	36166693
NM_006952	chr3	+	118892424	118924000	UPK1B	31576	118889924	118894924
NM_006953	chr22	+	45680867	45691755	UPK3A	10888	45678367	45683367
NM_182683	chr7	+	76139739	76157199	UPK3B	17460	76137239	76142239
NM_001114403	chr7	-	102277471	102283238	UPK3BL1	5767	102280738	102285738
NM_001287426	chr7	+	48128199	48148330	UPP1	20131	48125699	48130699
NM_001135098	chr2	+	158851690	158992666	UPP2	140976	158849190	158854190
NM_145052	chrX	+	74493893	74524732	UPRT	30839	74491393	74496393
NM_018244	chr20	-	33890368	33999945	UQCC1	109577	33997445	34002445
NM_032340	chr6	-	33664537	33679528	UQCC2	14991	33677028	33682028
NM_013387	chr22	+	30163357	30166402	UQCR10	3045	30160857	30165857
NM_006830	chr19	-	1597153	1605483	UQCR11	8330	1602983	1607983
NR_045639	chr8	-	97238903	97247862	UQCRB	8959	97245362	97250362
NM_003365	chr3	-	48636431	48647098	UQCRC1	10667	48644598	48649598
NM_003366	chr16	+	21964384	21994981	UQCRC2	30597	21961884	21966884
NM_006003	chr19	-	29698166	29704136	UQCRFS1	5970	29701636	29706636
NM_001297565	chr1	+	46769284	46782449	UQCRH	13165	46766784	46771784
NM_001105577	chr13	-	28552242	28562774	URAD	10532	28560274	28565274
NR_027335	chr16	-	90106168	90114033	URAHP	7865	90111533	90116533
NM_014825	chr21	-	33683329	33765312	URB1	81983	33762812	33767812
NM_014777	chr1	+	229761962	229795947	URB2	33985	229759462	229764462
NM_001290076	chr7	-	43915492	43966010	URGCP	50518	43963510	43968510
NM_001204871	chr7	-	43906156	43946231	URGCP-MRPS24	40075	43943731	43948731
NM_001252641	chr19	+	30414550	30507519	URI1	92969	30412050	30417050
NR_049743	chr9	+	131133597	131154295	URM1	20698	131131097	131136097
NM_144639	chr3	-	126200007	126236616	UROC1	36609	126234116	126239116
NR_036510	chr1	+	45477804	45481341	UROD	3537	45475304	45480304
NR_136677	chr10	-	127473550	127511837	UROS	38287	127509337	127514337
NM_001330568	chr16	+	58033502	58055522	USB1	22020	58031002	58036002
NM_018467	chr19	+	17326154	17330638	USE1	4484	17323654	17328654
NM_007122	chr1	-	161009040	161015769	USF1	6729	161013269	161018269
NM_001321150	chr19	+	35759880	35770724	USF2	10844	35757380	35762380
NR_111981	chr3	-	113367232	113415493	USF3	48261	113412993	113417993
NR_123738	chr11	-	17515441	17565963	USH1C	50522	17563463	17568463
NM_001282489	chr17	-	72912175	72919358	USH1G	7183	72916858	72921858
NM_206933	chr1	-	215796235	216596738	USH2A	800503	216594238	216599238
NR_135632	chr19	-	17360829	17375605	USHBP1	14776	17373105	17378105
NM_032747	chr10	-	105148808	105156270	USMG5	7462	105153770	105158770
NM_003715	chr4	+	76649705	76735442	USO1	85737	76647205	76652205
NM_001017415	chr1	+	62901974	62917475	USP1	15501	62899474	62904474
NR_073578	chr16	+	84733554	84813527	USP10	79973	84731054	84736054
NM_004651	chrX	+	47092313	47107727	USP11	15414	47089813	47094813
NM_182488	chr13	-	27640286	27746033	USP12	105747	27743533	27748533
NR_046547	chr13	+	27699669	27743272	USP12-AS1	43603	27697169	27702169
NR_046548	chr13	+	27746395	27757640	USP12-AS2	11245	27743895	27748895
NM_003940	chr3	+	179370932	179507189	USP13	136257	179368432	179373432
NM_005151	chr18	+	158482	213739	USP14	55257	155982	160982
NM_001252078	chr12	+	62654120	62803501	USP15	149381	62651620	62656620
NM_006447	chr21	+	30396937	30426807	USP16	29870	30394437	30399437
NM_017414	chr22	+	18632757	18660162	USP18	27405	18630257	18635257
NM_001199162	chr3	-	49145478	49158371	USP19	12893	49155871	49160871
NM_004205	chr11	-	119225924	119252436	USP2	26512	119249936	119254936
NR_034160	chr11	+	119252487	119369944	USP2-AS1	117457	119249987	119254987
NM_006676	chr9	+	132597695	132644117	USP20	46422	132595195	132600195
NM_012475	chr1	+	161129253	161135516	USP21	6263	161126753	161131753
NM_015276	chr17	-	20902905	20946352	USP22	43447	20943852	20948852
NM_015306	chr1	-	55532031	55681039	USP24	149008	55678539	55683539
NM_001283041	chr21	+	17102252	17252390	USP25	150138	17099752	17104752
NM_031907	chrX	-	132159506	132162300	USP26	2794	132159800	132164800
NM_001145073	chrX	+	49644469	49647168	USP27X	2699	49641969	49646969
NR_026742	chrX	-	49641326	49643959	USP27X-AS1	2633	49641459	49646459
NM_001301029	chr11	-	113668596	113746292	USP28	77696	113743792	113748792
NM_020903	chr19	+	57631508	57643293	USP29	11785	57629008	57634008
NR_046342	chr15	+	63796709	63886839	USP3	90130	63794209	63799209
NR_034080	chr15	-	63879908	63893026	USP3-AS1	13118	63890526	63895526
NM_001301175	chr12	+	109460893	109525831	USP30	64938	109458393	109463393
NM_020718	chr16	-	23072727	23160591	USP31	87864	23158091	23163091
NM_032582	chr17	-	58254690	58469586	USP32	214896	58467086	58472086
NR_003190	chr17	+	16690205	16707819	USP32P1	17614	16687705	16692705
NR_003554	chr17	-	18414575	18424566	USP32P2	9991	18422066	18427066
NR_146076	chr17	+	20313828	20336381	USP32P3	22553	20311328	20316328
NM_201624	chr1	-	78161673	78225564	USP33	63891	78223064	78228064
NM_014709	chr2	-	61414589	61697849	USP34	283260	61695349	61700349
NM_020798	chr11	+	77899857	77926278	USP35	26421	77897357	77902357
NM_001321291	chr17	-	76791733	76836609	USP36	44876	76834109	76839109
NM_020935	chr2	-	219314973	219433084	USP37	118111	219430584	219435584
NM_032557	chr4	+	144106069	144145027	USP38	38958	144103569	144108569
NR_046347	chr2	+	85829964	85876407	USP39	46443	85827464	85832464
NM_003363	chr3	-	49314576	49377536	USP4	62960	49375036	49380036
NM_018218	chr2	-	234384164	234474236	USP40	90072	234471736	234476736
NM_032172	chr7	+	6144549	6201195	USP42	56646	6142049	6147049
NM_153210	chr17	+	9548853	9633003	USP43	84150	9546353	9551353
NM_032147	chr12	-	95910335	95945266	USP44	34931	95942766	95947766
NM_001346022	chr6	-	99880181	99963365	USP45	83184	99960865	99965865
NM_022832	chr4	-	53457126	53525502	USP46	68376	53523002	53528002
NM_001282659	chr11	+	11862969	11980872	USP47	117903	11860469	11865469
NM_001330394	chr1	-	22005071	22109692	USP48	104621	22107192	22112192
NM_018561	chr6	-	41765382	41863099	USP49	97717	41860599	41865599
NM_001098536	chr12	+	6961284	6975795	USP5	14511	6958784	6963784
NM_203494	chr15	-	50792758	50838902	USP50	46144	50836402	50841402
NM_201286	chrX	-	55511048	55515631	USP51	4583	55513131	55518131
NM_019050	chr4	+	120133781	120216673	USP53	82892	120131281	120136281
NM_001350995	chr10	-	75257295	75385817	USP54	128522	75383317	75388317
NM_001304284	chr17	+	5019732	5078326	USP6	58594	5017232	5022232
NM_014688	chr10	-	11502508	11653788	USP6NL	151280	11651288	11656288
NM_003470	chr16	-	8985950	9057341	USP7	71391	9054841	9059841
NM_001128610	chr15	+	50716573	50793280	USP8	76707	50714073	50719073
NM_001039591	chrX	+	40944887	41095832	USP9X	150945	40942387	40947387
NM_004654	chrY	+	14813159	14972768	USP9Y	159609	14810659	14815659
NM_001321533	chr13	+	31191815	31234907	USPL1	43092	31189315	31194315
NM_005715	chr6	+	149068270	149398126	UST	329856	149065770	149070770
NR_038408	chr6	-	149275396	149285820	UST-AS1	10424	149283320	149288320
NR_110227	chr2	-	105713509	105719402	UTAT33	5893	105716902	105721902
NM_016037	chr1	+	38478383	38490497	UTP11	12114	38475883	38480883
NM_006649	chrX	+	129040096	129063738	UTP14A	23642	129037596	129042596
NM_021645	chr13	+	52598826	52607736	UTP14C	8910	52596326	52601326
NM_032175	chr5	+	72861565	72879202	UTP15	17637	72859065	72864065
NM_016001	chr17	+	49337896	49375292	UTP18	37396	49335396	49340396
NM_014503	chr12	+	101673904	101780397	UTP20	106493	101671404	101676404
NM_032334	chr8	+	117778741	117786921	UTP23	8180	117776241	117781241
NM_001318391	chr16	+	69166498	69202937	UTP4	36439	69163998	69168998
NM_018428	chr17	-	30190189	30228729	UTP6	38540	30226229	30231229
NM_007124	chr6	+	144612872	145174170	UTRN	561298	144610372	144615372
NM_021995	chr1	-	7907671	7913551	UTS2	5880	7911051	7916051
NM_198152	chr3	-	190984943	191048325	UTS2B	63382	191045825	191050825
NM_001258250	chrY	-	15360258	15592550	UTY	232292	15590050	15595050
NM_003369	chr11	+	75526211	75855282	UVRAG	329071	75523711	75528711
NM_001317934	chr4	+	1341053	1381837	UVSSA	40784	1338553	1343553
NM_025076	chr2	-	106709758	106810795	UXS1	101037	106808295	106813295
NM_153477	chrX	-	47511190	47518579	UXT	7389	47516079	47521079
NM_001351157	chr16	-	70721341	70835079	VAC14	113738	70832579	70837579
NR_034083	chr16	+	70788962	70807154	VAC14-AS1	18192	70786462	70791462
NM_016830	chr12	-	6571403	6580065	VAMP1	8662	6577565	6582565
NM_014232	chr17	-	8062464	8066293	VAMP2	3829	8063793	8068793
NM_004781	chr1	+	7831328	7841492	VAMP3	10164	7828828	7833828
NM_003762	chr1	-	171669295	171711379	VAMP4	42084	171708879	171713879
NM_006634	chr2	+	85811530	85820511	VAMP5	8981	85809030	85814030
NM_005638	chrX	+	155110942	155173433	VAMP7	62491	155108442	155113442
NM_003761	chr2	+	85804613	85809156	VAMP8	4543	85802113	85807113
NM_001172411	chr1	+	116184573	116240845	VANGL1	56272	116182073	116187073
NM_020335	chr1	+	160370363	160398468	VANGL2	28105	160367863	160372863
NM_194434	chr18	+	9913954	9960018	VAPA	46064	9911454	9916454
NR_036633	chr20	+	56964174	57026156	VAPB	61982	56961674	56966674
NM_006295	chr6	-	31745296	31763712	VARS	18416	31761212	31766212
NM_020442	chr6_dbb_hap3	+	2176096	2188360	VARS2	12264	2173596	2178596
NM_014909	chr14	+	77228234	77249363	VASH1	21129	77225734	77230734
NR_104184	chr14	-	77248075	77253067	VASH1-AS1	4992	77250567	77255567
NM_001136475	chr1	+	213123861	213164927	VASH2	41066	213121361	213126361
NM_138440	chr16	+	4421848	4433529	VASN	11681	4419348	4424348
NM_003370	chr19	+	46010687	46030240	VASP	19553	46008187	46013187
NM_006373	chr17	-	41166621	41174459	VAT1	7838	41171959	41176959
NM_020927	chr16	+	77822460	78014004	VAT1L	191544	77819960	77824960
NM_005428	chr19	+	6772678	6857377	VAV1	84699	6770178	6775178
NM_003371	chr9	-	136627015	136857446	VAV2	230431	136854946	136859946
NM_006113	chr1	-	108113781	108507545	VAV3	393764	108505045	108510045
NR_046653	chr1	+	108507064	108537229	VAV3-AS1	30165	108504564	108509564
NM_199131	chr10	-	118888031	118897812	VAX1	9781	118895312	118900312
NM_012476	chr2	+	71127719	71160575	VAX2	32856	71125219	71130219
NM_001303544	chrX	+	154425283	154468122	VBP1	42839	154422783	154427783
NM_080682	chr1	+	101185195	101204601	VCAM1	19406	101182695	101187695
NM_001164098	chr5	+	82767492	82878122	VCAN	110630	82764992	82769992
NR_136215	chr5	-	82827170	82858133	VCAN-AS1	30963	82855633	82860633
NM_014000	chr10	+	75757871	75879914	VCL	122043	75755371	75760371
NM_007126	chr9	-	35056064	35072739	VCP	16675	35070239	35075239
NM_025054	chr8	-	67542487	67579452	VCPIP1	36965	67576952	67581952
NM_024558	chr14	-	50575349	50583297	VCPKMT	7948	50580797	50585797
NM_003374	chr5	-	133307565	133340824	VDAC1	33259	133338324	133343324
NM_001184823	chr10	+	76969911	76991207	VDAC2	21296	76967411	76972411
NM_005662	chr8	+	42249278	42263455	VDAC3	14177	42246778	42251778
NM_000376	chr12	-	48235319	48298814	VDR	63495	48296314	48301314
NM_003376	chr6	+	43737945	43754223	VEGFA	16278	43735445	43740445
NM_003377	chr11	+	64002055	64006736	VEGFB	4681	63999555	64004555
NM_005429	chr4	-	177604684	177713899	VEGFC	109215	177711399	177716399
NM_004469	chrX	-	15363712	15402535	VEGFD	38823	15400035	15405035
NM_014468	chr10	+	135051407	135055434	VENTX	4027	135048907	135053907
NR_001559	chrX	+	26576453	26579169	VENTXP1	2716	26573953	26578953
NM_001167911	chr3	-	156977531	157221136	VEPH1	243605	157218636	157223636
NM_001330393	chr17	-	56048907	56065625	VEZF1	16718	56063125	56068125
NR_038242	chr12	+	95611521	95696566	VEZT	85045	95609021	95614021
NM_003378	chr7	-	100805789	100808852	VGF	3063	100806352	100811352
NM_016267	chrX	+	135614310	135638966	VGLL1	24656	135611810	135616810
NM_153453	chr6	+	117586720	117594728	VGLL2	8008	117584220	117589220
NM_001320494	chr3	-	86987118	87040273	VGLL3	53155	87037773	87042773
NM_001284390	chr3	-	11597540	11762242	VGLL4	164702	11759742	11764742
NM_000551	chr3	+	10183318	10195354	VHL	12036	10180818	10185818
NM_007127	chr2	+	219283837	219314248	VIL1	30411	219281337	219286337
NM_015873	chr3	+	38035077	38048676	VILL	13599	38032577	38037577
NM_003380	chr10	+	17270257	17279592	VIM	9335	17267757	17272757
NR_108061	chr10	-	17256237	17271984	VIM-AS1	15747	17269484	17274484
NM_194435	chr6	+	153071931	153080902	VIP	8971	153069431	153074431
NM_001193315	chr14	-	77893017	77923983	VIPAS39	30966	77921483	77926483
NM_001251882	chr3	+	42530790	42579065	VIPR1	48275	42528290	42533290
NM_003382	chr7	-	158820865	158937649	VIPR2	116784	158935149	158940149
NM_015496	chr8	-	95500004	95565746	VIRMA	65742	95563246	95568246
NM_001328661	chr2	+	36923832	37041937	VIT	118105	36921332	36926332
NM_001311311	chr16	-	31102162	31106320	VKORC1	4158	31103820	31108820
NM_173517	chr7	+	65338085	65424550	VKORC1L1	86465	65335585	65340585
NM_001322226	chr9	+	2621773	2656103	VLDLR	34330	2619273	2624273
NR_015375	chr9	-	2535654	2622373	VLDLR-AS1	86719	2619873	2624873
NM_001017980	chrX	+	150565656	150577836	VMA21	12180	150563156	150568156
NM_001017921	chr19	+	5904851	5910263	VMAC	5412	5902351	5907351
NM_001329400	chr17	+	57784825	57919616	VMP1	134791	57782325	57787325
NM_004666	chr6	-	133001996	133035194	VNN1	33198	133032694	133037694
NM_078488	chr6	-	133065008	133084598	VNN2	19590	133082098	133087098
NM_001291702	chr6	-	133043925	133055904	VNN3	11979	133053404	133058404
NM_001321244	chr7	-	55538300	55640213	VOPP1	101913	55637713	55642713
NM_001290185	chr11	+	118938462	118952688	VPS11	14226	118935962	118940962
NM_033305	chr9	+	79792360	80032399	VPS13A	240039	79789860	79794860
NM_017890	chr8	+	100025493	100889814	VPS13B	864321	100022993	100027993
NM_020821	chr15	-	62144589	62352664	VPS13C	208075	62350164	62355164
NM_015378	chr1	+	12290095	12572098	VPS13D	282003	12287595	12292595
NM_022575	chr20	+	2821342	2847378	VPS16	26036	2818842	2823842
NM_020857	chr15	+	41186627	41196173	VPS18	9546	41184127	41189127
NM_032353	chr17	+	40925453	40931618	VPS25	6165	40922953	40927953
NM_004896	chr10	+	70883908	70934172	VPS26A	50264	70881408	70886408
NM_052875	chr11	+	134094498	134117686	VPS26B	23188	134091998	134096998
NM_016208	chr8	-	145648983	145653946	VPS28	4963	145651446	145656446
NR_104102	chr12	-	110929327	110939945	VPS29	10618	110937445	110942445
NM_001351020	chr12	-	122714107	122751370	VPS33A	37263	122748870	122753870
NM_018668	chr15	-	91541645	91565851	VPS33B	24206	91563351	91568351
NM_018206	chr16	-	46691890	46723144	VPS35	31254	46720644	46725644
NM_016075	chr13	-	52986736	53024813	VPS36	38077	53022313	53027313
NM_001145152	chr8	+	17104400	17155533	VPS37A	51133	17101900	17106900
NM_024667	chr12	-	123349874	123380712	VPS37B	30838	123378212	123383212
NM_017966	chr11	-	60897727	60928916	VPS37C	31189	60926416	60931416
NM_001077621	chr7	+	73082173	73086440	VPS37D	4267	73079673	73084673
NM_001301138	chr15	-	42450898	42500524	VPS39	49626	42498024	42503024
NM_080631	chr7	-	38763542	38948800	VPS41	185258	38946300	38951300
NM_001279353	chr1	+	150039349	150117505	VPS45	78156	150036849	150041849
NM_013245	chr16	+	69345286	69358946	VPS4A	13660	69342786	69347786
NM_004869	chr18	-	61056424	61089752	VPS4B	33328	61087252	61092252
NM_001257998	chr7	+	92861652	92990435	VPS50	128783	92859152	92864152
NM_013265	chr11	+	64863586	64879332	VPS51	15746	64861086	64866086
NM_022553	chr6_qbl_hap6	-	4450267	4471978	VPS52	21711	4469478	4474478
NM_001128159	chr17	-	411907	618096	VPS53	206189	615596	620596
NM_016516	chr2	-	64119666	64246214	VPS54	126548	64243714	64248714
NM_005997	chr1	-	151148775	151162689	VPS72	13914	151160189	151165189
NM_001009921	chr3	+	184529930	184770402	VPS8	240472	184527430	184532430
NM_004913	chr16	-	89773540	89787394	VPS9D1	13854	89784894	89789894
NR_036480	chr16	+	89778263	89784573	VPS9D1-AS1	6310	89775763	89780763
NM_003384	chr14	+	97263683	97347951	VRK1	84268	97261183	97266183
NM_001288837	chr2	+	58134785	58387055	VRK2	252270	58132285	58137285
NM_016440	chr19	-	50479723	50528805	VRK3	49082	50526305	50531305
NM_018228	chr14	+	74815165	74826711	VRTN	11546	74812665	74817665
NM_182607	chrX	+	107288199	107322414	VSIG1	34215	107285699	107290699
NM_019086	chr12	-	118501397	118541810	VSIG10	40413	118539310	118544310
NM_001163922	chr19	-	51834794	51845378	VSIG10L	10584	51842878	51847878
NM_014312	chr11	-	124617367	124622168	VSIG2	4801	124619668	124624668
NM_001257403	chrX	-	65241579	65259967	VSIG4	18388	65257467	65262467
NM_001013661	chr1	-	159824105	159832447	VSIG8	8342	159829947	159834947
NM_022153	chr10	-	73507313	73533337	VSIR	26024	73530837	73535837
NM_003385	chr2	+	17721806	17837706	VSNL1	115900	17719306	17724306
NM_001288791	chr19	-	54544079	54567207	VSTM1	23128	54564707	54569707
NM_001301009	chr7	+	54610017	54638773	VSTM2A	28756	54607517	54612517
NR_038994	chr7	+	54624662	54639419	VSTM2A-OT1	14757	54622162	54627162
NM_001146339	chr19	+	30017490	30055226	VSTM2B	37736	30014990	30019990
NM_080607	chr20	+	36531498	36573747	VSTM2L	42249	36528998	36533998
NM_001031746	chr10	-	50222289	50323577	VSTM4	101288	50321077	50326077
NM_001144871	chr11	-	93553734	93583668	VSTM5	29934	93581168	93586168
NM_001256272	chr20	-	25051520	25063015	VSX1	11495	25060515	25065515
NM_182894	chr14	+	74706174	74729441	VSX2	23267	74703674	74708674
NM_001286372	chr6	+	142468298	142542085	VTA1	73787	142465798	142470798
NR_045604	chr1	-	117686208	117753582	VTCN1	67374	117751082	117756082
NM_001318203	chr10	+	114206745	114578503	VTI1A	371758	114204245	114209245
NM_006370	chr14	-	68117866	68141602	VTI1B	23736	68139102	68144102
NM_000638	chr17	-	26694298	26697373	VTN	3075	26694873	26699873
NM_022834	chr1	+	1370902	1378262	VWA1	7360	1368402	1373402
NM_001272046	chr10	+	115999012	116054259	VWA2	55247	115996512	116001512
NM_173615	chr16	+	22103858	22168287	VWA3A	64429	22101358	22106358
NM_144992	chr2	+	98703594	98929410	VWA3B	225816	98701094	98706094
NM_014622	chr11	+	123986110	124017618	VWA5A	31508	123983610	123988610
NM_001039500	chr1	+	20617411	20681387	VWA5B1	63976	20614911	20619911
NM_138345	chr3	+	183948216	183960117	VWA5B2	11901	183945716	183950716
NM_025258	chr6	-	31733370	31745108	VWA7	11738	31742608	31747608
NM_015058	chr13	-	42140960	42535221	VWA8	394261	42532721	42537721
NR_039974	chr13	+	42535304	42555701	VWA8-AS1	20397	42532804	42537804
NR_136188	chr7	+	49814928	49961546	VWC2	146618	49812428	49817428
NM_001080500	chr2	+	215276291	215443676	VWC2L	167385	215273791	215278791
NR_047698	chr2	+	215374905	215401613	VWC2L-IT1	26708	215372405	215377405
NM_152718	chr11	-	61025757	61062788	VWCE	37031	61060288	61065288
NM_001346973	chr7	-	12370510	12443567	VWDE	73057	12441067	12446067
NM_000552	chr12	-	6058039	6233841	VWF	175802	6231341	6236341
NM_100264	chr10	+	28821516	28912041	WAC	90525	28819016	28824016
NR_033805	chr10	-	28808845	28821283	WAC-AS1	12438	28818783	28823783
NM_001318328	chr10	-	88195012	88281541	WAPL	86529	88279041	88284041
NM_173701	chr14	-	100800124	100842680	WARS	42556	100840180	100845180
NM_201263	chr1	-	119573838	119683295	WARS2	109457	119680795	119685795
NR_126447	chr1	+	119590027	119605910	WARS2-IT1	15883	119587527	119592527
NM_000377	chrX	+	48542185	48549817	WAS	7632	48539685	48544685
NM_003931	chr6	-	110421021	110501207	WASF1	80186	110498707	110503707
NM_006990	chr1	-	27730729	27816698	WASF2	85969	27814198	27819198
NM_006646	chr13	+	27131839	27263082	WASF3	131243	27129339	27134339
NR_024077	chr2	+	114341229	114356613	WASH2P	15384	114338729	114343729
NR_003659	chr15	+	102501015	102516808	WASH3P	15793	102498515	102503515
NR_033266	chr19	-	60950	70966	WASH5P	10016	68466	73466
NR_024540	chr1	-	14361	29370	WASH7P	15009	26870	31870
NM_182905	chr9	-	14510	29739	WASHC1	15229	27239	32239
NM_001291398	chr10	+	51827647	51893269	WASHC2A	65622	51825147	51830147
NM_001169106	chr10	+	46222647	46288412	WASHC2C	65765	46220147	46225147
NM_001301107	chr12	-	102406617	102455902	WASHC3	49285	102453402	102458402
NM_015275	chr12	+	105501491	105562912	WASHC4	61421	105498991	105503991
NM_014846	chr8	-	126036502	126104061	WASHC5	67559	126101561	126106561
NM_003941	chr7	-	123321980	123389125	WASL	67145	123386625	123391625
NM_016312	chr12	-	14939411	14956401	WBP11	16990	14953901	14958901
NR_003558	chr18	+	30091625	30094597	WBP11P1	2972	30089125	30094125
NM_001083913	chr10	+	104503726	104576021	WBP1L	72295	104501226	104506226
NM_001348170	chr17	-	73841779	73852517	WBP2	10738	73850017	73855017
NM_152613	chr22	+	42394728	42424477	WBP2NL	29749	42392228	42397228
NM_007187	chr13	+	41635392	41658147	WBP4	22755	41632892	41637892
NM_025203	chr2	-	24252205	24270296	WDCP	18091	24267796	24272796
NM_020830	chr2	-	224740059	224810104	WDFY1	70045	224807604	224812604
NM_052950	chr13	+	52158483	52336171	WDFY2	177688	52155983	52160983
NM_014991	chr4	-	85590692	85887544	WDFY3	296852	85885044	85890044
NR_015359	chr4	+	85887970	85928168	WDFY3-AS2	40198	85885470	85890470
NM_020945	chr10	+	49893517	50191001	WDFY4	297484	49891017	49896017
NM_007086	chr14	-	55405655	55493819	WDHD1	88164	55491319	55496319
NM_015910	chr2	-	63348534	63815867	WDPCP	467333	63813367	63818367
NM_017491	chr4	-	10075962	10118573	WDR1	42611	10116073	10121073
NM_018117	chr10	+	122610686	122669038	WDR11	58352	122608186	122613186
NR_033850	chr10	-	122521323	122610691	WDR11-AS1	89368	122608191	122613191
NM_018256	chr2	-	203745322	203776949	WDR12	31627	203774449	203779449
NM_001347219	chrX	+	48455865	48463582	WDR13	7717	48453365	48458365
NM_181265	chr4	+	176986984	177103979	WDR17	116995	176984484	176989484
NM_024100	chr19	+	984327	994569	WDR18	10242	981827	986827
NM_025132	chr4	+	39184023	39287430	WDR19	103407	39181523	39186523
NM_001330228	chr14	+	102606155	102690010	WDR20	83855	102603655	102608655
NM_032259	chr16	-	734621	740424	WDR24	5803	737924	742924
NM_001161476	chr14	+	100842752	100996640	WDR25	153888	100840252	100845252
NM_001115113	chr1	-	224572844	224622001	WDR26	49157	224619501	224624501
NM_001202550	chr6	-	169857302	170102159	WDR27	244857	170099659	170104659
NM_006784	chr1	+	118472371	118503049	WDR3	30678	118469871	118474871
NM_145241	chr9	-	116075501	116102620	WDR31	27119	116100120	116105120
NM_018383	chr2	-	128461807	128568761	WDR33	106954	128566261	128571261
NM_052844	chr9	-	131395939	131419129	WDR34	23190	131416629	131421629
NM_020779	chr2	-	20110028	20189884	WDR35	79856	20187384	20192384
NM_139281	chr5	+	110427869	110466200	WDR36	38331	110425369	110430369
NM_014023	chr10	+	1102775	1178237	WDR37	75462	1100275	1105275
NM_001276374	chr9	+	127615695	127620170	WDR38	4475	127613195	127618195
NM_033661	chr21	-	44263189	44299693	WDR4	36504	44297193	44302193
NM_018268	chr5	-	76726757	76788365	WDR41	61608	76785865	76790865
NM_015131	chr2	+	29117508	29171086	WDR43	53578	29115008	29120008
NM_019045	chrX	+	117480035	117583923	WDR44	103888	117477535	117482535
NM_007075	chrX	-	48932091	48958059	WDR45	25968	48955559	48960559
NM_019613	chr17	-	80572437	80606411	WDR45B	33974	80603911	80608911
NM_005452	chr6_cox_hap2	-	4690689	4701118	WDR46	10429	4698618	4703618
NM_014969	chr1	-	109512837	109584850	WDR47	72013	109582350	109587350
NM_001303402	chr3	+	39093476	39138161	WDR48	44685	39090976	39095976
NM_001348951	chr3	-	167196472	167375791	WDR49	179319	167373291	167378291
NM_017588	chr9	+	137001209	137025094	WDR5	23885	136998709	137003709
NM_001345911	chr3	-	196281049	196295545	WDR53	14496	196293045	196298045
NM_001320825	chr2	+	74648849	74652882	WDR54	4033	74646349	74651349
NM_017706	chr5	+	140044383	140050553	WDR55	6170	140041883	140046883
NM_030581	chr16	-	74907470	75019017	WDR59	111547	75016517	75021517
NM_019069	chr3	-	122130699	122134882	WDR5B	4183	122132382	122137382
NM_018031	chr3	+	49044494	49053386	WDR6	8892	49041994	49046994
NM_001350914	chr7	+	158631935	158738883	WDR60	106948	158629435	158634435
NM_001303248	chr15	-	78575577	78592068	WDR61	16491	78589568	78594568
NM_001083961	chr19	+	36545782	36596012	WDR62	50230	36543282	36548282
NM_001288563	chr1	+	85527980	85598821	WDR63	70841	85525480	85530480
NM_144625	chr1	+	241815579	241965434	WDR64	149855	241813079	241818079
NM_144668	chr12	+	122356462	122441832	WDR66	85370	122353962	122358962
NM_015285	chr18	+	54318615	54697036	WDR7	378421	54316115	54321115
NM_018034	chr5	+	37379361	37752774	WDR70	373413	37376861	37381861
NR_102334	chr15	-	53805937	54055075	WDR72	249138	54052575	54057575
NR_130946	chr15	-	85184725	85197574	WDR73	12849	85195074	85200074
NM_018093	chr11	-	62600376	62607628	WDR74	7252	62605128	62610128
NM_032168	chr2	+	190306158	190340288	WDR75	34130	190303658	190308658
NM_001167941	chr15	+	44119111	44160617	WDR76	41506	44116611	44121611
NM_001317062	chr1	-	111982511	111991930	WDR77	9419	111989430	111994430
NM_024763	chr1	-	67278571	67390570	WDR78	111999	67388070	67393070
NM_001163673	chr17	+	1619816	1641893	WDR81	22077	1617316	1622316
NM_025222	chr3	-	52288437	52312659	WDR82	24222	52310159	52315159
NM_001099737	chr19	+	12777617	12786646	WDR83	9029	12775117	12780117
NM_001284261	chr7	-	151078206	151107791	WDR86	29585	151105291	151110291
NR_109857	chr7	+	151106246	151110440	WDR86-AS1	4194	151103746	151108746
NM_001291088	chr19	-	38375462	38397346	WDR87	21884	38394846	38399846
NM_173479	chr19	+	33622997	33666703	WDR88	43706	33620497	33625497
NM_080666	chr14	-	64063756	64108641	WDR89	44885	64106141	64111141
NM_145294	chr16	+	699362	717829	WDR90	18467	696862	701862
NM_014149	chr7	-	134868589	134896316	WDR91	27727	134893816	134898816
NM_138458	chr2	-	68357280	68384692	WDR92	27412	68382192	68387192
NM_020212	chr15	+	90234027	90286869	WDR93	52842	90231527	90236527
NM_001316309	chr8	+	145162594	145171286	WDR97	8692	145160094	145165094
NM_001330276	chr2	-	160092303	160143310	WDSUB1	51007	160140810	160145810
NM_001276252	chr1	+	27561006	27635124	WDTC1	74118	27558506	27563506
NR_133926	chr8	+	124428964	124460330	WDYHV1	31366	124426464	124431464
NM_003390	chr11	+	9595227	9611313	WEE1	16086	9592727	9597727
NM_001105558	chr7	+	141408152	141431071	WEE2	22919	141405652	141410652
NR_015392	chr7	-	141404137	141438030	WEE2-AS1	33893	141435530	141440530
NM_001282466	chr16	+	84328311	84363457	WFDC1	35146	84325811	84330811
NM_172006	chr20	-	44313289	44333658	WFDC10B	20369	44331158	44336158
NM_147197	chr20	-	44277201	44298878	WFDC11	21677	44296378	44301378
NM_172005	chr20	+	44330654	44337456	WFDC13	6802	44328154	44333154
NM_006103	chr20	+	44098393	44110172	WFDC2	11779	44095893	44100893
NR_030732	chr17	-	58160926	58165828	WFDC21P	4902	58163328	58168328
NM_080614	chr20	-	44402846	44420547	WFDC3	17701	44418047	44423047
NM_145652	chr20	-	43738092	43743813	WFDC5	5721	43741313	43746313
NM_080827	chr20	-	44162835	44168134	WFDC6	5299	44165634	44170634
NM_181510	chr20	-	44179790	44207965	WFDC8	28175	44205465	44210465
NM_147198	chr20	-	44236577	44259907	WFDC9	23330	44257407	44262407
NM_053284	chr16	+	681011	684116	WFIKKN1	3105	678511	683511
NM_001330341	chr17	+	48912010	48919714	WFIKKN2	7704	48909510	48914510
NM_001145853	chr4	+	6271576	6304992	WFS1	33416	6269076	6274076
NM_001080435	chr15	+	83478379	83503613	WHAMM	25234	83475879	83480879
NR_036650	chr15	-	32812048	32825942	WHAMMP1	13894	32823442	32828442
NR_026589	chr15	+	28982728	29003508	WHAMMP2	20780	28980228	28985228
NR_003521	chr15	-	23187728	23208357	WHAMMP3	20629	23205857	23210857
NM_015404	chr9	-	117164359	117267736	WHRN	103377	117265236	117270236
NM_007191	chr12	-	65444403	65515346	WIF1	70943	65512846	65517846
NM_001077269	chr2	-	175424301	175547627	WIPF1	123326	175545127	175550127
NM_133264	chr17	+	38375573	38438439	WIPF2	62866	38373073	38378073
NM_001080529	chr7	+	29846169	29956682	WIPF3	110513	29843669	29848669
NM_001320772	chr17	-	66417421	66453665	WIPI1	36244	66451165	66456165
NM_001278299	chr7	+	5229834	5273486	WIPI2	43652	5227334	5232334
NM_080838	chr8	+	134203281	134243932	WISP1	40651	134200781	134205781
NM_001323370	chr20	+	43343484	43356453	WISP2	12969	43340984	43345984
NM_003880	chr6	+	112375277	112390887	WISP3	15610	112372777	112377777
NM_021241	chr19	-	15532317	15560762	WIZ	28445	15558262	15563262
NM_001002292	chr1	-	68564141	68698229	WLS	134088	68695729	68700729
NM_018979	chr12	+	862088	1020618	WNK1	158530	859588	864588
NM_006648	chr9	+	95947211	96082854	WNK2	135643	95944711	95949711
NM_020922	chrX	-	54219255	54384438	WNK3	165183	54381938	54386938
NM_001321299	chr17	+	40932648	40949084	WNK4	16436	40930148	40935148
NM_005430	chr12	+	49372235	49376396	WNT1	4161	49369735	49374735
NM_025216	chr2	+	219745254	219758651	WNT10A	13397	219742754	219747754
NM_003394	chr12	-	49359122	49365641	WNT10B	6519	49363141	49368141
NM_004626	chr11	-	75897369	75917574	WNT11	20205	75915074	75920074
NM_016087	chr7	+	120965420	120981158	WNT16	15738	120962920	120967920
NM_003391	chr7	-	116916685	116963343	WNT2	46658	116960843	116965843
NM_004185	chr1	+	113009162	113063910	WNT2B	54748	113006662	113011662
NM_030753	chr17	-	44839871	44896126	WNT3	56255	44893626	44898626
NM_033131	chr1	+	228194722	228248972	WNT3A	54250	228192222	228197222
NM_030761	chr1	-	22443797	22469519	WNT4	25722	22467019	22472019
NM_003392	chr3	-	55499742	55521670	WNT5A	21928	55519170	55524170
NM_030775	chr12	+	1726221	1756377	WNT5B	30156	1723721	1728721
NM_006522	chr2	+	219724545	219738954	WNT6	14409	219722045	219727045
NM_004625	chr3	-	13860081	13921618	WNT7A	61537	13919118	13924118
NM_058238	chr22	-	46316247	46373008	WNT7B	56761	46370508	46375508
NR_125351	chr5	+	137419580	137428054	WNT8A	8474	137417080	137422080
NM_003393	chr10	+	102222811	102243399	WNT8B	20588	102220311	102225311
NM_003395	chr1	-	228109164	228135676	WNT9A	26512	228133176	228138176
NM_001320458	chr17	+	44928951	44964096	WNT9B	35145	44926451	44931451
NM_001143990	chr17	+	7589388	7606820	WRAP53	17432	7586888	7591888
NM_017818	chr1	-	3547330	3566671	WRAP73	19341	3564171	3569171
NR_146615	chr21	+	40752170	40800454	WRB	48284	40749670	40754670
NM_001317744	chr21	+	40752169	40887433	WRB-SH3BGR	135264	40749669	40754669
NM_000553	chr8	+	30890777	31031277	WRN	140500	30888277	30893277
NM_020135	chr6	+	2765665	2785979	WRNIP1	20314	2763165	2768165
NM_001348350	chr17	+	25621046	25640647	WSB1	19601	25618546	25623546
NM_001278557	chr12	-	118470496	118499979	WSB2	29483	118497479	118502479
NM_015253	chr17	+	5973933	6027747	WSCD1	53814	5971433	5976433
NM_014653	chr12	+	108523247	108644313	WSCD2	121066	108520747	108525747
NR_131252	chr5	+	133249367	133252960	WSPAR	3593	133246867	133251867
NM_000378	chr11	-	32409321	32457081	WT1	47760	32454581	32459581
NR_120548	chr11	+	32457063	32480315	WT1-AS	23252	32454563	32459563
NM_004906	chr6	+	160148029	160177352	WTAP	29323	160145529	160150529
NR_038390	chr11	+	102654406	102707497	WTAPP1	53091	102651906	102656906
NM_001077637	chr2	-	132118064	132121731	WTH3DI	3667	132119231	132124231
NM_001080436	chr19	+	34972879	34992085	WTIP	19206	34970379	34975379
NM_001161661	chr5	+	167719064	167899308	WWC1	180244	167716564	167721564
NM_024949	chr4	+	184020462	184241929	WWC2	221467	184017962	184022962
NR_126473	chr4	-	184154780	184161787	WWC2-AS1	7007	184159287	184164287
NM_015691	chrX	+	9983794	10112518	WWC3	128724	9981294	9986294
NM_001291997	chr16	+	78133309	79246564	WWOX	1113255	78130809	78135809
NM_007013	chr8	+	87354993	87480178	WWP1	125185	87352493	87357493
NM_007014	chr16	+	69796186	69975644	WWP2	179458	69793686	69798686
NM_001348362	chr3	-	149235015	149442575	WWTR1	207560	149440075	149445075
NR_040250	chr3	+	149375996	149379149	WWTR1-AS1	3153	149373496	149378496
NM_020196	chr19	-	7684410	7694439	XAB2	10029	7691939	7696939
NR_131204	chrX	-	112859586	113181506	XACT	321920	113179006	113184006
NM_001353135	chr17	+	6658765	6678964	XAF1	20199	6656265	6661265
NM_001097594	chrX	+	52238809	52243953	XAGE1B	5144	52236309	52241309
NM_001097604	chrX	+	52238809	52243953	XAGE1E	5144	52236309	52241309
NM_130777	chrX	+	52112152	52118826	XAGE2	6674	52109652	52114652
NM_133179	chrX	-	52891557	52897119	XAGE3	5562	52894619	52899619
NM_130775	chrX	+	52841227	52847322	XAGE5	6095	52838727	52843727
NM_005080	chr22	-	29190547	29196560	XBP1	6013	29194060	29199060
NM_002995	chr1	+	168545710	168551315	XCL1	5605	168543210	168548210
NM_003175	chr1	-	168510002	168513235	XCL2	3233	168510735	168515735
NM_005283	chr3	-	46062290	46068979	XCR1	6689	46066479	46071479
NM_000379	chr2	-	31557187	31637611	XDH	80424	31635111	31640111
NM_001141919	chrX	+	2670092	2734541	XG	64449	2667592	2672592
NR_003254	chrX	+	2670336	2693037	XGY2	22701	2667836	2672836
NM_001204401	chrX	+	122993661	123047829	XIAP	54168	122991161	122996161
NM_001198621	chr3	-	39224700	39234087	XIRP1	9387	39231587	39236587
NM_152381	chr2	+	167744996	168116261	XIRP2	371265	167742496	167747496
NR_046665	chr2	-	167979318	167997465	XIRP2-AS1	18147	167994965	167999965
NR_001564	chrX	-	73040485	73072588	XIST	32103	73070088	73075088
NM_021083	chrX	+	37545008	37591383	XK	46375	37542508	37547508
NM_175878	chr22	-	17264305	17302589	XKR3	38284	17300089	17305089
NM_052898	chr8	+	56015016	56438710	XKR4	423694	56012516	56017516
NM_207411	chr8	-	6666040	6693166	XKR5	27126	6690666	6695666
NM_173683	chr8	-	10753656	11058875	XKR6	305219	11056375	11061375
NM_001011718	chr20	+	30555804	30586256	XKR7	30452	30553304	30558304
NM_018053	chr1	+	28285972	28294607	XKR8	8635	28283472	28288472
NM_001011720	chr8	+	71581599	71648177	XKR9	66578	71579099	71584099
NM_212559	chrX	-	100168430	100183898	XKRX	15468	100181398	100186398
NR_131214	chr10	+	92707056	92751889	XLOC_008559	44833	92704556	92709556
NR_131215	chr12	+	121342497	121345877	XLOC_009911	3380	121339997	121344997
NR_027302	chr9	-	100437190	100459691	XPA	22501	100457191	100462191
NM_004628	chr3	-	14186647	14220172	XPC	33525	14217672	14222672
NM_001324128	chr10	-	111624523	111683311	XPNPEP1	58788	111680811	111685811
NM_003399	chrX	+	128872945	128903525	XPNPEP2	30580	128870445	128875445
NM_022098	chr22	+	41253084	41328823	XPNPEP3	75739	41250584	41255584
NM_003400	chr2	-	61705068	61765418	XPO1	60350	61762918	61767918
NM_022459	chr13	-	21351467	21476913	XPO4	125446	21474413	21479413
NM_020750	chr6	-	43490067	43543812	XPO5	53745	43541312	43546312
NM_001270940	chr16	-	28109297	28223239	XPO6	113942	28220739	28225739
NM_015024	chr8	+	21777179	21864096	XPO7	86917	21774679	21779679
NM_007235	chr12	+	64798152	64842463	XPOT	44311	64795652	64800652
NM_004736	chr1	+	180601145	180859415	XPR1	258270	180598645	180603645
NM_006297	chr19	-	44047463	44079730	XRCC1	32267	44077230	44082230
NM_005431	chr7	-	152343586	152373250	XRCC2	29664	152370750	152375750
NM_001100119	chr14	-	104163953	104181823	XRCC3	17870	104179323	104184323
NM_003401	chr5	+	82373227	82649579	XRCC4	276352	82370727	82375727
NM_021141	chr2	+	216974019	217071016	XRCC5	96997	216971519	216976519
NM_001288978	chr22	+	42017166	42060052	XRCC6	42886	42014666	42019666
NR_024608	chrX	-	98716599	99194841	XRCC6P5	478242	99192341	99197341
NM_001282857	chr3	-	142025448	142166904	XRN1	141456	142164404	142169404
NM_012255	chr20	+	21283921	21370463	XRN2	86542	21281421	21286421
NM_001270381	chr11	-	74551954	74660232	XRRA1	108278	74657732	74662732
NM_152531	chr3	-	194789012	194991895	XXYLT1	202883	194989395	194994395
NR_102710	chr3	+	194868599	194873585	XXYLT1-AS2	4986	194866099	194871099
NM_001349178	chr3	+	38388250	38468674	XYLB	80424	38385750	38390750
NM_022166	chr16	-	17196180	17564738	XYLT1	368558	17562238	17567238
NR_110010	chr17	+	48423392	48438546	XYLT2	15154	48420892	48425892
NM_001282446	chr7	+	39605974	39651688	YAE1D1	45714	39603474	39608474
NR_135139	chr12	-	42550906	42632170	YAF2	81264	42629670	42634670
NM_001130145	chr11	+	101981191	102104154	YAP1	122963	101978691	101983691
NM_003680	chr1	-	33240839	33283633	YARS	42794	33281133	33286133
NM_001040436	chr12	-	32899477	32908887	YARS2	9410	32906387	32911387
NM_058181	chr21	+	47706243	47717665	YBEY	11422	47703743	47708743
NM_004559	chr1	+	43147905	43169474	YBX1	21569	43145405	43150405
NM_015982	chr17	-	7191570	7197876	YBX2	6306	7195376	7200376
NM_003651	chr12	-	10851675	10875953	YBX3	24278	10873453	10878453
NM_018023	chr3	+	183415605	183530413	YEATS2	114808	183413105	183418105
NR_046727	chr3	-	183524851	183528239	YEATS2-AS1	3388	183525739	183530739
NM_001300950	chr12	+	69753489	69784650	YEATS4	31161	69750989	69755989
NM_005433	chr18	-	721591	812327	YES1	90736	809827	814827
NM_001300861	chr11	-	66052050	66056638	YIF1A	4588	66054138	66059138
NM_001145463	chr19	-	38794199	38806606	YIF1B	12407	38804106	38809106
NR_135075	chr1	-	54317391	54355504	YIPF1	38113	54353004	54358004
NM_024029	chr19	-	11033443	11039688	YIPF2	6245	11037188	11042188
NM_015388	chr6	-	43479564	43484728	YIPF3	5164	43482228	43487228
NM_032312	chr2	+	32502957	32531658	YIPF4	28701	32500457	32505457
NM_030799	chr5	-	143537722	143550278	YIPF5	12556	143547778	143552778
NM_173834	chrX	+	67718623	67757127	YIPF6	38504	67716123	67721123
NM_182592	chr4	-	44624353	44653658	YIPF7	29305	44651158	44656158
NM_198537	chr19	+	19639669	19648393	YJEFN3	8724	19637169	19642169
NM_006555	chr7	+	44240577	44253893	YKT6	13316	44238077	44243077
NM_019589	chr14	+	75230068	75304013	YLPM1	73945	75227568	75232568
NM_001253866	chr10	-	27399039	27443349	YME1L1	44310	27440849	27445849
NM_001276320	chr1	-	207217193	207226325	YOD1	9132	207223825	207228825
NM_013313	chr22	-	22051825	22090123	YPEL1	38298	22087623	22092623
NM_001005404	chr17	+	57409052	57479095	YPEL2	70043	57406552	57411552
NM_001145524	chr16	-	30103636	30107537	YPEL3	3901	30105037	30110037
NM_145008	chr11	-	57412559	57417417	YPEL4	4858	57414917	57419917
NM_001127399	chr2	+	30369749	30383399	YPEL5	13650	30367249	30372249
NM_024640	chr1	-	38268613	38273865	YRDC	5252	38271365	38276365
NM_133370	chr4	-	69176104	69215835	YTHDC1	39731	69213335	69218335
NM_022828	chr5	+	112849358	112930984	YTHDC2	81626	112846858	112851858
NM_017798	chr20	-	61826781	61847538	YTHDF1	20757	61845038	61850038
NM_001173128	chr1	+	29063132	29096287	YTHDF2	33155	29060632	29065632
NM_001277815	chr8	+	64081111	64125346	YTHDF3	44235	64078611	64083611
NM_003404	chr20	+	43514239	43537175	YWHAB	22936	43511739	43516739
NR_024058	chr17	-	1247833	1303556	YWHAE	55723	1301056	1306056
NR_024178	chr17	-	36202572	36244363	YWHAEP7	41791	36241863	36246863
NM_012479	chr7	-	75956107	75988342	YWHAG	32235	75985842	75990842
NM_003405	chr22	+	32340478	32353590	YWHAH	13112	32337978	32342978
NM_006826	chr2	-	9724095	9771184	YWHAQ	47089	9768684	9773684
NM_003406	chr8	-	101930803	101965623	YWHAZ	34820	101963123	101968123
NM_003403	chr14	+	100705101	100745371	YY1	40270	100702601	100707601
NM_139118	chr1	-	155629232	155658823	YY1AP1	29591	155656323	155661323
NM_206923	chrX	+	21874104	21876845	YY2	2741	21871604	21876604
NM_180990	chr17	+	74075262	74078885	ZACN	3623	74072762	74077762
NM_175907	chr18	-	72907064	72921303	ZADH2	14239	72918803	72923803
NR_111918	chr7	+	100331248	100395419	ZAN	64171	100328748	100333748
NM_001079	chr2	+	98330030	98356323	ZAP70	26293	98327530	98332530
NM_175619	chr4	+	48492268	48496406	ZAR1	4138	48489768	48494768
NM_001136571	chr13	-	32877907	32886091	ZAR1L	8184	32883591	32888591
NM_001199201	chr3	-	166958076	167098085	ZBBX	140009	167095585	167100585
NM_004729	chrX	-	2404454	2419008	ZBED1	14554	2416508	2421508
NM_032367	chr5	-	76372501	76383071	ZBED3	10570	76380571	76385571
NR_024398	chr5	+	76382622	76444176	ZBED3-AS1	61554	76380122	76385122
NM_014838	chr22	+	50247496	50283726	ZBED4	36230	50244996	50249996
NM_021211	chr11	-	10874250	10879620	ZBED5	5370	10877120	10882120
NR_034137	chr11	+	10879763	10900823	ZBED5-AS1	21060	10877263	10882263
NM_001174108	chr1	+	203766650	203770200	ZBED6	3550	203764150	203769150
NM_138434	chr7	+	150026937	150029811	ZBED6CL	2874	150024437	150029437
NM_001303251	chr5	-	159820154	159827104	ZBED8	6950	159824604	159829604
NM_001329616	chr6	-	28539406	28583954	ZBED9	44548	28581454	28586454
NM_001160417	chr20	-	56178901	56195632	ZBP1	16731	56193132	56198132
NM_014950	chr14	+	64971291	65000408	ZBTB1	29117	64968791	64973791
NM_001277145	chr8	+	81397853	81438500	ZBTB10	40647	81395353	81400353
NM_014415	chr3	-	101368282	101395988	ZBTB11	27706	101393488	101398488
NR_024407	chr3	+	101395273	101398057	ZBTB11-AS1	2784	101392773	101397773
NM_001243704	chr18	-	5289017	5297052	ZBTB14	8035	5294552	5299552
NM_006006	chr11	+	113930430	114121397	ZBTB16	190967	113927930	113932930
NM_001287604	chr1	-	16268363	16302627	ZBTB17	34264	16300127	16305127
NM_001278196	chr1	+	244212240	244220780	ZBTB18	8540	244209740	244214740
NM_020861	chr6	-	151685249	151712835	ZBTB2	27586	151710335	151715335
NM_001348800	chr3	-	114033346	114866127	ZBTB20	832781	114863627	114868627
NR_038993	chr3	+	114070657	114107825	ZBTB20-AS1	37168	114068157	114073157
NR_126422	chr3	+	114591879	114595361	ZBTB20-AS3	3482	114589379	114594379
NR_046877	chr3	+	114819269	114821908	ZBTB20-AS4	2639	114816769	114821769
NR_121661	chr3	+	114172439	114238979	ZBTB20-AS5	66540	114169939	114174939
NM_001320731	chr21	-	43406939	43430496	ZBTB21	23557	43427996	43432996
NM_001145338	chr6_cox_hap2	-	4725993	4729534	ZBTB22	3541	4727034	4732034
NM_014797	chr6	-	109783718	109804440	ZBTB24	20722	109801940	109806940
NM_001304508	chr14	-	64915823	64971931	ZBTB25	56108	64969431	64974431
NM_020924	chr9	-	125680307	125693830	ZBTB26	13523	125691330	125696330
NM_024784	chr11	-	62518434	62521656	ZBTB3	3222	62519156	62524156
NM_001316902	chr19	+	36195388	36207940	ZBTB32	12552	36192888	36197888
NM_006777	chrX	+	119384606	119392251	ZBTB33	7645	119382106	119387106
NM_001099270	chr9	+	129622943	129648156	ZBTB34	25213	129620443	129625443
NM_001346115	chr1	+	173837219	173855774	ZBTB37	18555	173834719	173839719
NM_001080412	chr3	+	141043054	141168632	ZBTB38	125578	141040554	141045554
NM_014830	chr12	-	57392616	57400297	ZBTB39	7681	57397797	57402797
NM_020899	chr17	-	7362684	7387568	ZBTB4	24884	7385068	7390068
NM_014870	chr1	+	22778343	22857650	ZBTB40	79307	22775843	22780843
NR_135153	chr1	-	197122811	197169672	ZBTB41	46861	197167172	197172172
NM_001137601	chr14	+	105267517	105271048	ZBTB42	3531	105265017	105270017
NM_001135776	chr9	+	129567284	129600487	ZBTB43	33203	129564784	129569784
NM_014155	chr11	-	130096573	130184607	ZBTB44	88034	130182107	130187107
NM_001316980	chr19	-	59024896	59053079	ZBTB45	28183	59050579	59055579
NM_025224	chr20	-	62375020	62436856	ZBTB46	61836	62434356	62439356
NR_110081	chr20	+	62439428	62454360	ZBTB46-AS1	14932	62436928	62441928
NM_145166	chr3	+	42695175	42709072	ZBTB47	13897	42692675	42697675
NM_001278648	chr1	+	6640050	6649340	ZBTB48	9290	6637550	6642550
NM_145291	chr4	+	4291923	4323513	ZBTB49	31590	4289423	4294423
NM_014872	chr9	-	37438099	37465407	ZBTB5	27308	37462907	37467907
NM_006626	chr9	-	125670334	125675607	ZBTB6	5273	125673107	125678107
NM_015898	chr19	-	4043301	4066943	ZBTB7A	23642	4064443	4069443
NR_045515	chr1	+	154975105	154991001	ZBTB7B	15896	154972605	154977605
NM_001318841	chr18	-	45553638	45935793	ZBTB7C	382155	45933293	45938293
NR_111980	chr1	+	33004745	33071551	ZBTB8A	66806	33002245	33007245
NM_001145720	chr1	+	32930657	32953459	ZBTB8B	22802	32928157	32933157
NM_001330475	chr1	-	33086423	33116191	ZBTB8OS	29768	33113691	33118691
NM_152735	chr6	+	33422355	33425320	ZBTB9	2965	33419855	33424855
NM_016010	chr8	+	79578281	79631997	ZC2HC1A	53716	79575781	79580781
NM_001013623	chr6	+	144185572	144259483	ZC2HC1B	73911	144183072	144188072
NR_110315	chr14	+	75536279	75546690	ZC2HC1C	10411	75533779	75538779
NM_001303124	chr12	+	56512003	56516280	ZC3H10	4277	56509503	56514503
NM_001319238	chr1	+	203764664	203823256	ZC3H11A	58592	203762164	203767164
NM_001323551	chr1	+	37940118	37949978	ZC3H12A	9860	37937618	37942618
NM_001010888	chrX	+	64708614	64727767	ZC3H12B	19153	64706114	64711114
NM_033390	chr11	+	109964086	110042566	ZC3H12C	78480	109961586	109966586
NM_207360	chr6	-	149768765	149806148	ZC3H12D	37383	149803648	149808648
NM_001330567	chr13	-	46528599	46626913	ZC3H13	98314	46624413	46629413
NM_024824	chr14	+	89029252	89079853	ZC3H14	50601	89026752	89031752
NM_018471	chr2	+	187350884	187374087	ZC3H15	23203	187348384	187353384
NM_144604	chr16	+	88636788	88698372	ZC3H18	61584	88634288	88639288
NM_015117	chr8	-	144519824	144623620	ZC3H3	103796	144621120	144626120
NM_015168	chr19	-	47567446	47617009	ZC3H4	49563	47614509	47619509
NM_198581	chr2	+	113033177	113097640	ZC3H6	64463	113030677	113035677
NM_014153	chr16	-	11844441	11891114	ZC3H7A	46673	11888614	11893614
NM_017590	chr22	+	41697506	41756151	ZC3H7B	58645	41695006	41700006
NM_032494	chr2	-	112973438	113012664	ZC3H8	39226	113010164	113015164
NM_020119	chr7	-	138728265	138794465	ZC3HAV1	66200	138791965	138796965
NM_080660	chr7	-	138710451	138720775	ZC3HAV1L	10324	138718275	138723275
NM_016478	chr7	-	129658125	129691291	ZC3HC1	33166	129688791	129693791
NM_001178032	chrX	-	64135681	64254624	ZC4H2	118943	64252124	64257124
NM_001300817	chr5	-	132332676	132362296	ZCCHC10	29620	132359796	132364796
NM_015269	chr1	-	52888947	53018762	ZCCHC11	129815	53016262	53021262
NM_001312891	chrX	+	117957705	117960936	ZCCHC12	3231	117955205	117960205
NM_015144	chr16	-	87439851	87525460	ZCCHC14	85609	87522960	87527960
NM_001282568	chr1	+	31769828	31837800	ZCCHC17	67972	31767328	31772328
NR_026694	chrX	+	103357216	103360538	ZCCHC18	3322	103354716	103359716
NR_126534	chr18	+	60190657	60253976	ZCCHC2	63319	60188157	60193157
NM_001039778	chr4	+	110224190	110237291	ZCCHC23	13101	110221690	110226690
NM_153367	chr10	-	81142082	81205383	ZCCHC24	63301	81202883	81207883
NM_033089	chr20	+	278203	280963	ZCCHC3	2760	275703	280703
NM_024936	chr4	+	25314395	25372005	ZCCHC4	57610	25311895	25316895
NM_001185059	chr9	-	88902647	88969402	ZCCHC6	66755	88966902	88971902
NM_001289119	chr9	+	37120468	37358145	ZCCHC7	237677	37117968	37122968
NM_017612	chr12	-	122956145	122985620	ZCCHC8	29475	122983120	122988120
NM_032280	chr5	+	80597401	80608965	ZCCHC9	11564	80594901	80599901
NM_033114	chr12	-	42705887	42719932	ZCRB1	14045	42717432	42722432
NM_017984	chr7	-	99998494	100026431	ZCWPW1	27937	100023931	100028931
NM_001324169	chr3	+	28390639	28567857	ZCWPW2	177218	28388139	28393139
NM_020923	chr2	+	207139364	207179150	ZDBF2	39786	207136864	207141864
NM_001323627	chr16	-	67428321	67450397	ZDHHC1	22076	67447897	67452897
NM_024786	chr5	-	795719	851101	ZDHHC11	55382	848601	853601
NR_147095	chr5	-	710469	784870	ZDHHC11B	74401	782370	787370
NM_032799	chr9	-	131483148	131486408	ZDHHC12	3260	131483908	131488908
NM_019028	chr11	+	19138691	19197967	ZDHHC13	59276	19136191	19141191
NM_024630	chr6	+	157802556	158094977	ZDHHC14	292421	157800056	157805056
NM_144969	chrX	-	74588261	74743337	ZDHHC15	155076	74740837	74745837
NM_198045	chr10	+	99205887	99217127	ZDHHC16	11240	99203387	99208387
NM_015336	chr12	+	77157853	77247474	ZDHHC17	89621	77155353	77160353
NM_032283	chr1	+	27153200	27182211	ZDHHC18	29011	27150700	27155700
NR_135617	chr3	-	195924322	195938308	ZDHHC19	13986	195935808	195940808
NM_016353	chr8	+	17013835	17080241	ZDHHC2	66406	17011335	17016335
NR_104486	chr13	-	21946709	22033509	ZDHHC20	86800	22031009	22036009
NM_178566	chr9	-	14611068	14693480	ZDHHC21	82412	14690980	14695980
NM_174976	chr14	-	77597612	77608134	ZDHHC22	10522	77605634	77610634
NM_001320467	chr3	+	113666747	113682220	ZDHHC23	15473	113664247	113669247
NM_001348571	chr11	-	66288552	66313709	ZDHHC24	25157	66311209	66316209
NM_001330761	chr3	-	44956752	45017677	ZDHHC3	60925	45015177	45020177
NM_001134389	chr7	+	6617064	6628610	ZDHHC4	11546	6614564	6619564
NM_015457	chr11	+	57435473	57468659	ZDHHC5	33186	57432973	57437973
NM_001351082	chr10	-	114190047	114207304	ZDHHC6	17257	114204804	114209804
NM_001145548	chr16	-	85008066	85045141	ZDHHC7	37075	85042641	85047641
NM_013373	chr22	+	20119363	20135530	ZDHHC8	16167	20116863	20121863
NR_003950	chr22	-	23732791	23744799	ZDHHC8P1	12008	23742299	23747299
NM_016032	chrX	-	128937263	128977910	ZDHHC9	40647	128975410	128980410
NM_001323638	chr10	+	31607423	31818742	ZEB1	211319	31604923	31609923
NR_024284	chr10	-	31605456	31608024	ZEB1-AS1	2568	31605524	31610524
NM_001171653	chr2	-	145141941	145277958	ZEB2	136017	145275458	145280458
NM_006336	chr9	-	131492066	131534213	ZER1	42147	131531713	131536713
NM_001170796	chr8	-	82613565	82633539	ZFAND1	19974	82631039	82636039
NM_182491	chr7	-	1192542	1199855	ZFAND2A	7313	1197355	1202355
NM_138802	chr2	+	220071505	220074373	ZFAND2B	2868	220069005	220074005
NM_021943	chr6	+	37787306	38122399	ZFAND3	335093	37784806	37789806
NM_001282906	chr10	-	46110948	46168261	ZFAND4	57313	46165761	46170761
NM_006007	chr9	-	74966340	74980163	ZFAND5	13823	74977663	74982663
NM_001242918	chr15	+	80351909	80430735	ZFAND6	78826	80349409	80354409
NR_003604	chr20	+	47894714	47905795	ZFAS1	11081	47892214	47897214
NM_020863	chr8	-	135490030	135725292	ZFAT	235262	135722792	135727792
NR_002438	chr8	+	135610313	135612932	ZFAT-AS1	2619	135607813	135612813
NM_144982	chr12	-	72003378	72057749	ZFC3H1	54371	72055249	72060249
NM_033400	chr14	-	23990063	24020858	ZFHX2	30795	24018358	24023358
NM_001164766	chr16	-	72816785	73092534	ZFHX3	275749	73090034	73095034
NM_024721	chr8	+	77593514	77779521	ZFHX4	186007	77591014	77596014
NR_024360	chr8	-	77523113	77595510	ZFHX4-AS1	72397	77593010	77598010
NM_153688	chr16	+	75182338	75206132	ZFP1	23794	75179838	75184838
NM_020917	chr19	-	36825354	36870105	ZFP14	44751	36867605	36872605
NM_030613	chr5	+	178322894	178360212	ZFP2	37318	178320394	178325394
NM_020828	chr19	+	57050316	57068170	ZFP28	17854	57047816	57052816
NM_153018	chr17	+	4981753	4999669	ZFP3	17916	4979253	4984253
NM_001320668	chr19	-	38121909	38147162	ZFP30	25253	38144662	38149662
NM_003407	chr19	+	39897486	39900052	ZFP36	2566	39894986	39899986
NM_001244701	chr14	-	69254371	69262960	ZFP36L1	8589	69260460	69265460
NM_006887	chr2	-	43449540	43453745	ZFP36L2	4205	43451245	43456245
NM_001282518	chr9	-	115804094	115819071	ZFP37	14977	115816571	115821571
NM_173832	chr8	+	144329097	144344875	ZFP41	15778	144326597	144331597
NM_001304358	chr4	+	188916924	188926203	ZFP42	9279	188914424	188919424
NM_001109809	chr6_cox_hap2	-	1158970	1163760	ZFP57	4790	1161260	1166260
NM_152283	chr5	-	180274610	180288286	ZFP62	13676	180285786	180290786
NM_199427	chr20	-	50700549	50808524	ZFP64	107975	50806024	50811024
NM_001320178	chr1	+	40943301	40962015	ZFP69	18714	40940801	40945801
NM_023070	chr1	+	40916336	40929390	ZFP69B	13054	40913836	40918836
NM_001321919	chr19	-	36874003	36909576	ZFP82	35573	36907076	36912076
NM_001305204	chr16	+	68573115	68609975	ZFP90	36860	68570615	68575615
NM_053023	chr11	+	58346586	58389023	ZFP91	42437	58344086	58349086
NR_024091	chr11	+	58346586	58393205	ZFP91-CNTF	46619	58344086	58349086
NM_001136273	chrX	+	152683780	152687086	ZFP92	3306	152681280	152686280
NM_006782	chr11	+	64851693	64855874	ZFPL1	4181	64849193	64854193
NM_153813	chr16	+	88520013	88601574	ZFPM1	81561	88517513	88522513
NM_012082	chr8	+	106331146	106816767	ZFPM2	485621	106328646	106333646
NR_125796	chr8	-	106792637	107072731	ZFPM2-AS1	280094	107070231	107075231
NM_016107	chr5	-	32354451	32444867	ZFR	90416	32442367	32447367
NM_015174	chr19	-	3804021	3869027	ZFR2	65006	3866527	3871527
NM_001330327	chrX	+	24167105	24234206	ZFX	67101	24164605	24169605
NR_046657	chrX	-	24164341	24167771	ZFX-AS1	3430	24165271	24170271
NM_001145276	chrY	+	2803111	2850547	ZFY	47436	2800611	2805611
NR_144458	chrY	-	2834859	2870667	ZFY-AS1	35808	2868167	2873167
NM_021260	chr14	-	73436152	73493920	ZFYVE1	57768	73491420	73496420
NM_001284236	chr5	+	79703831	79779198	ZFYVE16	75367	79701331	79706331
NM_001077268	chr15	+	41099273	41106767	ZFYVE19	7494	41096773	41101773
NM_024071	chr14	+	104182080	104200005	ZFYVE21	17925	104179580	104184580
NM_015346	chr14	-	68213236	68283306	ZFYVE26	70070	68280806	68285806
NM_144588	chr10	+	99496877	99520664	ZFYVE27	23787	99494377	99499377
NM_001172656	chr4	-	2271323	2420370	ZFYVE28	149047	2417870	2422870
NM_004799	chr1	+	52607765	52812358	ZFYVE9	204593	52605265	52610265
NM_152338	chr16	+	29789560	29792969	ZG16	3409	29787060	29792060
NM_001103167	chr19	-	10415478	10420233	ZGLP1	4755	10417733	10422733
NM_001083113	chr20	+	62338793	62367494	ZGPAT	28701	62336293	62341293
NM_001350397	chr4	-	113460488	113558151	ZGRF1	97663	113555651	113560651
NR_037873	chr8	-	124260689	124287781	ZHX1	27092	124285281	124290281
NM_001204180	chr8	-	124238428	124286727	ZHX1-C8orf76	48299	124284227	124289227
NM_014943	chr8	+	123793900	123986755	ZHX2	192855	123791400	123796400
NM_015035	chr20	-	39807088	39928739	ZHX3	121651	39926239	39931239
NM_003412	chr3	+	147127180	147134506	ZIC1	7326	147124680	147129680
NM_007129	chr13	+	100634009	100639027	ZIC2	5018	100631509	100636509
NM_001330661	chrX	+	136648285	136659850	ZIC3	11565	136645785	136650785
NM_032153	chr3	-	147103834	147124596	ZIC4	20762	147122096	147127096
NM_033132	chr13	-	100615217	100624163	ZIC5	8946	100621663	100626663
NM_001321147	chr19	+	58095343	58105258	ZIK1	9915	58092843	58097843
NM_001146327	chr19	-	57285922	57352097	ZIM2	66175	57349597	57354597
NR_110744	chr19	+	57276689	57311014	ZIM2-AS1	34325	57274189	57279189
NM_052882	chr19	-	57645463	57656570	ZIM3	11107	57654070	57659070
NM_001346579	chr7	+	99613174	99642997	ZKSCAN1	29823	99610674	99615674
NM_001012981	chr16	-	25247321	25268855	ZKSCAN2	21534	25266355	25271355
NM_024493	chr6	+	28317690	28336954	ZKSCAN3	19264	28315190	28320190
NM_001304506	chr6	-	28209482	28227030	ZKSCAN4	17548	28224530	28229530
NM_001318082	chr7	+	99102266	99131445	ZKSCAN5	29179	99099766	99104766
NM_001288592	chr3	+	44596666	44624956	ZKSCAN7	28290	44594166	44599166
NM_001278122	chr6	+	28109687	28127250	ZKSCAN8	17563	28107187	28112187
NM_001282401	chrX	-	101137259	101187039	ZMAT1	49780	101184539	101189539
NM_144723	chr5	+	140079944	140086266	ZMAT2	6322	140077444	140082444
NM_022470	chr3	-	178735010	178789656	ZMAT3	54646	178787156	178792156
NM_024645	chr8	-	40388110	40755343	ZMAT4	367233	40752843	40757843
NM_001318129	chr22	-	30126944	30163000	ZMAT5	36056	30160500	30165500
NM_020338	chr10	+	80828791	81076285	ZMIZ1	247494	80826291	80831291
NR_015429	chr10	-	80703082	80827205	ZMIZ1-AS1	124123	80824705	80829705
NM_001300959	chr7	+	44788164	44809479	ZMIZ2	21315	44785664	44790664
NM_005857	chr1	+	40723721	40759856	ZMPSTE24	36135	40721221	40726221
NM_001289088	chr1	+	35525386	35581459	ZMYM1	56073	35522886	35527886
NM_001353159	chr13	+	20531545	20665984	ZMYM2	134439	20529045	20534045
NM_001171162	chrX	-	70459473	70475047	ZMYM3	15574	70472547	70477547
NM_005095	chr1	+	35734567	35887545	ZMYM4	152978	35732067	35737067
NR_046659	chr1	-	35824424	35831678	ZMYM4-AS1	7254	35829178	35834178
NM_001142684	chr13	-	20397623	20437776	ZMYM5	40153	20435276	20440276
NM_007167	chr1	-	35451766	35497569	ZMYM6	45803	35495069	35500069
NM_001308379	chr3	-	50378536	50383177	ZMYND10	4641	50380677	50385677
NM_006624	chr10	+	180404	300577	ZMYND11	120173	177904	182904
NM_032257	chr1	-	42896000	42921938	ZMYND12	25938	42919438	42924438
NM_001267822	chr17	+	4643309	4649414	ZMYND15	6105	4640809	4645809
NM_138462	chr9	-	140476530	140484937	ZMYND19	8407	140482437	140487437
NM_001281775	chr20	-	45837858	45985633	ZMYND8	147775	45983133	45988133
NM_015394	chr12	+	133707213	133736049	ZNF10	28836	133704713	133709713
NM_173531	chr19	-	21906842	21950430	ZNF100	43588	21947930	21952930
NM_001300949	chr19	+	19778961	19794315	ZNF101	15354	19776461	19781461
NM_001284307	chr15	-	42704634	42783395	ZNF106	78761	42780895	42785895
NM_016220	chr7	+	64126460	64171960	ZNF107	45500	64123960	64128960
NM_001348282	chr19	-	44830705	44871375	ZNF112	40670	44868875	44873875
NM_153608	chr19	+	48773355	48790865	ZNF114	17510	48770855	48775855
NM_015852	chr7	-	64434829	64451414	ZNF117	16585	64448914	64453914
NM_016265	chr7	-	6728063	6746566	ZNF12	18503	6744066	6749066
NM_001308269	chr19	-	9676403	9695209	ZNF121	18806	9692709	9697709
NM_001243740	chr1	-	247285276	247335319	ZNF124	50043	247332819	247337819
NM_001330706	chr5	+	43120944	43176426	ZNF131	55482	43118444	43123444
NM_003433	chr19	-	58944180	58951589	ZNF132	7409	58949089	58954089
NM_001083330	chr20	+	18268871	18297640	ZNF133	28769	18266371	18271371
NM_003435	chr19	+	58125586	58136085	ZNF134	10499	58123086	58128086
NM_001289402	chr19	+	58570606	58581110	ZNF135	10504	58568106	58573106
NM_003437	chr19	+	12273861	12300696	ZNF136	26835	12271361	12276361
NR_023311	chr19	+	53099936	53103405	ZNF137P	3469	53097436	53102436
NR_073389	chr7	+	64254765	64314178	ZNF138	59413	64252265	64257265
NM_021030	chr19	-	19821280	19843921	ZNF14	22641	19841421	19846421
NM_001300776	chr12	+	133656788	133684258	ZNF140	27470	133654288	133659288
NM_003441	chr4	+	331567	378653	ZNF141	47086	329067	334067
NR_073599	chr2	-	219502639	219524355	ZNF142	21716	219521855	219526855
NM_001282657	chr11	+	9482511	9550071	ZNF143	67560	9480011	9485011
NM_007145	chr19	+	36705503	36729675	ZNF146	24172	36703003	36708003
NM_021964	chr3	-	124944512	125094198	ZNF148	149686	125091698	125096698
NR_110975	chr19	-	58207642	58220579	ZNF154	12937	58218079	58223079
NM_001260487	chr19	+	44488321	44502477	ZNF155	14156	44485821	44490821
NM_003446	chrX	+	47229998	47273098	ZNF157	43100	47227498	47232498
NM_001029976	chr8	-	146155743	146176274	ZNF16	20531	146173774	146178774
NM_001322137	chr19	-	53569866	53606687	ZNF160	36821	53604187	53609187
NM_003447	chr6	+	28048481	28057340	ZNF165	8859	28045981	28050981
NM_001301275	chr9	+	97021547	97064111	ZNF169	42564	97019047	97024047
NM_001330617	chr19	+	57922514	57933307	ZNF17	10793	57920014	57925014
NM_001347868	chr16	+	3451189	3459366	ZNF174	8177	3448689	3453689
NM_007147	chr19	+	52074489	52092991	ZNF175	18502	52071989	52076989
NM_003451	chr19	+	9473695	9493293	ZNF177	19598	9471195	9476195
NM_001303281	chr17	-	11880755	11900827	ZNF18	20072	11898327	11903327
NM_001288762	chr19	-	44978644	45004575	ZNF180	25931	45002075	45007075
NM_001145665	chr19	+	35225479	35233774	ZNF181	8295	35222979	35227979
NM_001178099	chrX	-	47834249	47863394	ZNF182	29145	47860894	47865894
NR_144687	chr6	-	27371790	27440897	ZNF184	69107	27438397	27443397
NM_001178110	chrX	+	152082985	152142025	ZNF185	59040	152080485	152085485
NR_103480	chr9	+	104161135	104172942	ZNF189	11807	104158635	104163635
NM_006961	chr16	-	71507975	71523254	ZNF19	15279	71520754	71525754
NR_103448	chr6	+	28129538	28137373	ZNF192P1	7835	28127038	28132038
NM_001130520	chr11	-	3379156	3400452	ZNF195	21296	3397952	3402952
NM_001323293	chr3	+	44666510	44689963	ZNF197	23453	44664010	44669010
NR_046658	chr3	-	44658619	44666289	ZNF197-AS1	7670	44663789	44668789
NM_021088	chr2	+	95831161	95850064	ZNF2	18903	95828661	95833661
NM_001203250	chr19	-	12242167	12251222	ZNF20	9055	12248722	12253722
NM_198087	chr16	-	3272324	3285457	ZNF200	13133	3282957	3287957
NM_003455	chr11	-	123594634	123612391	ZNF202	17757	123609891	123614891
NR_024553	chr6	-	27325601	27343153	ZNF204P	17552	27340653	27345653
NM_003456	chr16	+	3162562	3170518	ZNF205	7956	3160062	3165062
NR_024167	chr16	-	3160460	3165599	ZNF205-AS1	5139	3163099	3168099
NM_001032293	chr17	+	30677156	30697468	ZNF207	20312	30674656	30679656
NM_001329971	chr19	-	22122567	22193745	ZNF208	71178	22191245	22196245
NM_001265597	chr19	+	58144534	58155414	ZNF211	10880	58142034	58147034
NM_012256	chr7	+	148936741	148952700	ZNF212	15959	148934241	148939241
NM_004220	chr16	+	3185056	3192805	ZNF213	7749	3182556	3187556
NR_110900	chr16	-	3175529	3184883	ZNF213-AS1	9354	3182383	3187383
NM_013249	chr11	-	7020548	7041586	ZNF214	21038	7039086	7044086
NM_013250	chr11	+	6947653	6979278	ZNF215	31625	6945153	6950153
NM_006526	chr20	-	52183609	52199636	ZNF217	16027	52197136	52202136
NM_001102454	chr14	-	21558204	21572863	ZNF219	14659	21570363	21575363
NM_006963	chr10	+	45496272	45500777	ZNF22	4505	45493772	45498772
NM_001297588	chr19	+	44455374	44471752	ZNF221	16378	44452874	44457874
NM_001129996	chr19	+	44529493	44537262	ZNF222	7769	44526993	44531993
NM_013361	chr19	+	44556163	44572147	ZNF223	15984	44553663	44558663
NM_001321645	chr19	+	44598481	44613983	ZNF224	15502	44595981	44600981
NM_013362	chr19	+	44617514	44638969	ZNF225	21455	44615014	44620014
NM_001319089	chr19	+	44669214	44681838	ZNF226	12624	44666714	44671714
NM_001289172	chr19	+	44716680	44741421	ZNF227	24741	44714180	44719180
NM_001278510	chr19	-	44930422	44952766	ZNF229	22344	44950266	44955266
NM_001304492	chr16	-	71481502	71496155	ZNF23	14653	71493655	71498655
NM_006300	chr19	+	44507076	44518072	ZNF230	10996	44504576	44509576
NM_001320953	chr17	-	5009028	5026337	ZNF232	17309	5023837	5028837
NM_001207005	chr19	+	44764032	44779470	ZNF233	15438	44761532	44766532
NM_001144824	chr19	+	44645709	44664462	ZNF234	18753	44643209	44648209
NM_004234	chr19	-	44790500	44809178	ZNF235	18678	44806678	44811678
NM_001306089	chr18	+	74534562	74682682	ZNF236	148120	74532062	74537062
NM_001324349	chr10	-	44051792	44070066	ZNF239	18274	44067566	44072566
NM_006965	chr18	-	32912171	32924431	ZNF24	12260	32921931	32926931
NR_147993	chr10	-	38047465	38147012	ZNF248	99547	38144512	38149512
NM_145011	chr10	-	38238499	38265583	ZNF25	27084	38263083	38268083
NM_021061	chr8	-	146102335	146126846	ZNF250	24511	146124346	146129346
NM_138367	chr8	-	145946293	145980970	ZNF251	34677	145978470	145983470
NR_023392	chr8	-	146198974	146228285	ZNF252P	29311	146225785	146230785
NR_026974	chr8	+	146228196	146231432	ZNF252P-AS1	3236	146225696	146230696
NM_001331134	chr19	+	19976638	20004293	ZNF253	27655	19974138	19979138
NM_001278677	chr19	+	24216206	24312769	ZNF254	96563	24213706	24218706
NM_005773	chr19	-	58452200	58459077	ZNF256	6877	58456577	58461577
NM_001316996	chr19	+	22235249	22273903	ZNF257	38654	22232749	22237749
NM_001256280	chr12	+	133562933	133589154	ZNF26	26221	133560433	133565433
NM_001166038	chr19	-	37001588	37019248	ZNF260	17660	37016748	37021748
NM_005741	chr16	+	3333486	3341459	ZNF263	7973	3330986	3335986
NM_003417	chr19	+	57702867	57734214	ZNF264	31347	57700367	57705367
NM_001271314	chr19	-	9523101	9546254	ZNF266	23153	9543754	9548754
NM_001265588	chr16	+	31885078	31928629	ZNF267	43551	31882578	31887578
NM_001165887	chr12	+	133757994	133783697	ZNF268	25703	133755494	133760494
NR_024566	chr18	+	32870235	32890730	ZNF271P	20495	32867735	32872735
NR_003099	chr7	+	64363619	64391955	ZNF273	28336	64361119	64366119
NM_133502	chr19	+	58694355	58724928	ZNF274	30573	58691855	58696855
NM_001080485	chrX	+	152599612	152618384	ZNF275	18772	152597112	152602112
NM_152287	chr16	+	89787392	89807332	ZNF276	19940	89784892	89789892
NM_021994	chr7	+	111846642	111983989	ZNF277	137347	111844142	111849142
NM_006969	chr19	-	53300660	53324922	ZNF28	24262	53322422	53327422
NM_080740	chr22	-	22868060	22874624	ZNF280A	6564	22872124	22877124
NR_130642	chr22	-	22838770	22863505	ZNF280B	24735	22861005	22866005
NM_017666	chrX	-	129336672	129402922	ZNF280C	66250	129400422	129405422
NM_017661	chr15	-	56922373	57026284	ZNF280D	103911	57023784	57028784
NM_001281294	chr1	-	200374074	200379186	ZNF281	5112	200376686	200381686
NM_003575	chr7	+	148892553	148923339	ZNF282	30786	148890053	148895053
NM_001297752	chr19	+	44331443	44353050	ZNF283	21607	44328943	44333943
NM_001037813	chr19	+	44576296	44593766	ZNF284	17470	44573796	44578796
NM_001291490	chr19	-	44889807	44905777	ZNF285	15970	44903277	44908277
NM_001288644	chr17	+	15602890	15624100	ZNF286A	21210	15600390	15605390
NM_001145045	chr17	-	18561741	18585572	ZNF286B	23831	18583072	18588072
NM_020653	chr17	-	16450276	16472526	ZNF287	22250	16470026	16475026
NM_015021	chr6	+	87865266	87975661	ZNF292	110395	87862766	87867766
NR_119384	chr21	+	43429302	43445029	ZNF295-AS1	15727	43426802	43431802
NM_145288	chr19	-	45574757	45579846	ZNF296	5089	45577346	45582346
NM_001318137	chr7	-	99661469	99679387	ZNF3	17918	99676887	99681887
NM_194325	chr19	+	35417806	35436076	ZNF30	18270	35415306	35420306
NR_110749	chr19	-	35413918	35417730	ZNF30-AS1	3812	35415230	35420230
NM_001172831	chr5	-	150273953	150284545	ZNF300	10592	150282045	150287045
NR_026867	chr5	-	150309997	150326146	ZNF300P1	16149	150323646	150328646
NM_001289188	chr19	+	35168543	35177302	ZNF302	8759	35166043	35171043
NM_020657	chr19	+	57862641	57871265	ZNF304	8624	57860141	57865141
NM_001350637	chr6_cox_hap2	-	481360	492196	ZNF311	10836	489696	494696
NM_001278559	chr7	+	6676952	6697910	ZNF316	20958	6674452	6679452
NM_020933	chr19	+	9251055	9274091	ZNF317	23036	9248555	9253555
NM_014345	chr6	-	43303807	43337181	ZNF318	33374	43334681	43339681
NM_020807	chr16	-	58028571	58033762	ZNF319	5191	58031262	58036262
NM_006973	chr10	-	44139306	44144326	ZNF32	5020	44141826	44146826
NR_038867	chr10	+	44124264	44170147	ZNF32-AS3	45883	44121764	44126764
NM_001351777	chr19	-	53362743	53400947	ZNF320	38204	53398447	53403447
NR_037805	chr19	-	53430387	53445847	ZNF321P	15460	53443347	53448347
NM_001242797	chr6	-	26634610	26659980	ZNF322	25370	26657480	26662480
NM_014347	chr19	+	58978411	58984945	ZNF324	6534	58975911	58980911
NM_207395	chr19	+	58962970	58969199	ZNF324B	6229	58960470	58965470
NM_001320185	chr1	+	90460653	90501089	ZNF326	40436	90458153	90463153
NM_024620	chr19	-	58637694	58662148	ZNF329	24454	58659648	58664648
NM_014487	chr4	+	142142040	142155850	ZNF330	13810	142139540	142144540
NM_001317120	chr19	+	54024176	54083523	ZNF331	59347	54021676	54026676
NM_001300912	chr19	+	14800851	14844558	ZNF333	43707	14798351	14803351
NR_073026	chr20	-	45128268	45142198	ZNF334	13930	45139698	45144698
NM_022095	chr20	-	44577291	44600833	ZNF335	23542	44598333	44603333
NM_015655	chr20	-	25653830	25677540	ZNF337	23710	25675040	25680040
NR_126465	chr20	+	25604680	25658708	ZNF337-AS1	54028	25602180	25607180
NR_136709	chr10	+	38299577	38356762	ZNF33A	57185	38297077	38302077
NR_130951	chr10	-	43069630	43134285	ZNF33B	64655	43131785	43136785
NM_001286770	chr8	-	145997608	146012730	ZNF34	15122	146010230	146015230
NM_032819	chr20	+	32319565	32380075	ZNF341	60510	32317065	32322065
NR_110623	chr20	-	32375178	32398905	ZNF341-AS1	23727	32396405	32401405
NM_001282495	chr20	-	2462465	2505168	ZNF343	42703	2502668	2507668
NR_038362	chr19	+	37341787	37384120	ZNF345	42333	37339287	37344287
NM_001308213	chr5	+	176449680	176508190	ZNF346	58510	176447180	176452180
NM_032584	chr19	-	53641956	53662322	ZNF347	20366	53659822	53664822
NM_003420	chr3	+	44690232	44702283	ZNF35	12051	44687732	44692732
NM_021632	chr19	-	52467592	52490079	ZNF350	22487	52487579	52492579
NR_103847	chr19	+	52452386	52484620	ZNF350-AS1	32234	52449886	52454886
NM_005649	chr5	-	178138521	178157703	ZNF354A	19182	178155203	178160203
NM_058230	chr5	+	178286953	178311424	ZNF354B	24471	178284453	178289453
NM_014594	chr5	+	178487415	178510978	ZNF354C	23563	178484915	178489915
NM_018083	chr19	+	7581003	7585911	ZNF358	4908	7578503	7583503
NM_152493	chr1	+	33722173	33766320	ZNF362	44147	33719673	33724673
NM_199451	chr10	+	64133915	64431771	ZNF365	297856	64131415	64136415
NM_152625	chr5	-	71735725	71803249	ZNF366	67524	71800749	71805749
NM_153695	chr9	-	99148224	99180669	ZNF367	32445	99178169	99183169
NM_001324256	chr10	+	38383263	38439197	ZNF37A	55934	38380763	38385763
NR_026777	chr10	-	43008960	43048318	ZNF37BP	39358	43045818	43050818
NM_032825	chr19	+	37096206	37119499	ZNF382	23293	37093706	37098706
NM_001345948	chr19	+	37708827	37734826	ZNF383	25999	37706327	37711327
NM_001135734	chr12	-	6775642	6798738	ZNF384	23096	6796238	6801238
NM_001130967	chr12	-	54762912	54785089	ZNF385A	22177	54782589	54787589
NM_001352808	chr2	-	180306710	180726232	ZNF385B	419522	180723732	180728732
NM_001242704	chr17	-	40177593	40190044	ZNF385C	12451	40187544	40192544
NM_024697	chr3	-	21462489	21792816	ZNF385D	330327	21790316	21795316
NR_046731	chr3	+	21584280	21621451	ZNF385D-AS1	37171	21581780	21586780
NR_046876	chr3	+	21998630	22021320	ZNF385D-AS2	22690	21996130	22001130
NM_001322288	chr6	+	27342413	27371686	ZNF391	29273	27339913	27344913
NM_001345968	chr7	-	99084141	99097931	ZNF394	13790	99095431	99100431
NM_018660	chr8	-	28203101	28243977	ZNF395	40876	28241477	28246477
NM_001322286	chr18	-	32946660	32957301	ZNF396	10641	32954801	32959801
NM_032347	chr18	+	32820993	32838397	ZNF397	17404	32818493	32823493
NM_020781	chr7	+	148823507	148880118	ZNF398	56611	148821007	148826007
NM_001033719	chr19	-	44376514	44384288	ZNF404	7774	44381788	44386788
NM_017757	chr18	+	72342918	72777628	ZNF407	434710	72340418	72345418
NM_024741	chr11	+	46722316	46727466	ZNF408	5150	46719816	46724816
NM_001324149	chrX	-	47304576	47342668	ZNF41	38092	47340168	47345168
NM_001242927	chr14	+	74353317	74398991	ZNF410	45674	74350817	74355817
NM_001146175	chr19	-	8575461	8579048	ZNF414	3587	8576548	8581548
NM_001330766	chr19	-	53611131	53636173	ZNF415	25042	53633673	53638673
NM_017879	chr19	-	58082933	58090243	ZNF416	7310	58087743	58092743
NM_001297734	chr19	-	58417141	58427984	ZNF417	10843	58425484	58430484
NM_133460	chr19	-	58433251	58446755	ZNF418	13504	58444255	58449255
NM_001098495	chr19	+	57999078	58006048	ZNF419	6970	57996578	58001578
NM_144689	chr19	+	37569123	37621268	ZNF420	52145	37566623	37571623
NM_001271620	chr16	-	49521441	49891830	ZNF423	370389	49889330	49894330
NM_001001661	chr7	-	148799877	148823438	ZNF425	23561	148820938	148825938
NM_024106	chr19	-	9633899	9649321	ZNF426	15422	9646821	9651821
NM_182498	chr19	-	44111375	44124014	ZNF428	12639	44121514	44126514
NM_001346912	chr19	+	21688353	21723469	ZNF429	35116	21685853	21690853
NM_001256653	chr19	-	21987750	22034870	ZNF43	47120	22032370	22037370
NM_025189	chr19	+	21203425	21242852	ZNF430	39427	21200925	21205925
NR_138052	chr19	+	21324812	21378856	ZNF431	54044	21322312	21327312
NM_014650	chr19	-	52534631	52552377	ZNF432	17746	52549877	52554877
NM_001308351	chr19	-	12125531	12146556	ZNF433	21025	12144056	12149056
NM_001077195	chr1	-	23685940	23696357	ZNF436	10417	23693857	23698857
NR_033690	chr1	+	23695463	23698330	ZNF436-AS1	2867	23692963	23697963
NM_001143771	chr10	-	31133564	31320866	ZNF438	187302	31318366	31323366
NM_001348721	chr19	+	11959547	11980306	ZNF439	20759	11957047	11962047
NM_016264	chr19	-	12382624	12405714	ZNF44	23090	12403214	12408214
NM_152357	chr19	+	11925106	11946016	ZNF440	20910	11922606	11927606
NM_152355	chr19	+	11877814	11894893	ZNF441	17079	11875314	11880314
NM_030824	chr19	-	12460184	12476475	ZNF442	16291	12473975	12478975
NM_005815	chr19	-	12540519	12551926	ZNF443	11407	12549426	12554426
NM_018337	chr19	+	56652534	56672262	ZNF444	19728	56650034	56655034
NM_181489	chr3	-	44481261	44519162	ZNF445	37901	44516662	44521662
NM_001304453	chr19	+	58988545	59000900	ZNF446	12355	58986045	58991045
NM_152695	chrX	+	134478695	134497338	ZNF449	18643	134476195	134481195
NM_003425	chr19	-	44416775	44439411	ZNF45	22636	44436911	44441911
NM_015555	chr6	+	56954827	57035098	ZNF451	80271	56952327	56957327
NM_001323306	chr5	+	178368191	178393434	ZNF454	25243	178365691	178370691
NM_001330622	chr19	+	57791334	57804936	ZNF460	13602	57788834	57793834
NM_153257	chr19	-	37127522	37157755	ZNF461	30233	37155255	37160255
NM_021224	chr9	+	109625377	109775915	ZNF462	150538	109622877	109627877
NM_207336	chr7	-	149461270	149470568	ZNF467	9298	149468068	149473068
NM_001008801	chr19	-	53341784	53360902	ZNF468	19118	53358402	53363402
NM_001127464	chr16	+	88493878	88507165	ZNF469	13287	88491378	88496378
NM_001001668	chr19	+	57078889	57094262	ZNF470	15373	57076389	57081389
NM_001321768	chr19	+	57019211	57041583	ZNF471	22372	57016711	57021711
NM_015428	chr19	+	50529149	50552031	ZNF473	22882	50526649	50531649
NM_207317	chr5	+	121465207	121489266	ZNF474	24059	121462707	121467707
NM_033273	chr7	-	57187325	57207571	ZNF479	20246	57205071	57210071
NM_001214906	chr16	+	30389632	30411429	ZNF48	21797	30387132	30392132
NM_001297624	chr19	+	52800421	52829180	ZNF480	28759	52797921	52802921
NM_001007169	chr9	+	114287438	114340124	ZNF483	52686	114284938	114289938
NM_001261460	chr9	-	95607312	95640320	ZNF484	33008	95637820	95642820
NM_001318140	chr10	+	44101854	44113352	ZNF485	11498	44099354	44104354
NM_052852	chr19	+	20278022	20311299	ZNF486	33277	20275522	20280522
NR_026693	chr10	+	43932573	43978007	ZNF487	45434	43930073	43935073
NM_001346932	chr10	+	48355023	48373866	ZNF488	18843	48352523	48357523
NM_020714	chr19	-	12686919	12721623	ZNF490	34704	12719123	12724123
NM_152356	chr19	+	11909390	11919306	ZNF491	9916	11906890	11911890
NM_020855	chr19	+	22817125	22850472	ZNF492	33347	22814625	22819625
NM_175910	chr19	+	21579920	21610296	ZNF493	30376	21577420	21582420
NM_032752	chr1	-	247460714	247495242	ZNF496	34528	247492742	247497742
NM_001207009	chr19	-	58865722	58874214	ZNF497	8492	58871714	58876714
NM_021646	chr16	-	4798392	4817219	ZNF500	18827	4814719	4819719
NM_145044	chr3	+	44771097	44778575	ZNF501	7478	44768597	44773597
NM_033210	chr3	+	44754134	44765323	ZNF502	11189	44751634	44756634
NR_120651	chr10	-	77039483	77161652	ZNF503	122169	77159152	77164152
NR_038226	chr10	+	77056140	77121436	ZNF503-AS1	65296	77053640	77058640
NR_024421	chr10	+	77161285	77168740	ZNF503-AS2	7455	77158785	77163785
NM_001099269	chr19	-	19903519	19932560	ZNF506	29041	19930060	19935060
NM_014910	chr19	+	32836513	32878573	ZNF507	42060	32834013	32839013
NM_001314060	chr9	-	99516830	99540411	ZNF510	23581	99537911	99542911
NM_145806	chr10	+	135122392	135126666	ZNF511	4274	135119892	135124892
NM_001271318	chr2	+	27805835	27846082	ZNF512	40247	27803335	27808335
NM_020713	chr20	-	62588056	62601223	ZNF512B	13167	62598723	62603723
NM_144631	chr2	-	27600097	27603611	ZNF513	3514	27601111	27606111
NM_001318005	chr2	-	95810744	95825330	ZNF514	14586	95822830	95827830
NM_014643	chr18	-	74069636	74207146	ZNF516	137510	74204646	74209646
NR_134285	chr8	+	146024260	146036139	ZNF517	11879	146021760	146026760
NR_138482	chr10	+	97889471	97965047	ZNF518A	75576	97886971	97891971
NM_053042	chr4	-	10441503	10459032	ZNF518B	17529	10456532	10461532
NR_033354	chr18	-	14075988	14132489	ZNF519	56501	14129989	14134989
NM_001308225	chr18	-	22641887	22932214	ZNF521	290327	22929714	22934714
NM_153219	chr19	+	56111705	56114504	ZNF524	2799	56109205	56114205
NR_145447	chr19	+	53868945	53889841	ZNF525	20896	53866445	53871445
NM_133444	chr19	+	42724422	42731205	ZNF526	6783	42721922	42726922
NM_032453	chr19	+	37862058	37883966	ZNF527	21908	37859558	37864558
NM_032423	chr19	+	52901120	52921657	ZNF528	20537	52898620	52903620
NR_125345	chr19	-	52892092	52901010	ZNF528-AS1	8918	52898510	52903510
NM_001145650	chr19	-	37034516	37096178	ZNF529	61662	37093678	37098678
NR_110703	chr19	+	37063971	37085618	ZNF529-AS1	21647	37061471	37066471
NR_135923	chr19	+	58111252	58124089	ZNF530	12837	58108752	58113752
NM_018181	chr18	+	56529831	56653712	ZNF532	123881	56527331	56532331
NM_001291368	chr19	+	52932223	52955516	ZNF534	23293	52929723	52934723
NM_001352260	chr19	+	30863299	31204493	ZNF536	341194	30860799	30865799
NM_152606	chr19	+	38042272	38105079	ZNF540	62807	38039772	38044772
NM_001277075	chr19	-	48023941	48076369	ZNF541	52428	48073869	48078869
NR_003127	chr19	+	56879467	56891196	ZNF542P	11729	56876967	56881967
NM_213598	chr19	+	57831864	57842144	ZNF543	10280	57829364	57834364
NM_001320782	chr19	+	58740046	58788858	ZNF544	48812	58737546	58742546
NM_178544	chr19	+	40502942	40526948	ZNF546	24006	40500442	40505442
NM_173631	chr19	+	57874802	57890925	ZNF547	16123	57872302	57877302
NM_152909	chr19	+	57901217	57913919	ZNF548	12702	57898717	57903717
NM_001199295	chr19	+	58038692	58052244	ZNF549	13552	58036192	58041192
NM_001277090	chr19	-	58053203	58071231	ZNF550	18028	58068731	58073731
NM_001270938	chr19	+	58193336	58201169	ZNF551	7833	58190836	58195836
NM_024762	chr19	-	58318449	58326281	ZNF552	7832	58323781	58328781
NM_001102651	chr19	+	2819871	2836733	ZNF554	16862	2817371	2822371
NM_152791	chr19	+	2841432	2860472	ZNF555	19040	2838932	2843932
NM_024967	chr19	+	2867332	2878503	ZNF556	11171	2864832	2869832
NM_024341	chr19	+	7069470	7087978	ZNF557	18508	7066970	7071970
NM_144693	chr19	-	8920251	8942980	ZNF558	22729	8940480	8945480
NM_001202411	chr19	+	9434447	9454521	ZNF559	20074	9431947	9436947
NM_001172650	chr19	+	9434901	9493293	ZNF559-ZNF177	58392	9432401	9437401
NM_152476	chr19	-	9577030	9609279	ZNF560	32249	9606779	9611779
NM_001330365	chr19	-	9718001	9731939	ZNF561	13938	9729439	9734439
NR_122038	chr19	+	9732157	9745538	ZNF561-AS1	13381	9729657	9734657
NM_001300885	chr19	-	9759337	9785776	ZNF562	26439	9783276	9788276
NM_145276	chr19	-	12428303	12444534	ZNF563	16231	12442034	12447034
NM_144976	chr19	-	12636183	12662356	ZNF564	26173	12659856	12664856
NM_001042474	chr19	-	36672961	36705986	ZNF565	33025	36703486	36708486
NM_001300970	chr19	-	36936020	36980804	ZNF566	44784	36978304	36983304
NM_001322914	chr19	+	37178513	37212238	ZNF567	33725	37176013	37181013
NM_001204838	chr19	+	37407230	37488834	ZNF568	81604	37404730	37409730
NM_001330482	chr19	-	37902043	37958360	ZNF569	56317	37955860	37960860
NM_173480	chr19	+	2900895	2918474	ZNF57	17579	2898395	2903395
NM_001300993	chr19	+	37958673	37979554	ZNF570	20881	37956173	37961173
NM_001290314	chr19	-	38055154	38085693	ZNF571	30539	38083193	38088193
NR_038247	chr19	+	38039850	38078248	ZNF571-AS1	38398	38037350	38042350
NM_152412	chr8	+	125985538	125991630	ZNF572	6092	125983038	125988038
NM_001172689	chr19	-	38229202	38270230	ZNF573	41028	38267730	38272730
NM_001330519	chr19	+	42572628	42585719	ZNF574	13091	42570128	42575128
NM_174945	chr19	+	44037339	44040284	ZNF575	2945	44034839	44039839
NM_024327	chr19	+	44100543	44104587	ZNF576	4044	44098043	44103043
NR_024181	chr19	-	52359055	52391189	ZNF577	32134	52388689	52393689
NM_001099694	chr19	+	52956828	53020131	ZNF578	63303	52954328	52959328
NM_152600	chr19	-	56088890	56092211	ZNF579	3321	56089711	56094711
NM_001320371	chr19	-	56894119	56904970	ZNF582	10851	56902470	56907470
NR_037160	chr19	+	56905044	56910544	ZNF582-AS1	5500	56902544	56907544
NM_001159860	chr19	+	56915382	56936400	ZNF583	21018	56912882	56917882
NM_001318002	chr19	+	58920040	58929692	ZNF584	9652	58917540	58922540
NM_001288800	chr19	-	37638339	37663643	ZNF585A	25304	37661143	37666143
NM_152279	chr19	-	37672480	37701451	ZNF585B	28971	37698951	37703951
NM_017652	chr19	+	58281019	58291984	ZNF586	10965	58278519	58283519
NM_032828	chr19	+	58361180	58376491	ZNF587	15311	58358680	58363680
NM_001204818	chr19	+	58341661	58357606	ZNF587B	15945	58339161	58344161
NM_016089	chr3	+	48282595	48312479	ZNF589	29884	48280095	48285095
NM_014630	chr15	+	85291817	85349663	ZNF592	57846	85289317	85294317
NM_032530	chr17	-	5082830	5095178	ZNF594	12348	5092678	5097678
NM_001286052	chr4	+	53178	88099	ZNF595	34921	50678	55678
NM_001287256	chr8	+	182136	197340	ZNF596	15204	179636	184636
NM_152457	chr16	-	3482421	3493537	ZNF597	11116	3491037	3496037
NM_178167	chr16	-	2047652	2059822	ZNF598	12170	2057322	2062322
NM_001007248	chr19	-	35248978	35264134	ZNF599	15156	35261634	35266634
NM_001321867	chr19	-	53268065	53290044	ZNF600	21979	53287544	53292544
NM_001164715	chr12	-	133498018	133532892	ZNF605	34874	133530392	133535392
NM_025027	chr19	-	58488420	58514714	ZNF606	26294	58512214	58517214
NM_032689	chr19	-	38187263	38210691	ZNF607	23428	38208191	38213191
NM_020747	chr5	-	123972609	124080805	ZNF608	108196	124078305	124083305
NM_015042	chr15	+	64791618	64978266	ZNF609	186648	64789118	64794118
NM_001161425	chr19	+	52839497	52870376	ZNF610	30879	52836997	52841997
NM_001161499	chr19	-	53206065	53238307	ZNF611	32242	53235807	53240807
NM_024840	chr19	+	52430687	52449011	ZNF613	18324	52428187	52433187
NM_025040	chr19	-	52516576	52531680	ZNF614	15104	52529180	52534180
NM_001321320	chr19	-	52494586	52511483	ZNF615	16897	52508983	52513983
NM_178523	chr19	-	52616344	52643191	ZNF616	26847	52640691	52645691
NM_001318042	chr9	+	116638561	116818875	ZNF618	180314	116636061	116641061
NM_001145093	chr3	+	40518603	40531728	ZNF619	13125	40516103	40521103
NM_001256167	chr3	+	40547529	40559712	ZNF620	12183	40545029	40550029
NM_001098414	chr3	+	40566368	40581285	ZNF621	14917	40563868	40568868
NM_033414	chr5	-	16451627	16465894	ZNF622	14267	16463394	16468394
NM_001261843	chr8	+	144718182	144735900	ZNF623	17718	144715682	144720682
NM_020787	chr17	-	16524047	16557167	ZNF624	33120	16554667	16559667
NR_037801	chr19	-	12255708	12267546	ZNF625	11838	12265046	12270046
NR_037802	chr19	-	12242167	12267546	ZNF625-ZNF20	25379	12265046	12270046
NM_001076675	chr19	-	20802744	20844402	ZNF626	41658	20841902	20846902
NM_001290084	chr19	+	11708234	11729974	ZNF627	21740	11705734	11710734
NM_033113	chr19	+	55987698	55995854	ZNF628	8156	55985198	55990198
NM_001345970	chr16	-	30789775	30798540	ZNF629	8765	30796040	30801040
NM_001190255	chrX	-	47917566	47931025	ZNF630	13459	47928525	47933525
NR_046742	chrX	+	47915698	47926696	ZNF630-AS1	10998	47913198	47918198
NM_001252612	chr2	+	71558884	71662191	ZNF638	103307	71556384	71561384
NM_001303426	chr3	+	179040778	179053323	ZNF639	12545	179038278	179043278
NM_001172682	chr12	-	48733792	48745029	ZNF641	11237	48742529	48747529
NM_201269	chr1	-	91380856	91487812	ZNF644	106956	91485312	91490312
NM_014699	chr16	+	31085742	31094833	ZNF646	9091	31083242	31088242
NM_001009992	chr1	-	182023704	182030847	ZNF648	7143	182028347	182033347
NM_023074	chr19	-	52392487	52408305	ZNF649	15818	52405805	52410805
NR_110733	chr19	+	52391277	52403717	ZNF649-AS1	12440	52388777	52393777
NM_014897	chr17	-	47366567	47439835	ZNF652	73268	47437335	47442335
NM_138783	chr19	-	11594241	11616738	ZNF653	22497	11614238	11619238
NM_001350134	chr3	+	88108434	88193811	ZNF654	85377	88105934	88110934
NM_138494	chr7	+	99156044	99174076	ZNF655	18032	99153544	99158544
NR_134255	chr9	-	40760699	40789480	ZNF658	28781	40786980	40791980
NR_003528	chr9	-	39443813	39464526	ZNF658B	20713	39462026	39467026
NM_173658	chr3	+	44626341	44641185	ZNF660	14844	44623841	44628841
NM_001351735	chr3	+	44626341	44689963	ZNF660-ZNF197	63622	44623841	44628841
NM_207404	chr3	+	42947401	42960825	ZNF662	13424	42944901	42949901
NM_152437	chr12	+	124457761	124499986	ZNF664	42225	124455261	124460261
NM_001204299	chr12	+	124457730	124800570	ZNF664-RFLNA	342840	124455230	124460230
NM_024733	chr19	-	53666551	53696619	ZNF665	30068	53694119	53699119
NM_022103	chr19	-	56950692	56988770	ZNF667	38078	56986270	56991270
NR_036521	chr19	+	56989242	57006805	ZNF667-AS1	17563	56986742	56991742
NM_024706	chr16	-	31072163	31085641	ZNF668	13478	31083141	31088141
NM_024804	chr1	-	247263263	247267674	ZNF669	4411	247265174	247270174
NM_033213	chr1	-	247197939	247242115	ZNF670	44176	247239615	247244615
NR_037894	chr1	-	247108848	247242115	ZNF670-ZNF695	133267	247239615	247244615
NM_001321376	chr19	-	58231114	58238992	ZNF671	7878	58236492	58241492
NM_024836	chr1	+	249132376	249143716	ZNF672	11340	249129876	249134876
NM_001146291	chrX	-	46357159	46404892	ZNF674	47733	46402392	46407392
NR_015378	chrX	+	46404924	46407910	ZNF674-AS1	2986	46402424	46407424
NM_138330	chr19	-	23835707	23870017	ZNF675	34310	23867517	23872517
NM_001001411	chr19	-	22361902	22379753	ZNF676	17851	22377253	22382253
NM_182609	chr19	-	53738633	53758156	ZNF677	19523	53755656	53760656
NR_102302	chr1	+	227751219	227865144	ZNF678	113925	227748719	227753719
NM_153363	chr7	+	63688851	63727309	ZNF679	38458	63686351	63691351
NM_178558	chr7	-	63980254	64023505	ZNF680	43251	64021005	64026005
NM_138286	chr19	-	23921996	23941693	ZNF681	19697	23939193	23944193
NM_033196	chr19	-	20115226	20150277	ZNF682	35051	20147777	20152777
NM_001307925	chr1	-	26688124	26699285	ZNF683	11161	26696785	26701785
NM_152373	chr1	+	40997232	41013841	ZNF684	16609	40994732	40999732
NM_001304764	chr1	+	151254030	151264381	ZNF687	10351	151251530	151256530
NM_145271	chr16	-	30581018	30583728	ZNF688	2710	30581228	30586228
NR_073481	chr16	-	30613878	30622096	ZNF689	8218	30619596	30624596
NM_001321163	chr19	+	11998598	12025365	ZNF69	26767	11996098	12001098
NM_001242739	chr1	+	43312243	43318146	ZNF691	5903	43309743	43314743
NM_001193328	chr1	-	249144202	249153315	ZNF692	9113	249150815	249155815
NR_037892	chr1	-	247108848	247171395	ZNF695	62547	247168895	247173895
NM_030895	chr8	+	144373558	144382120	ZNF696	8562	144371058	144376058
NM_001080470	chr1	-	120161999	120190390	ZNF697	28391	120187890	120192890
NM_198535	chr19	-	9401815	9420390	ZNF699	18575	9417890	9422890
NM_001282796	chr8	+	146052902	146072893	ZNF7	19991	146050402	146055402
NM_021916	chr22	-	24083770	24093279	ZNF70	9509	24090779	24095779
NM_001271848	chr19	+	12035882	12061588	ZNF700	25706	12033382	12038382
NM_018260	chr19	+	53073525	53090427	ZNF701	16902	53071025	53076025
NR_003578	chr19	-	53471503	53496784	ZNF702P	25281	53494284	53499284
NM_025069	chr8	+	37553268	37557539	ZNF703	4271	37550768	37555768
NM_001033723	chr8	-	81540685	81787016	ZNF704	246331	81784516	81789516
NM_001004328	chr12	+	8325149	8332642	ZNF705A	7493	8322649	8327649
NM_001193630	chr8	+	7783858	7809935	ZNF705B	26077	7781358	7786358
NM_001039615	chr8	+	11946846	11973025	ZNF705D	26179	11944346	11949346
NM_001278713	chr11	-	71525090	71532593	ZNF705E	7503	71530093	71535093
NM_001164457	chr8	-	7215497	7220490	ZNF705G	4993	7217990	7222990
NM_001267709	chr8	-	102209265	102218292	ZNF706	9027	102215792	102220792
NM_001288806	chr8	+	144766621	144777555	ZNF707	10934	144764121	144769121
NM_001297560	chr19	-	21473961	21512241	ZNF708	38280	21509741	21514741
NM_152601	chr19	-	12571997	12595632	ZNF709	23635	12593132	12598132
NM_021216	chr19	+	57106663	57135544	ZNF71	28881	57104163	57109163
NM_198526	chr15	+	90544722	90625432	ZNF710	80710	90542222	90547222
NR_146321	chr15	-	90617743	90625439	ZNF710-AS1	7696	90622939	90627939
NM_021998	chrX	+	84498996	84528368	ZNF711	29372	84496496	84501496
NM_182633	chr7	+	55954969	56009918	ZNF713	54949	55952469	55957469
NR_117086	chr19	+	21264952	21307883	ZNF714	42931	21262452	21267452
NM_001159279	chr7	+	57509882	57533265	ZNF716	23383	57507382	57512382
NM_001290210	chr3	-	75779111	75834734	ZNF717	55623	75832234	75837234
NR_110527	chr4	+	53192	196095	ZNF718	142903	50692	55692
NM_001130913	chr16	+	31724549	31772886	ZNF720	48337	31722049	31727049
NM_133474	chr4	-	433772	492960	ZNF721	59188	490460	495460
NR_145488	chr7	+	63459183	63483903	ZNF722P	24720	63456683	63461683
NM_001349726	chr19	+	23015122	23041469	ZNF723	26347	23012622	23017622
NR_045525	chr19	-	23406606	23433172	ZNF724	26566	23430672	23435672
NM_001348687	chr19	+	24097683	24127515	ZNF726	29832	24095183	24100183
NM_001159522	chr7	+	63505820	63538927	ZNF727	33107	63503320	63508320
NM_001267716	chr19	-	23157684	23186010	ZNF728	28326	23183510	23188510
NM_001242680	chr19	+	22469251	22499978	ZNF729	30727	22466751	22471751
NM_001277403	chr19	+	23299776	23330014	ZNF730	30238	23297276	23302276
NM_001137608	chr4	-	264463	289944	ZNF732	25481	287444	292444
NR_003952	chr7	-	62751669	62764434	ZNF733P	12765	62761934	62766934
NM_001159524	chr7	+	63667580	63680668	ZNF735	13088	63665080	63670080
NM_001170905	chr7	+	63774250	63817012	ZNF736	42762	63771750	63776750
NM_001159293	chr19	-	20720797	20748626	ZNF737	27829	20746126	20751126
NR_027130	chr19	+	21541734	21571384	ZNF738	29650	21539234	21544234
NR_046282	chr22	+	20748404	20762753	ZNF74	14349	20745904	20750904
NM_001004304	chr12	+	53574534	53584654	ZNF740	10120	53572034	53577034
NM_152557	chr7	-	149169883	149194898	ZNF746	25015	149192398	149197398
NM_001305018	chr16	-	30541687	30546291	ZNF747	4604	30543791	30548791
NM_001321954	chr19	+	57946692	57958465	ZNF749	11773	57944192	57949192
NM_024702	chr17	-	80787309	80797931	ZNF750	10622	80795431	80800431
NM_001352497	chr16	+	3355405	3368576	ZNF75A	13171	3352905	3357905
NR_110381	chrX	-	134382535	134478012	ZNF75D	95477	134475512	134480512
NM_003427	chr6	+	35227490	35263764	ZNF76	36274	35224990	35229990
NM_001289951	chr19	+	53935226	53961515	ZNF761	26289	53932726	53937726
NM_001012753	chr19	+	12075868	12091198	ZNF763	15330	12073368	12078368
NM_033410	chr16	-	30565084	30569642	ZNF764	4558	30567142	30572142
NR_146721	chr19	+	53898385	53930574	ZNF765	32189	53895885	53900885
NM_001350496	chr19	+	53898385	53961515	ZNF765-ZNF761	63130	53895885	53900885
NM_001010851	chr19	+	52772823	52795976	ZNF766	23153	52770323	52775323
NR_027788	chr7	-	149244244	149321881	ZNF767P	77637	149319381	149324381
NM_024671	chr16	-	30535321	30537910	ZNF768	2589	30535410	30540410
NM_021217	chr19	-	2933215	2944969	ZNF77	11754	2942469	2947469
NM_014106	chr15	-	35270541	35280497	ZNF770	9956	35277997	35282997
NM_001142305	chr16	+	30418734	30429916	ZNF771	11182	30416234	30421234
NM_001144068	chr19	-	57980953	57988938	ZNF772	7985	57986438	57991438
NR_130705	chr19	+	58011221	58027791	ZNF773	16570	58008721	58013721
NM_001004309	chr15	+	90895476	90904715	ZNF774	9239	90892976	90897976
NM_173680	chr7	+	150076405	150095719	ZNF775	19314	150073905	150078905
NM_001348007	chr19	+	58258163	58269528	ZNF776	11365	58255663	58260663
NM_015694	chr7	-	149128453	149158053	ZNF777	29600	149155553	149160553
NM_001201407	chr16	+	89284110	89295965	ZNF778	11855	89281610	89286610
NM_001142579	chr19	-	40575058	40596845	ZNF780A	21787	40594345	40599345
NM_001005851	chr19	-	40534166	40562115	ZNF780B	27949	40559615	40564615
NM_152605	chr19	-	38158649	38183216	ZNF781	24567	38180716	38185716
NM_001346991	chr9	-	99578552	99616770	ZNF782	38218	99614270	99619270
NM_001195220	chr7	+	148959261	148982085	ZNF783	22824	148956761	148961761
NM_203374	chr19	-	56132106	56135941	ZNF784	3835	56133441	56138441
NM_152458	chr16	-	30591993	30597092	ZNF785	5099	30594592	30599592
NM_152411	chr7	-	148766732	148787869	ZNF786	21137	148785369	148790369
NM_001002836	chr19	-	56598728	56632742	ZNF787	34014	56630242	56635242
NM_001348163	chr19	+	12203077	12225567	ZNF788	22490	12200577	12205577
NM_001351002	chr7	+	99070514	99085217	ZNF789	14703	99068014	99073014
NM_001322260	chr9	+	130186652	130207651	ZNF79	20999	130184152	130189152
NM_001242800	chr19	-	37309223	37341689	ZNF790	32466	37339189	37344189
NR_040027	chr19	+	37288451	37319013	ZNF790-AS1	30562	37285951	37290951
NM_153358	chr19	+	12721731	12740676	ZNF791	18945	12719231	12724231
NM_175872	chr19	-	35447257	35454953	ZNF792	7696	35452453	35457453
NM_001013659	chr19	+	37997840	38034239	ZNF793	36399	37995340	38000340
NR_110723	chr19	-	37988062	37997989	ZNF793-AS1	9927	37995489	38000489
NM_001322498	chr19	-	12500827	12512088	ZNF799	11261	12509588	12514588
NM_021089	chr19	+	58790317	58807254	ZNF8	16937	58787817	58792817
NR_144447	chr19	+	58790331	58827023	ZNF8-ERVK3-1	36692	58787831	58792831
NM_007136	chr3	-	113953479	113956425	ZNF80	2946	113953925	113958925
NM_176814	chr7	-	127010096	127032778	ZNF800	22682	127030278	127035278
NM_194250	chr2	+	185463092	185804214	ZNF804A	341122	185460592	185465592
NM_181646	chr7	+	88388681	88966371	ZNF804B	577690	88386181	88391181
NM_001145078	chr19	+	57752052	57774106	ZNF805	22054	57749552	57754552
NM_001304449	chr2	+	133064716	133076320	ZNF806	11604	133062216	133067216
NR_146880	chr19	-	35032620	35036291	ZNF807	3671	35033791	35038791
NM_001321425	chr19	+	53030908	53059303	ZNF808	28395	53028408	53033408
NM_007137	chrX	+	47696300	47781655	ZNF81	85355	47693800	47698800
NR_146446	chr19	-	9799535	9811452	ZNF812P	11917	9808952	9813952
NM_001004301	chr19	+	53970988	53997546	ZNF813	26558	53968488	53973488
NM_001144989	chr19	-	58380746	58400442	ZNF814	19696	58397942	58402942
NR_023382	chr7	+	5862790	5894066	ZNF815P	31276	5860290	5865290
NM_001202457	chr19	-	53452631	53466164	ZNF816	13533	53463664	53468664
NM_001202473	chr19	-	53430387	53466164	ZNF816-ZNF321P	35777	53463664	53468664
NR_073396	chr19	+	53716200	53719355	ZNF818P	3155	53713700	53718700
NM_001201556	chr16	-	71893582	71918093	ZNF821	24511	71915593	71920593
NM_001297610	chr19	-	11832079	11849824	ZNF823	17745	11847324	11852324
NR_036455	chr19	-	20578625	20607771	ZNF826P	29146	20605271	20610271
NM_001306215	chr4	-	146678778	146860112	ZNF827	181334	146857612	146862612
NM_001037232	chr19	-	37379025	37407193	ZNF829	28168	37404693	37409693
NM_001277948	chr19	-	53115617	53193834	ZNF83	78217	53191334	53196334
NM_178457	chr20	+	57766074	57834167	ZNF831	68093	57763574	57768574
NR_028594	chr19	+	11784812	11797384	ZNF833P	12572	11782312	11787312
NM_001005850	chr19	-	57174019	57183123	ZNF835	9104	57180623	57185623
NM_001102657	chr19	-	52658124	52674896	ZNF836	16772	52672396	52677396
NR_049780	chr19	-	58878989	58892389	ZNF837	13400	58889889	58894889
NM_001267827	chr14	+	102783713	102809511	ZNF839	25798	102781213	102786213
NM_003428	chr12	+	133613871	133639890	ZNF84	26019	133611371	133616371
NM_001352299	chr19	-	52561352	52597524	ZNF841	36172	52595024	52600024
NM_001353381	chr16	-	31446758	31454481	ZNF843	7723	31451981	31456981
NR_134326	chr19	+	12175513	12188631	ZNF844	13118	12173013	12178013
NM_001321524	chr19	+	53836971	53859372	ZNF845	22401	53834471	53839471
NM_001077624	chr19	-	9868150	9879410	ZNF846	11260	9876910	9881910
NM_001256173	chr19	+	21106058	21133503	ZNF85	27445	21103558	21108558
NM_001193552	chr19	-	37234379	37263716	ZNF850	29337	37261216	37266216
NM_001287349	chr3	-	44540461	44552132	ZNF852	11671	44549632	44554632
NM_017560	chr7	+	6655526	6663921	ZNF853	8395	6653026	6658026
NM_001137674	chr3	+	32023265	32033228	ZNF860	9963	32020765	32025765
NM_001099220	chr7	+	149535455	149564568	ZNF862	29113	149532955	149537955
NM_001195605	chr19	+	56124958	56129907	ZNF865	4949	56122458	56127458
NR_027481	chr4	+	206388	249773	ZNF876P	43385	203888	208888
NM_001080404	chr19	-	12154619	12163782	ZNF878	9163	12161282	12166282
NM_001136116	chr5	+	178450752	178461388	ZNF879	10636	178448252	178453252
NM_001145434	chr19	+	52873169	52889046	ZNF880	15877	52870669	52875669
NM_001101338	chr9	-	115759399	115774472	ZNF883	15073	115771972	115776972
NM_001310127	chr19	-	53409145	53421184	ZNF888	12039	53418684	53423684
NR_034163	chr7	-	5160940	5184177	ZNF890P	23237	5181677	5186677
NM_001277291	chr12	-	133696554	133707059	ZNF891	10505	133704559	133709559
NM_007138	chr19	+	20188802	20231977	ZNF90	43175	20186302	20191302
NM_001300951	chr19	-	23540497	23578362	ZNF91	37865	23575862	23580862
NM_001287534	chr7	+	64838711	64866048	ZNF92	27337	64836211	64841211
NM_031218	chr19	+	20011721	20046382	ZNF93	34661	20009221	20014221
NM_001098626	chr19	-	22573898	22605148	ZNF98	31250	22602648	22607648
NM_001080409	chr19	-	22934984	22966973	ZNF99	31989	22964473	22969473
NM_021035	chr20	-	47862438	47894756	ZNFX1	32318	47892256	47897256
NM_006349	chr7	+	100860984	100867471	ZNHIT1	6487	100858484	100863484
NR_104011	chr17	+	34842470	34855154	ZNHIT3	12684	34839970	34844970
NM_001170670	chr1	-	86115105	86174116	ZNHIT6	59011	86171616	86176616
NM_001278786	chr6	+	30029016	30032686	ZNRD1	3670	30026516	30031516
NR_026751	chr6_ssto_hap7	-	1298114	1359409	ZNRD1ASP	61295	1356909	1361909
NM_032268	chr16	+	75032914	75144892	ZNRF1	111978	75030414	75035414
NM_147128	chr7	+	30323922	30407308	ZNRF2	83386	30321422	30326422
NM_001206998	chr22	+	29279754	29453476	ZNRF3	173722	29277254	29282254
NR_046851	chr22	-	29420986	29427464	ZNRF3-AS1	6478	29424964	29429964
NM_207341	chr11	+	60635014	60643164	ZP1	8150	60632514	60637514
NM_003460	chr16	-	21208772	21225831	ZP2	17059	21223331	21228331
NM_007155	chr7	+	76026840	76071388	ZP3	44548	76024340	76029340
NM_021186	chr1	-	238045676	238054222	ZP4	8546	238051722	238056722
NM_001159878	chr7	-	49977023	50132860	ZPBP	155837	50130360	50135360
NM_198844	chr17	+	38024454	38034149	ZPBP2	9695	38021954	38026954
NM_001329788	chr3	+	102153858	102198685	ZPLD1	44827	102151358	102156358
NM_001317086	chr11	-	116648904	116658754	ZPR1	9850	116656254	116661254
NM_017580	chr10	+	126630691	126676005	ZRANB1	45314	126628191	126633191
NM_203350	chr1	-	71528973	71546972	ZRANB2	17999	71544472	71549472
NR_038420	chr1	+	71512188	71532865	ZRANB2-AS1	20677	71509688	71514688
NR_046217	chr1	+	71547006	71703406	ZRANB2-AS2	156400	71544506	71549506
NM_032143	chr2	-	135954538	136288806	ZRANB3	334268	136286306	136291306
NM_005089	chrX	+	15808573	15841382	ZRSR2	32809	15806073	15811073
NM_182572	chr19	+	58545433	58565999	ZSCAN1	20566	58542933	58547933
NM_001282416	chr16	-	3138890	3149318	ZSCAN10	10428	3146818	3151818
NR_136513	chr6	-	28346597	28367544	ZSCAN12	20947	28365044	28370044
NR_024063	chr6	+	28058584	28063493	ZSCAN12P1	4909	28056084	28061084
NM_001320557	chr6	+	28092333	28097864	ZSCAN16	5531	28089833	28094833
NR_103456	chr6	-	28089572	28105094	ZSCAN16-AS1	15522	28102594	28107594
NM_001145542	chr19	-	58595208	58629793	ZSCAN18	34585	58627293	58632293
NM_181877	chr15	+	85144248	85166947	ZSCAN2	22699	85141748	85146748
NM_145238	chr1	+	33938231	33961995	ZSCAN20	23764	33935731	33940731
NM_145914	chr7	+	99647416	99662663	ZSCAN21	15247	99644916	99649916
NM_181846	chr19	+	58838384	58853712	ZSCAN22	15328	58835884	58840884
NM_001012455	chr6	-	28400431	28411279	ZSCAN23	10848	28408779	28413779
NM_001350984	chr7	+	99214570	99270161	ZSCAN25	55591	99212070	99217070
NM_152736	chr6	+	28234787	28246000	ZSCAN26	11213	28232287	28237287
NM_152455	chr15	-	43650369	43662258	ZSCAN29	11889	43659758	43664758
NM_001288711	chr18	-	32831021	32870209	ZSCAN30	39188	32867709	32872709
NM_001135215	chr6	-	28292514	28324048	ZSCAN31	31534	28321548	28326548
NM_017810	chr16	-	3432080	3451065	ZSCAN32	18985	3448565	3453565
NM_152677	chr19	+	58180302	58190520	ZSCAN4	10218	58177802	58182802
NM_001322072	chr19	-	56732671	56879752	ZSCAN5A	147081	56877252	56882252
NM_001080456	chr19	-	56701057	56704421	ZSCAN5B	3364	56701921	56706921
NM_001199479	chr6	+	28193028	28201264	ZSCAN9	8236	28190528	28195528
NM_080603	chr20	+	44509847	44513905	ZSWIM1	4058	44507347	44512347
NM_182521	chr2	-	187692206	187713897	ZSWIM2	21691	187711397	187716397
NR_037628	chr20	+	44486219	44507769	ZSWIM3	21550	44483719	44488719
NM_023072	chr19	+	13906273	13943044	ZSWIM4	36771	13903773	13908773
NM_020883	chr1	-	45482075	45672250	ZSWIM5	190175	45669750	45674750
NM_020928	chr5	+	60628099	60841999	ZSWIM6	213900	60625599	60630599
NM_001042698	chr17	-	15879874	15903006	ZSWIM7	23132	15900506	15905506
NM_015037	chr10	+	75545381	75561556	ZSWIM8	16175	75542881	75547881
NR_038357	chr10	-	75556271	75561157	ZSWIM8-AS1	4886	75558657	75563657
NM_145062	chr6	-	116956780	116989973	ZUFSP	33193	116987473	116992473
NM_004724	chr11	-	113603904	113644485	ZW10	40581	113641985	113646985
NM_017975	chr15	+	66797420	66841822	ZWILCH	44402	66794920	66799920
NM_032997	chr10	-	58117198	58121034	ZWINT	3836	58118534	58123534
NM_007156	chrX	-	57931863	57937067	ZXDA	5204	57934567	57939567
NM_007157	chrX	+	57618268	57623910	ZXDB	5642	57615768	57620768
NM_025112	chr3	-	126156443	126194762	ZXDC	38319	126192262	126197262
NM_001004339	chr1	+	53308182	53360247	ZYG11A	52065	53305682	53310682
NM_024646	chr1	+	53192130	53293013	ZYG11B	100883	53189630	53194630
NM_003461	chr7	+	143078359	143088206	ZYX	9847	143075859	143080859
NM_015113	chr17	-	3907738	4046253	ZZEF1	138515	4043753	4048753
NM_001308237	chr1	-	78028100	78149112	ZZZ3	121012	78146612	78151612
